,index,ibge_6,Dez_tot_pes,Dez_tot_pes_rpc_ate_meio_sm,Dez_tot_pes_pob,Dez_pes_ext_pob,Dez_tot_pes_pob_e_ext_pob,Dez_tot_bx_renda,Media_tot_pes,Media_tot_pes_rpc_ate_meio_sm,Media_tot_pes_pob,Media_pes_ext_pob,Media_tot_pes_pob_e_ext_pob,Media_tot_bx_renda,Soma_tot_pes,Soma_tot_pes_rpc_ate_meio_sm,Soma_tot_pes_pob,Soma_pes_ext_pob,Soma_tot_pes_pob_e_ext_pob,Soma_tot_bx_renda,ano,municipio,municipio_aj,uf,ibge_7,soma_c1,soma_c1_original,media_c1,media_c1_original,total_max_cras,c1_dez_2022,c1_original_dez_2022,porte
0,0,110001,12695,9574,2503,3005,5508,4066,12182.58,9380.42,2335.83,3362.42,5698.25,3682.17,146191,112565,28030,40349,68379,44186,2022,'ALTA FLORESTA DOESTE',Alta Floresta D´oeste,'RO',1100015,14165.0,14165,1180.4,1180.4,1,522.0,522.0,Pequeno II
1,1,110002,39857,32098,8917,8743,17660,14438,38935.25,31886.08,8589.25,9516.08,18105.33,13780.75,467223,382633,103071,114193,217264,165369,2022,'ARIQUEMES',Ariquemes,'RO',1100023,15515.0,15515,1292.9,1292.9,1,611.0,611.0,Médio
2,2,110003,2504,1990,523,385,908,1082,2301.5,1859.67,499.58,511.58,1011.17,848.5,27618,22316,5995,6139,12134,10182,2022,'CABIXI',Cabixi,'RO',1100031,1837.0,1837,153.1,153.1,1,128.0,128.0,Pequeno I
3,3,110004,40718,31406,7373,10481,17854,13552,37497.75,29279.75,6401.58,10080.67,16482.25,12797.5,449973,351357,76819,120968,197787,153570,2022,'CACOAL',Cacoal,'RO',1100049,4709.0,8495,392.4,707.9,1,242.0,242.0,Médio
4,4,110005,7631,6139,1451,1965,3416,2723,7230.33,5870.75,1214.5,1999.0,3213.5,2657.25,86764,70449,14574,23988,38562,31887,2022,'CEREJEIRAS',Cerejeiras,'RO',1100056,2140.0,4153,178.3,346.1,1,175.0,175.0,Pequeno I
5,5,110006,4707,3306,676,616,1292,2014,4831.08,3403.0,674.5,677.42,1351.92,2051.08,57973,40836,8094,8129,16223,24613,2022,'COLORADO DO OESTE',Colorado do Oeste,'RO',1100064,2972.0,2972,247.7,247.7,1,308.0,308.0,Pequeno I
6,6,110007,3645,2703,790,704,1494,1209,3644.58,2781.17,792.92,948.67,1741.58,1039.58,43735,33374,9515,11384,20899,12475,2022,'CORUMBIARA',Corumbiara,'RO',1100072,4397.0,4397,366.4,366.4,1,200.0,200.0,Pequeno I
7,7,110008,10035,8518,1514,5291,6805,1713,9807.58,8350.17,1144.25,5614.42,6758.67,1591.5,117691,100202,13731,67373,81104,19098,2022,'COSTA MARQUES',Costa Marques,'RO',1100080,8243.0,8243,686.9,686.9,1,586.0,586.0,Pequeno I
8,8,110009,14303,10698,2591,3745,6336,4362,13733.33,10415.25,2396.5,3902.75,6299.25,4116.0,164800,124983,28758,46833,75591,49392,2022,'ESPIGAO DOESTE',Espigão D´oeste,'RO',1100098,10060.0,10060,838.3,838.3,1,389.0,389.0,Pequeno II
9,9,110010,27868,23644,5048,12666,17714,5930,26877.58,22888.17,4405.92,12874.0,17279.92,5608.25,322531,274658,52871,154488,207359,67299,2022,'GUAJARA-MIRIM',Guajará-mirim,'RO',1100106,7867.0,7867,655.6,655.6,1,373.0,373.0,Pequeno II
10,10,110011,22914,17750,5232,3739,8971,8779,21654.92,16958.08,5210.42,3639.25,8849.67,8108.42,259859,203497,62525,43671,106196,97301,2022,'JARU',Jaru,'RO',1100114,28903.0,31468,2408.6,2622.3,2,2255.0,2255.0,Médio
11,11,110012,50021,37678,9852,8255,18107,19571,45687.67,34425.75,8980.92,6405.83,15386.75,19039.0,548252,413109,107771,76870,184641,228468,2022,'JI-PARANA',Ji-paraná,'RO',1100122,54012.0,54012,4501.0,4501.0,4,3211.0,3211.0,Grande
12,12,110013,18736,14421,5695,2404,8099,6322,17863.08,14030.58,5632.92,2463.5,8096.42,5934.17,214357,168367,67595,29562,97157,71210,2022,'MACHADINHO DOESTE',Machadinho D´oeste,'RO',1100130,16997.0,16997,1416.4,1416.4,1,1048.0,1048.0,Pequeno II
13,13,110014,11324,8504,1438,4066,5504,3000,11110.0,8475.25,1370.58,4145.25,5515.83,2959.42,133320,101703,16447,49743,66190,35513,2022,'NOVA BRASILANDIA DOESTE',Nova Brasilândia D´oeste,'RO',1100148,2790.0,6028,232.5,502.3,1,794.0,794.0,Pequeno I
14,14,110015,17688,12823,2978,3375,6353,6470,16622.08,12116.92,2663.5,3413.92,6077.42,6039.5,199465,145403,31962,40967,72929,72474,2022,'OURO PRETO DO OESTE',Ouro Preto do Oeste,'RO',1100155,3352.0,3352,279.3,279.3,1,321.0,321.0,Pequeno II
15,15,110018,13095,9603,2158,2180,4338,5265,11576.0,8509.33,1861.75,2185.25,4047.0,4462.33,138912,102112,22341,26223,48564,53548,2022,'PIMENTA BUENO',Pimenta Bueno,'RO',1100189,6466.0,6466,538.8,538.8,1,504.0,504.0,Pequeno II
16,16,110020,241179,204356,44061,106540,150601,53755,217230.0,184681.17,39297.75,95088.83,134386.58,50294.58,2606760,2216174,471573,1141066,1612639,603535,2022,'PORTO VELHO',Porto Velho,'RO',1100205,79287.0,82379,6607.2,6864.9,6,4547.0,4547.0,Grande
17,17,110025,13287,10543,1854,5297,7151,3392,13630.25,10504.25,1779.08,5337.5,7116.58,3387.67,163563,126051,21349,64050,85399,40652,2022,'PRESIDENTE MEDICI',Presidente Médici,'RO',1100254,9230.0,9230,769.2,769.2,1,491.0,491.0,Pequeno II
18,18,110026,1742,1402,336,430,766,636,1621.75,1339.92,330.17,498.42,828.58,511.33,19461,16079,3962,5981,9943,6136,2022,'RIO CRESPO',Rio Crespo,'RO',1100262,5150.0,5150,429.2,429.2,1,235.0,235.0,Pequeno I
19,19,110028,21750,15866,4369,1784,6153,9713,20448.0,15013.5,4093.0,2057.75,6150.75,8862.75,245376,180162,49116,24693,73809,106353,2022,'ROLIM DE MOURA',Rolim de Moura,'RO',1100288,2782.0,2782,231.8,231.8,1,112.0,112.0,Médio
20,20,110029,4439,3192,577,1272,1849,1343,4243.67,3046.17,560.0,1272.08,1832.08,1214.08,50924,36554,6720,15265,21985,14569,2022,'SANTA LUZIA DOESTE',Santa Luzia D´oeste,'RO',1100296,4404.0,4404,367.0,367.0,1,483.0,483.0,Pequeno I
21,21,110030,37847,28243,8716,4033,12749,15494,35185.33,26567.58,7622.75,4481.17,12103.92,14463.67,422224,318811,91473,53774,145247,173564,2022,'VILHENA',Vilhena,'RO',1100304,1098.0,22811,91.5,1900.9,1,203.0,203.0,Médio
22,22,110032,11677,8025,2597,1469,4066,3959,10919.08,7656.17,2281.33,1705.42,3986.75,3669.42,131029,91874,27376,20465,47841,44033,2022,'SAO MIGUEL DO GUAPORE',São Miguel do Guaporé,'RO',1100320,8183.0,8183,681.9,681.9,1,1268.0,1268.0,Pequeno II
23,23,110033,15871,13106,4278,4482,8760,4346,13887.75,11729.17,3880.33,3995.5,7875.83,3853.33,166653,140750,46564,47946,94510,46240,2022,'NOVA MAMORE',Nova Mamoré,'RO',1100338,5357.0,5357,446.4,446.4,1,338.0,338.0,Pequeno II
24,24,110034,8648,6877,2691,1762,4453,2424,8291.75,6666.5,2456.58,2127.08,4583.67,2082.83,99501,79998,29479,25525,55004,24994,2022,'ALVORADA DOESTE',Alvorada D´oeste,'RO',1100346,2766.0,2766,230.5,230.5,1,112.0,112.0,Pequeno I
25,25,110037,5335,4202,1172,1277,2449,1753,5226.58,4238.92,1028.42,1679.67,2708.08,1530.83,62719,50867,12341,20156,32497,18370,2022,'ALTO ALEGRE DOS PARECIS',Alto Alegre Dos Parecis,'RO',1100379,7344.0,7344,612.0,612.0,1,634.0,634.0,Pequeno I
26,26,110040,9272,7469,2121,1860,3981,3488,9026.08,7375.42,1944.17,2271.42,4215.58,3159.83,108313,88505,23330,27257,50587,37918,2022,'ALTO PARAISO',Alto Paraíso,'RO',1100403,5166.0,11027,430.5,918.9,1,742.0,742.0,Pequeno I
27,27,110045,14735,12038,3703,3938,7641,4397,14922.5,12234.83,3404.92,4485.17,7890.08,4344.75,179070,146818,40859,53822,94681,52137,2022,'BURITIS',Buritis,'RO',1100452,1929.0,1929,160.8,160.8,1,576.0,576.0,Pequeno II
28,28,110050,5309,4015,1488,443,1931,2084,5170.67,4024.92,1424.75,561.33,1986.08,2038.83,62048,48299,17097,6736,23833,24466,2022,'NOVO HORIZONTE DO OESTE',Novo Horizonte do Oeste,'RO',1100502,4399.0,4399,366.6,366.6,1,356.0,356.0,Pequeno I
29,29,110060,3138,2217,594,506,1100,1117,2962.0,2157.08,567.42,547.33,1114.75,1042.33,35544,25885,6809,6568,13377,12508,2022,'CACAULANDIA',Cacaulândia,'RO',1100601,5295.0,5295,441.2,441.2,1,215.0,215.0,Pequeno I
30,30,110070,5393,4153,1174,873,2047,2106,5286.33,4170.42,1267.67,941.0,2208.67,1961.75,63436,50045,15212,11292,26504,23541,2022,'CAMPO NOVO DE RONDONIA',Campo Novo de Rondônia,'RO',1100700,4140.0,4140,345.0,345.0,1,180.0,180.0,Pequeno I
31,31,110080,17787,15089,3407,7503,10910,4179,16805.33,14511.92,2780.17,8374.08,11154.25,3357.67,201664,174143,33362,100489,133851,40292,2022,'CANDEIAS DO JAMARI',Candeias do Jamari,'RO',1100809,2838.0,13833,236.5,1152.8,1,891.0,891.0,Pequeno I
32,32,110090,1826,1417,394,389,783,634,1759.67,1387.25,366.75,385.67,752.42,634.83,21116,16647,4401,4628,9029,7618,2022,'CASTANHEIRAS',Castanheiras,'RO',1100908,133.0,133,14.8,14.8,1,8.0,8.0,Pequeno I
33,33,110092,4404,3501,813,1712,2525,976,4125.5,3281.25,650.5,1701.17,2351.67,929.58,49506,39375,7806,20414,28220,11155,2022,'CHUPINGUAIA',Chupinguaia,'RO',1100924,1411.0,1411,117.6,117.6,1,88.0,88.0,Pequeno I
34,34,110094,9367,7659,3103,1077,4180,3479,9188.5,7609.92,3179.83,1177.25,4357.08,3252.83,110262,91319,38158,14127,52285,39034,2022,'CUJUBIM',Cujubim,'RO',1100940,8722.0,8722,726.8,726.8,1,404.0,404.0,Pequeno I
35,35,110100,5732,4895,1820,1567,3387,1508,5524.83,4740.17,1583.92,1781.75,3365.67,1374.5,66298,56882,19007,21381,40388,16494,2022,'GOVERNADOR JORGE TEIXEIRA',Governador Jorge Teixeira,'RO',1101005,3939.0,3939,328.2,328.2,2,268.0,268.0,Pequeno I
36,36,110110,5496,4485,1460,935,2395,2090,5267.67,4343.08,1402.83,1098.17,2501.0,1842.08,63212,52117,16834,13178,30012,22105,2022,'ITAPUA DO OESTE',Itapuã do Oeste,'RO',1101104,4313.0,4313,359.4,359.4,1,162.0,162.0,Pequeno I
37,37,110120,4254,3295,864,910,1774,1521,4022.08,3256.5,821.5,1053.33,1874.83,1381.67,48265,39078,9858,12640,22498,16580,2022,'MINISTRO ANDREAZZA',Ministro Andreazza,'RO',1101203,5353.0,5353,446.1,446.1,1,854.0,854.0,Pequeno I
38,38,110130,7768,5384,1109,661,1770,3614,7579.58,5328.17,873.83,573.33,1447.17,3881.0,90955,63938,10486,6880,17366,46572,2022,'MIRANTE DA SERRA',Mirante da Serra,'RO',1101302,7303.0,7303,608.6,608.6,1,613.0,613.0,Pequeno I
39,39,110140,7850,6302,1438,2692,4130,2172,7291.67,5875.5,1244.58,2420.25,3664.83,2210.67,87500,70506,14935,29043,43978,26528,2022,'MONTE NEGRO',Monte Negro,'RO',1101401,5732.0,8698,477.7,724.8,1,289.0,289.0,Pequeno I
40,40,110143,4373,3469,1091,1024,2115,1354,4162.17,3339.67,1013.58,959.0,1972.58,1367.08,49946,40076,12163,11508,23671,16405,2022,'NOVA UNIAO',Nova União,'RO',1101435,2941.0,2941,245.1,245.1,1,305.0,305.0,Pequeno I
41,41,110145,2820,1974,478,806,1284,690,2753.92,1926.42,438.58,807.83,1246.42,680.0,33047,23117,5263,9694,14957,8160,2022,'PARECIS',Parecis,'RO',1101450,1672.0,1672,139.3,139.3,1,94.0,94.0,Pequeno I
42,42,110146,1549,1189,340,465,805,384,1473.33,1166.42,244.5,551.25,795.75,370.67,17680,13997,2934,6615,9549,4448,2022,'PIMENTEIRAS DO OESTE',Pimenteiras do Oeste,'RO',1101468,2693.0,2693,224.4,224.4,1,23.0,23.0,Pequeno I
43,43,110147,2276,1682,265,754,1019,663,2187.92,1625.5,263.83,692.25,956.08,669.42,26255,19506,3166,8307,11473,8033,2022,'PRIMAVERA DE RONDONIA',Primavera de Rondônia,'RO',1101476,4263.0,4263,355.2,355.2,1,115.0,115.0,Pequeno I
44,44,110148,3005,1769,475,141,616,1153,2899.0,1729.75,488.83,196.83,685.67,1044.08,34788,20757,5866,2362,8228,12529,2022,'SAO FELIPE DOESTE',São Felipe D´oeste,'RO',1101484,2095.0,2095,174.6,174.6,1,64.0,64.0,Pequeno I
45,45,110149,10043,7953,2851,1978,4829,3124,9668.33,7721.42,2633.92,2130.17,4764.08,2957.33,116020,92657,31607,25562,57169,35488,2022,'SAO FRANCISCO DO GUAPORE',São Francisco do Guaporé,'RO',1101492,1862.0,1862,155.2,155.2,1,104.0,104.0,Pequeno I
46,46,110150,7306,5589,1925,950,2875,2714,7334.33,5718.17,1842.25,1504.33,3346.58,2371.58,88012,68618,22107,18052,40159,28459,2022,'SERINGUEIRAS',Seringueiras,'RO',1101500,2063.0,2063,171.9,171.9,1,284.0,284.0,Pequeno I
47,47,110155,2753,1998,444,731,1175,823,2602.92,1944.75,446.5,710.5,1157.0,787.75,31235,23337,5358,8526,13884,9453,2022,'TEIXEIROPOLIS',Teixeirópolis,'RO',1101559,936.0,936,78.0,78.0,1,83.0,83.0,Pequeno I
48,48,110160,4846,3809,1403,698,2101,1708,4692.83,3770.25,1210.58,914.42,2125.0,1645.25,56314,45243,14527,10973,25500,19743,2022,'THEOBROMA',Theobroma,'RO',1101609,5108.0,5108,425.7,425.7,1,213.0,213.0,Pequeno I
49,49,110170,6035,4380,747,2324,3071,1309,5841.58,4301.0,684.92,2324.25,3009.17,1291.83,70099,51612,8219,27891,36110,15502,2022,'URUPA',Urupá,'RO',1101708,5506.0,5506,458.8,458.8,1,334.0,334.0,Pequeno I
50,50,110175,6788,5060,1019,2085,3104,1956,6447.5,4837.5,914.25,1955.83,2870.08,1967.42,77370,58050,10971,23470,34441,23609,2022,'VALE DO ANARI',Vale do Anari,'RO',1101757,4299.0,4299,358.2,358.2,1,120.0,120.0,Pequeno I
51,51,110180,4042,3122,476,1479,1955,1167,4139.08,3229.92,433.83,1655.0,2088.83,1141.08,49669,38759,5206,19860,25066,13693,2022,'VALE DO PARAISO',Vale do Paraíso,'RO',1101807,6215.0,6215,517.9,517.9,1,438.0,438.0,Pequeno I
52,52,120001,10872,9638,1573,6142,7715,1923,10555.83,9430.75,1509.5,6180.33,7689.83,1740.92,126670,113169,18114,74164,92278,20891,2022,'ACRELANDIA',Acrelândia,'AC',1200013,4812.0,4812,401.0,401.0,1,409.0,409.0,Pequeno I
53,53,120005,8194,7761,930,5849,6779,982,7884.5,7566.67,778.33,6012.25,6790.58,776.08,94614,90800,9340,72147,81487,9313,2022,'ASSIS BRASIL',Assis Brasil,'AC',1200054,6907.0,6907,575.6,575.6,1,700.0,700.0,Pequeno I
54,54,120010,18161,16684,1331,13104,14435,2249,17181.67,15861.67,1228.5,12551.17,13779.67,2082.0,206180,190340,14742,150614,165356,24984,2022,'BRASILEIA',Brasiléia,'AC',1200104,10340.0,12499,861.7,1041.6,1,1313.0,1313.0,Pequeno II
55,55,120013,8825,8208,2455,4023,6478,1730,8468.42,7968.25,1950.33,4591.5,6541.83,1426.42,101621,95619,23404,55098,78502,17117,2022,'BUJARI',Bujari,'AC',1200138,2303.0,2303,191.9,191.9,1,83.0,83.0,Pequeno I
56,56,120017,9063,8265,1105,5676,6781,1484,8737.42,8051.92,1085.58,5618.5,6704.08,1347.83,104849,96623,13027,67422,80449,16174,2022,'CAPIXABA',Capixaba,'AC',1200179,3543.0,3543,295.2,295.2,1,473.0,473.0,Pequeno I
57,57,120020,60517,57798,4462,45671,50133,7665,59357.67,56846.33,4261.83,45952.25,50214.08,6632.25,712292,682156,51142,551427,602569,79587,2022,'CRUZEIRO DO SUL',Cruzeiro do Sul,'AC',1200203,2966.0,2966,247.2,247.2,1,187.0,187.0,Médio
58,58,120025,10550,9585,1388,6634,8022,1563,9961.83,9086.08,1081.5,6722.33,7803.83,1282.25,119542,109033,12978,80668,93646,15387,2022,'EPITACIOLANDIA',Epitaciolândia,'AC',1200252,2877.0,2877,239.8,239.8,1,135.0,135.0,Pequeno I
59,59,120030,27327,26297,2170,20273,22443,3854,26644.25,25710.83,2088.0,20218.17,22306.17,3404.67,319731,308530,25056,242618,267674,40856,2022,'FEIJO',Feijó,'AC',1200302,6937.0,6937,578.1,578.1,1,440.0,440.0,Pequeno II
60,60,120032,8294,8034,609,6657,7266,768,8134.92,7936.33,601.42,6692.83,7294.25,642.08,97619,95236,7217,80314,87531,7705,2022,'JORDAO',Jordão,'AC',1200328,4017.0,5187,334.8,432.2,1,408.0,408.0,Pequeno I
61,61,120033,16079,15473,541,13438,13979,1494,15950.58,15385.58,560.83,13422.33,13983.17,1402.42,191407,184627,6730,161068,167798,16829,2022,'MANCIO LIMA',Mâncio Lima,'AC',1200336,5535.0,5535,461.2,461.2,1,433.0,433.0,Pequeno I
62,62,120034,10631,9864,688,8075,8763,1101,10412.17,9691.33,632.67,8027.5,8660.17,1031.17,124946,116296,7592,96330,103922,12374,2022,'MANOEL URBANO',Manoel Urbano,'AC',1200344,1105.0,1105,92.1,92.1,1,400.0,400.0,Pequeno I
63,63,120035,15807,15163,975,12846,13821,1342,15523.25,14986.33,1043.75,12681.0,13724.75,1261.58,186279,179836,12525,152172,164697,15139,2022,'MARECHAL THAUMATURGO',Marechal Thaumaturgo,'AC',1200351,8833.0,8833,736.1,736.1,1,164.0,164.0,Pequeno I
64,64,120038,10303,9433,1484,5896,7380,2053,9662.0,8914.67,1338.75,5841.5,7180.25,1734.42,115944,106976,16065,70098,86163,20813,2022,'PLACIDO DE CASTRO',Plácido de Castro,'AC',1200385,1425.0,1425,118.8,118.8,1,84.0,84.0,Pequeno I
65,65,120039,9293,8944,743,7128,7871,1073,9080.92,8786.33,700.42,7091.67,7792.08,994.25,108971,105436,8405,85100,93505,11931,2022,'PORTO WALTER',Porto Walter,'AC',1200393,1211.0,1211,100.9,100.9,1,252.0,252.0,Pequeno I
66,66,120040,184085,168848,22815,110438,133253,35595,168591.92,155529.08,20524.25,103659.67,124183.92,31345.17,2023103,1866349,246291,1243916,1490207,376142,2022,'RIO BRANCO',Rio Branco,'AC',1200401,114233.0,114233,9519.4,9519.4,8,7364.0,7364.0,Grande
67,67,120042,13064,12439,775,10150,10925,1514,12974.42,12447.83,759.58,10363.92,11123.5,1324.33,155693,149374,9115,124367,133482,15892,2022,'RODRIGUES ALVES',Rodrigues Alves,'AC',1200427,3850.0,3850,320.8,320.8,1,351.0,351.0,Pequeno I
68,68,120043,6444,6043,358,4900,5258,785,6290.25,5982.92,297.42,5167.42,5464.83,518.08,75483,71795,3569,62009,65578,6217,2022,'SANTA ROSA DO PURUS',Santa Rosa do Purus,'AC',1200435,1398.0,1398,116.5,116.5,1,200.0,200.0,Pequeno I
69,69,120045,16805,15326,1499,11609,13108,2218,16522.83,15285.17,1151.17,12417.83,13569.0,1716.17,198274,183422,13814,149014,162828,20594,2022,'SENADOR GUIOMARD',Senador Guiomard,'AC',1200450,1182.0,1182,98.5,98.5,1,150.0,150.0,Pequeno II
70,70,120050,36314,34916,1970,29450,31420,3496,35653.58,34365.0,1960.0,29143.92,31103.92,3261.08,427843,412380,23520,349727,373247,39133,2022,'SENA MADUREIRA',Sena Madureira,'AC',1200500,4171.0,4171,347.6,347.6,1,206.0,206.0,Pequeno II
71,71,120060,40257,38696,2361,32972,35333,3363,39326.17,37944.92,2328.83,32785.5,35114.33,2830.58,471914,455339,27946,393426,421372,33967,2022,'TARAUACA',Tarauacá,'AC',1200609,841.0,841,70.1,70.1,1,73.0,73.0,Pequeno II
72,72,120070,11735,10889,1685,7246,8931,1958,11267.42,10537.25,1315.42,7482.17,8797.58,1739.67,135209,126447,15785,89786,105571,20876,2022,'XAPURI',Xapuri,'AC',1200708,6208.0,6208,517.3,517.3,1,412.0,412.0,Pequeno I
73,73,120080,15941,14951,1734,11395,13129,1822,15149.5,14290.83,1606.75,11019.58,12626.33,1664.5,181794,171490,19281,132235,151516,19974,2022,'PORTO ACRE',Porto Acre,'AC',1200807,4986.0,8591,415.5,715.9,1,461.0,461.0,Pequeno I
74,74,130002,13153,12453,1223,10360,11583,870,13003.0,12420.5,904.58,10791.83,11696.42,724.08,156036,149046,10855,129502,140357,8689,2022,'ALVARAES',Alvarães,'AM',1300029,1399.0,28312,116.6,2359.3,1,0.0,2515.0,Pequeno I
75,75,130006,9834,9005,1905,5467,7372,1633,9669.0,8874.67,1543.75,5824.42,7368.17,1506.5,116028,106496,18525,69893,88418,18078,2022,'AMATURA',Amaturá,'AM',1300060,6351.0,6351,529.2,529.2,1,34.0,34.0,Pequeno I
76,76,130008,9898,9242,586,7623,8209,1033,9824.42,9247.25,528.83,7731.58,8260.42,986.83,117893,110967,6346,92779,99125,11842,2022,'ANAMA',Anamã,'AM',1300086,2490.0,2490,207.5,207.5,1,134.0,134.0,Pequeno I
77,77,130010,12694,11821,378,10681,11059,762,12215.17,11414.92,347.0,10309.58,10656.58,758.33,146582,136979,4164,123715,127879,9100,2022,'ANORI',Anori,'AM',1300102,6820.0,13492,568.3,1124.3,1,855.0,855.0,Pequeno I
78,78,130014,12210,10357,2001,6133,8134,2223,11382.5,9859.83,1641.42,6235.5,7876.92,1982.92,136590,118318,19697,74826,94523,23795,2022,'APUI',Apuí,'AM',1300144,8365.0,8365,697.1,697.1,1,513.0,513.0,Pequeno I
79,79,130020,11873,11254,766,9042,9808,1446,11883.92,11323.5,746.92,9303.33,10050.25,1273.25,142607,135882,8963,111640,120603,15279,2022,'ATALAIA DO NORTE',Atalaia do Norte,'AM',1300201,1248.0,1248,104.0,104.0,1,145.0,145.0,Pequeno I
80,80,130030,40654,39180,512,37127,37639,1541,38308.75,36962.83,596.0,34754.67,35350.67,1612.17,459705,443554,7152,417056,424208,19346,2022,'AUTAZES',Autazes,'AM',1300300,14108.0,21168,1175.7,1764.0,1,800.0,800.0,Pequeno II
81,81,130040,13292,12158,1601,9038,10639,1519,12963.75,11923.0,1292.75,9286.08,10578.83,1344.17,155565,143076,15513,111433,126946,16130,2022,'BARCELOS',Barcelos,'AM',1300409,4754.0,4754,396.2,396.2,1,211.0,211.0,Pequeno II
82,82,130050,28971,27139,1361,23745,25106,2033,28628.75,26896.83,1120.92,24238.83,25359.75,1537.08,343545,322762,13451,290866,304317,18445,2022,'BARREIRINHA',Barreirinha,'AM',1300508,7972.0,7972,664.3,664.3,1,493.0,493.0,Pequeno II
83,83,130060,32139,30388,2196,24958,27154,3234,31536.08,29912.92,2227.17,24789.0,27016.17,2896.75,378433,358955,26726,297468,324194,34761,2022,'BENJAMIN CONSTANT',Benjamin Constant,'AM',1300607,8022.0,8022,668.5,668.5,1,332.0,332.0,Pequeno II
84,84,130063,22663,21617,836,19628,20464,1153,22500.17,21560.0,829.67,19666.5,20496.17,1063.83,270002,258720,9956,235998,245954,12766,2022,'BERURI',Beruri,'AM',1300631,2049.0,2049,170.8,170.8,1,150.0,150.0,Pequeno I
85,85,130068,13430,12409,884,9770,10654,1755,13478.83,12546.67,912.67,9960.42,10873.08,1673.58,161746,150560,10952,119525,130477,20083,2022,'BOA VISTA DO RAMOS',Boa Vista do Ramos,'AM',1300680,1425.0,20270,118.8,1689.2,1,85.0,85.0,Pequeno I
86,86,130070,23342,21532,1620,17333,18953,2579,22619.67,20908.42,1207.83,17485.33,18693.17,2215.25,271436,250901,14494,209824,224318,26583,2022,'BOCA DO ACRE',Boca do Acre,'AM',1300706,2850.0,2850,237.5,237.5,1,450.0,450.0,Pequeno II
87,87,130080,27833,26296,1195,23087,24282,2014,27611.5,26311.17,1316.08,23311.5,24627.58,1683.58,331338,315734,15793,279738,295531,20203,2022,'BORBA',Borba,'AM',1300805,11925.0,11925,993.8,993.8,1,724.0,724.0,Pequeno II
88,88,130083,9917,9373,812,7675,8487,886,9635.33,9161.75,823.42,7516.42,8339.83,821.92,115624,109941,9881,90197,100078,9863,2022,'CAAPIRANGA',Caapiranga,'AM',1300839,5104.0,8732,425.3,727.7,1,374.0,374.0,Pequeno I
89,89,130090,12492,11856,218,10801,11019,837,11951.25,11376.17,188.58,10490.42,10679.0,697.17,143415,136514,2263,125885,128148,8366,2022,'CANUTAMA',Canutama,'AM',1300904,1356.0,1356,113.0,113.0,1,101.0,101.0,Pequeno I
90,90,130100,25308,23700,419,22177,22596,1104,25035.17,23565.75,353.0,22331.17,22684.17,881.58,300422,282789,4236,267974,272210,10579,2022,'CARAUARI',Carauari,'AM',1301001,7549.0,7549,629.1,629.1,1,780.0,780.0,Pequeno II
91,91,130110,26280,23753,4064,16290,20354,3399,25354.17,23085.5,3299.67,16921.42,20221.08,2864.42,304250,277026,39596,203057,242653,34373,2022,'CAREIRO',Careiro,'AM',1301100,11201.0,11201,933.4,933.4,2,489.0,489.0,Pequeno II
92,92,130115,17274,16226,457,14261,14718,1508,17000.08,16062.17,447.08,14327.83,14774.92,1287.25,204001,192746,5365,171934,177299,15447,2022,'CAREIRO DA VARZEA',Careiro da Várzea,'AM',1301159,5853.0,5853,487.8,487.8,1,328.0,328.0,Pequeno II
93,93,130120,56052,53214,4833,44090,48923,4291,52400.75,49866.42,4307.33,41470.33,45777.67,4088.75,628809,598397,51688,497644,549332,49065,2022,'COARI',Coari,'AM',1301209,9800.0,9800,816.7,816.7,2,891.0,891.0,Médio
94,94,130130,19172,17099,1771,13066,14837,2262,18704.25,16742.17,1616.33,12922.0,14538.33,2203.83,224451,200906,19396,155064,174460,26446,2022,'CODAJAS',Codajás,'AM',1301308,3542.0,3542,295.2,295.2,1,329.0,329.0,Pequeno II
95,95,130140,26862,25641,1434,22175,23609,2032,26355.33,25183.0,1430.08,21771.0,23201.08,1981.92,316264,302196,17161,261252,278413,23783,2022,'EIRUNEPE',Eirunepé,'AM',1301407,2213.0,2213,184.4,184.4,1,132.0,132.0,Pequeno II
96,96,130150,14281,13958,387,12915,13302,656,14272.42,13975.33,413.25,12951.33,13364.58,610.75,171269,167704,4959,155416,160375,7329,2022,'ENVIRA',Envira,'AM',1301506,790.0,790,65.8,65.8,1,45.0,45.0,Pequeno I
97,97,130160,21171,19843,892,17660,18552,1291,20331.33,19131.83,909.5,17031.92,17941.42,1190.42,243976,229582,10914,204383,215297,14285,2022,'FONTE BOA',Fonte Boa,'AM',1301605,2803.0,2803,233.6,233.6,1,500.0,500.0,Pequeno II
98,98,130165,13338,13062,625,11652,12277,785,13001.67,12751.33,573.5,11543.33,12116.83,634.5,156020,153016,6882,138520,145402,7614,2022,'GUAJARA',Guajará,'AM',1301654,550.0,20346,45.8,1695.5,1,550.0,550.0,Pequeno I
99,99,130170,39505,36280,1402,32200,33602,2678,37145.25,34158.42,1699.25,29903.67,31602.92,2555.5,445743,409901,20391,358844,379235,30666,2022,'HUMAITA',Humaitá,'AM',1301704,8189.0,8189,682.4,682.4,1,563.0,563.0,Pequeno II
100,100,130180,15060,14800,228,14237,14465,335,14928.58,14669.75,228.08,14133.42,14361.5,308.25,179143,176037,2737,169601,172338,3699,2022,'IPIXUNA',Ipixuna,'AM',1301803,6349.0,6349,529.1,529.1,1,609.0,609.0,Pequeno II
101,101,130185,52585,47881,2128,42826,44954,2927,50521.83,46196.08,1945.33,41558.25,43503.58,2692.5,606262,554353,23344,498699,522043,32310,2022,'IRANDUBA',Iranduba,'AM',1301852,5874.0,25215,489.5,2101.2,1,1202.0,1202.0,Pequeno II
102,102,130190,71949,65315,5617,50312,55929,9386,67783.25,61692.33,5269.92,48139.58,53409.5,8282.83,813399,740308,63239,577675,640914,99394,2022,'ITACOATIARA',Itacoatiara,'AM',1301902,17846.0,17846,1487.2,1487.2,2,1126.0,1126.0,Médio
103,103,130195,9766,9180,457,7839,8296,884,9497.08,8903.75,445.08,7598.42,8043.5,860.25,113965,106845,5341,91181,96522,10323,2022,'ITAMARATI',Itamarati,'AM',1301951,1695.0,1695,141.2,141.2,1,299.0,299.0,Pequeno I
104,104,130200,8702,7820,621,6114,6735,1085,8291.92,7523.92,480.25,6247.33,6727.58,796.33,99503,90287,5763,74968,80731,9556,2022,'ITAPIRANGA',Itapiranga,'AM',1302009,1148.0,1148,95.7,95.7,1,480.0,480.0,Pequeno I
105,105,130210,6303,6046,677,4728,5405,641,5715.92,5508.58,590.58,4415.5,5006.08,502.5,68591,66103,7087,52986,60073,6030,2022,'JAPURA',Japurá,'AM',1302108,343.0,343,28.6,28.6,1,28.0,28.0,Pequeno I
106,106,130220,8673,8015,281,7290,7571,444,8377.25,7794.58,263.75,7097.42,7361.17,433.42,100527,93535,3165,85169,88334,5201,2022,'JURUA',Juruá,'AM',1302207,1079.0,1079,89.9,89.9,1,27.0,27.0,Pequeno I
107,107,130230,21564,20516,1043,18169,19212,1304,20915.67,19928.75,1089.58,17622.25,18711.83,1216.92,250988,239145,13075,211467,224542,14603,2022,'JUTAI',Jutaí,'AM',1302306,537.0,3175,44.8,264.6,1,250.0,250.0,Pequeno I
108,108,130240,40062,36364,691,33471,34162,2202,39413.08,35982.58,811.83,33119.5,33931.33,2051.25,472957,431791,9742,397434,407176,24615,2022,'LABREA',Lábrea,'AM',1302405,5009.0,5009,417.4,417.4,1,200.0,200.0,Pequeno II
109,109,130250,84945,79496,4220,67119,71339,8157,83063.08,78052.5,4027.83,66781.58,70809.42,7243.08,996757,936630,48334,801379,849713,86917,2022,'MANACAPURU',Manacapuru,'AM',1302504,15758.0,38412,1313.2,3201.0,2,2126.0,2126.0,Médio
110,110,130255,16522,14968,677,12232,12909,2059,16334.92,14936.58,677.5,12296.58,12974.08,1962.5,196019,179239,8130,147559,155689,23550,2022,'MANAQUIRI',Manaquiri,'AM',1302553,11725.0,11725,977.1,977.1,1,852.0,852.0,Pequeno II
111,111,130260,1000705,911782,181376,577928,759304,152478,860837.75,782452.5,169706.08,470518.08,640224.17,142228.33,10330053,9389430,2036473,5646217,7682690,1706740,2022,'MANAUS',Manaus,'AM',1302603,350503.0,355518,29208.6,29626.5,20,20485.0,20485.0,Metrópole
112,112,130270,37284,34170,6158,22572,28730,5440,36097.25,33179.08,5309.25,22551.17,27860.42,5318.67,433167,398149,63711,270614,334325,63824,2022,'MANICORE',Manicoré,'AM',1302702,7020.0,13629,585.0,1135.8,1,0.0,4300.0,Pequeno II
113,113,130280,15039,14572,599,13448,14047,525,14837.67,14432.75,502.5,13478.75,13981.25,451.5,178052,173193,6030,161745,167775,5418,2022,'MARAA',Maraã,'AM',1302801,1909.0,5360,159.1,446.7,1,0.0,1100.0,Pequeno I
114,114,130290,50804,48226,1771,44206,45977,2249,48452.0,46062.08,2143.42,41510.25,43653.67,2408.42,581424,552745,25721,498123,523844,28901,2022,'MAUES',Maués,'AM',1302900,38610.0,86866,3217.5,7238.8,3,0.0,8708.0,Médio
115,115,130300,17537,16599,639,14225,14864,1735,17339.67,16521.5,785.75,14250.67,15036.42,1485.08,208076,198258,9429,171008,180437,17821,2022,'NHAMUNDA',Nhamundá,'AM',1303007,1313.0,1313,109.4,109.4,1,56.0,56.0,Pequeno I
116,116,130310,24650,23167,1077,20337,21414,1753,23581.08,22287.42,1186.67,19375.92,20562.58,1724.83,282973,267449,14240,232511,246751,20698,2022,'NOVA OLINDA DO NORTE',Nova Olinda do Norte,'AM',1303106,4694.0,4694,391.2,391.2,1,351.0,351.0,Pequeno II
117,117,130320,12521,11528,1427,8483,9910,1618,12229.58,11353.92,1322.42,8653.17,9975.58,1378.33,146755,136247,15869,103838,119707,16540,2022,'NOVO AIRAO',Novo Airão,'AM',1303205,2322.0,2322,193.5,193.5,1,80.0,80.0,Pequeno I
118,118,130330,15597,14303,783,12210,12993,1310,15482.42,14260.0,813.33,12252.25,13065.58,1194.42,185789,171120,9760,147027,156787,14333,2022,'NOVO ARIPUANA',Novo Aripuanã,'AM',1303304,2391.0,2391,199.2,199.2,1,202.0,202.0,Pequeno II
119,119,130340,79449,74617,3823,65098,68921,5696,77647.08,73207.0,3415.42,64615.58,68031.0,5176.0,931765,878484,40985,775387,816372,62112,2022,'PARINTINS',Parintins,'AM',1303403,59828.0,67105,4985.7,5592.1,4,6781.0,6781.0,Grande
120,120,130350,15077,14425,758,12498,13256,1169,14980.58,14379.92,723.75,12586.08,13309.83,1070.08,179767,172559,8685,151033,159718,12841,2022,'PAUINI',Pauini,'AM',1303502,3970.0,3970,330.8,330.8,1,302.0,302.0,Pequeno I
121,121,130353,23730,21306,3058,14899,17957,3349,22745.25,20550.25,2590.58,15137.5,17728.08,2822.17,272943,246603,31087,181650,212737,33866,2022,'PRESIDENTE FIGUEIREDO',Presidente Figueiredo,'AM',1303536,7795.0,13168,649.6,1097.3,1,605.0,605.0,Pequeno II
122,122,130356,19227,17585,3313,10917,14230,3355,18268.75,16780.25,2743.67,11028.33,13772.0,3008.25,219225,201363,32924,132340,165264,36099,2022,'RIO PRETO DA EVA',Rio Preto da Eva,'AM',1303569,9232.0,13301,769.3,1108.4,1,0.0,2004.0,Pequeno II
123,123,130360,10867,9977,363,8878,9241,736,10564.5,9771.67,314.42,8841.75,9156.17,615.5,126774,117260,3773,106101,109874,7386,2022,'SANTA ISABEL DO RIO NEGRO',Santa Isabel do Rio Negro,'AM',1303601,5710.0,9788,475.8,815.7,1,726.0,726.0,Pequeno I
124,124,130370,24344,22885,3984,13860,17844,5041,23719.25,22404.83,3106.33,15527.83,18634.17,3770.67,284631,268858,37276,186334,223610,45248,2022,'SANTO ANTONIO DO ICA',Santo Antônio do Içá,'AM',1303700,12118.0,18693,1009.8,1557.8,1,987.0,987.0,Pequeno II
125,125,130380,36787,35820,3559,28650,32209,3611,34782.58,33919.17,3180.58,27771.92,30952.5,2966.67,417391,407030,38167,333263,371430,35600,2022,'SAO GABRIEL DA CACHOEIRA',São Gabriel da Cachoeira,'AM',1303809,6336.0,6336,528.0,528.0,1,335.0,335.0,Pequeno II
126,126,130390,30022,28389,1848,24927,26775,1614,28171.67,26831.92,2050.92,23141.33,25192.25,1639.67,338060,321983,24611,277696,302307,19676,2022,'SAO PAULO DE OLIVENCA',São Paulo de Olivença,'AM',1303908,8812.0,8812,734.3,734.3,1,1173.0,1173.0,Pequeno II
127,127,130395,8493,7670,624,6093,6717,953,8360.58,7649.58,621.42,6092.33,6713.75,935.83,100327,91795,7457,73108,80565,11230,2022,'SAO SEBASTIAO DO UATUMA',São Sebastião do Uatumã,'AM',1303957,2258.0,2258,188.2,188.2,1,214.0,214.0,Pequeno I
128,128,130400,9427,8700,321,7698,8019,681,9217.08,8561.5,300.08,7705.25,8005.33,556.17,110605,102738,3601,92463,96064,6674,2022,'SILVES',Silves,'AM',1304005,3740.0,11542,311.7,961.8,1,652.0,652.0,Pequeno I
129,129,130406,44505,41829,7581,29011,36592,5237,41092.83,38686.75,5714.67,28791.83,34506.5,4180.25,493114,464241,68576,345502,414078,50163,2022,'TABATINGA',Tabatinga,'AM',1304062,17478.0,20386,1456.5,1698.8,1,1232.0,1232.0,Médio
130,130,130410,16724,15562,4263,8753,13016,2546,16321.92,15223.58,4117.0,8526.08,12643.08,2580.5,195863,182683,49404,102313,151717,30966,2022,'TAPAUA',Tapauá,'AM',1304104,6013.0,8515,501.1,709.6,1,741.0,741.0,Pequeno I
131,131,130420,55369,51646,6297,37670,43967,7679,53052.42,49660.58,5063.83,38342.42,43406.25,6254.33,636629,595927,60766,460109,520875,75052,2022,'TEFE',Tefé,'AM',1304203,26537.0,35239,2211.4,2936.6,2,1316.0,7464.0,Médio
132,132,130423,15083,14237,1007,12156,13163,1074,14707.17,13957.25,819.25,12260.17,13079.42,877.83,176486,167487,9831,147122,156953,10534,2022,'TONANTINS',Tonantins,'AM',1304237,6420.0,6420,535.0,535.0,1,659.0,659.0,Pequeno I
133,133,130426,12137,11673,194,10875,11069,604,11749.0,11390.25,225.92,10678.75,10904.67,485.58,140988,136683,2711,128145,130856,5827,2022,'UARINI',Uarini,'AM',1304260,6371.0,6371,530.9,530.9,1,695.0,695.0,Pequeno I
134,134,130430,13528,12440,503,10946,11449,991,13045.5,12072.67,505.58,10650.33,11155.92,916.75,156546,144872,6067,127804,133871,11001,2022,'URUCARA',Urucará,'AM',1304302,4500.0,4500,375.0,375.0,1,625.0,625.0,Pequeno I
135,135,130440,17276,16075,383,15082,15465,610,16809.08,15689.83,391.92,14712.08,15104.0,585.83,201709,188278,4703,176545,181248,7030,2022,'URUCURITUBA',Urucurituba,'AM',1304401,2103.0,2103,175.2,175.2,1,28.0,28.0,Pequeno I
136,136,140002,8040,7524,539,6157,6696,828,7623.42,7175.42,412.5,6112.33,6524.83,650.58,91481,86105,4950,73348,78298,7807,2022,'AMAJARI',Amajari,'RR',1400027,299.0,299,27.2,27.2,1,,,Pequeno I
137,137,140005,10479,9860,2442,6384,8826,1034,9981.08,9406.0,1531.75,7004.83,8536.58,869.42,119773,112872,18381,84058,102439,10433,2022,'ALTO ALEGRE',Alto Alegre,'RR',1400050,2140.0,2140,178.3,178.3,2,468.0,468.0,Pequeno I
138,138,140010,164918,146037,37479,61067,98546,47491,155479.83,138519.58,34294.58,63010.75,97305.33,41214.25,1865758,1662235,411535,756129,1167664,494571,2022,'BOA VISTA',Boa Vista,'RR',1400100,107828.0,193671,8985.7,16139.2,7,10727.0,14259.0,Grande
139,139,140015,14096,13067,717,11688,12405,662,12778.42,11875.0,737.25,10497.58,11234.83,640.17,153341,142500,8847,125971,134818,7682,2022,'BONFIM',Bonfim,'RR',1400159,3347.0,3347,334.7,334.7,1,80.0,80.0,Pequeno I
140,140,140017,16694,15600,934,13247,14181,1419,15453.83,14508.75,825.42,12501.25,13326.67,1182.08,185446,174105,9905,150015,159920,14185,2022,'CANTA',Cantá,'RR',1400175,2338.0,2338,194.8,194.8,1,104.0,104.0,Pequeno I
141,141,140020,17364,16105,1261,12694,13955,2150,16466.08,15379.17,1098.67,12494.25,13592.92,1786.25,197593,184550,13184,149931,163115,21435,2022,'CARACARAI',Caracaraí,'RR',1400209,1875.0,1875,156.2,156.2,2,75.0,75.0,Pequeno I
142,142,140023,8767,7839,1000,5914,6914,925,8258.75,7428.83,883.75,5647.58,6531.33,897.5,99105,89146,10605,67771,78376,10770,2022,'CAROEBE',Caroebe,'RR',1400233,6238.0,6238,519.8,519.8,1,1000.0,1000.0,Pequeno I
143,143,140028,5868,5346,362,4161,4523,823,5571.08,5122.33,319.75,4085.92,4405.67,716.67,66853,61468,3837,49031,52868,8600,2022,'IRACEMA',Iracema,'RR',1400282,168.0,168,21.0,21.0,1,,,Pequeno I
144,144,140030,16355,15508,507,14397,14904,604,15157.17,14369.08,417.75,13382.5,13800.25,568.83,181886,172429,5013,160590,165603,6826,2022,'MUCAJAI',Mucajaí,'RR',1400308,3187.0,3187,265.6,265.6,1,115.0,115.0,Pequeno I
145,145,140040,12210,11820,543,10731,11274,546,11359.42,11037.58,514.83,10106.92,10621.75,415.83,136313,132451,6178,121283,127461,4990,2022,'NORMANDIA',Normandia,'RR',1400407,1474.0,1474,122.8,122.8,1,26.0,26.0,Pequeno I
146,146,140045,14327,13529,2891,8497,11388,2141,11816.42,11109.83,1941.25,7550.5,9491.75,1618.08,141797,133318,23295,90606,113901,19417,2022,'PACARAIMA',Pacaraima,'RR',1400456,3603.0,3603,300.2,300.2,1,116.0,116.0,Pequeno I
147,147,140047,19737,17884,2422,12502,14924,2960,18947.67,17262.42,2038.5,12637.08,14675.58,2586.83,227372,207149,24462,151645,176107,31042,2022,'RORAINOPOLIS',Rorainópolis,'RR',1400472,648.0,648,324.0,324.0,1,,,Pequeno II
148,148,140050,5507,5036,776,3425,4201,835,5039.25,4646.33,637.75,3349.83,3987.58,658.75,60471,55756,7653,40198,47851,7905,2022,'SAO JOAO DA BALIZA',São João da Baliza,'RR',1400506,2399.0,2399,199.9,199.9,1,10.0,10.0,Pequeno I
149,149,140060,5811,5420,480,4560,5040,380,5331.42,4963.33,382.25,4200.42,4582.67,380.67,63977,59560,4587,50405,54992,4568,2022,'SAO LUIZ',São Luiz,'RR',1400605,276.0,276,23.0,23.0,1,23.0,23.0,Pequeno I
150,150,140070,11685,11520,1024,9630,10654,866,10873.75,10746.92,879.67,9184.75,10064.42,682.5,130485,128963,10556,110217,120773,8190,2022,'UIRAMUTA',Uiramutã,'RR',1400704,2390.0,2390,199.2,199.2,1,216.0,216.0,Pequeno I
151,151,150010,132838,124573,2762,111271,114033,10540,126182.33,119147.08,2726.83,106523.83,109250.67,9896.42,1514188,1429765,32722,1278286,1311008,118757,2022,'ABAETETUBA',Abaetetuba,'PA',1500107,26806.0,26806,2233.8,2233.8,8,1847.0,1847.0,Grande
152,152,150013,5652,5180,255,4456,4711,469,5417.5,4995.0,219.33,4355.75,4575.08,419.92,65010,59940,2632,52269,54901,5039,2022,'ABEL FIGUEIREDO',Abel Figueiredo,'PA',1500131,2349.0,2349,195.8,195.8,1,141.0,141.0,Pequeno I
153,153,150020,47812,45623,3620,37813,41433,4190,45706.67,43878.17,3458.75,36924.08,40382.83,3495.33,548480,526538,41505,443089,484594,41944,2022,'ACARA',Acará,'PA',1500206,9180.0,9180,765.0,765.0,3,393.0,393.0,Médio
154,154,150030,35778,34422,2048,29907,31955,2467,34488.58,33322.75,1805.08,29641.42,31446.5,1876.25,413863,399873,21661,355697,377358,22515,2022,'AFUA',Afuá,'PA',1500305,9698.0,9698,808.2,808.2,1,931.0,931.0,Pequeno II
155,155,150034,11646,10306,595,8644,9239,1067,11278.08,10107.5,532.58,8660.33,9192.92,914.58,135337,121290,6391,103924,110315,10975,2022,'AGUA AZUL DO NORTE',Água Azul do Norte,'PA',1500347,8065.0,8065,672.1,672.1,2,489.0,489.0,Pequeno II
156,156,150040,46356,43616,1529,40373,41902,1714,44614.92,42071.5,1556.92,39053.17,40610.08,1461.42,535379,504858,18683,468638,487321,17537,2022,'ALENQUER',Alenquer,'PA',1500404,6281.0,6281,523.4,523.4,2,821.0,821.0,Médio
157,157,150050,26452,25197,654,23149,23803,1394,25917.58,24914.83,619.5,23133.58,23753.08,1161.75,311011,298978,7434,277603,285037,13941,2022,'ALMEIRIM',Almeirim,'PA',1500503,8621.0,31468,718.4,2622.3,2,35.0,2336.0,Pequeno II
158,158,150060,71183,62778,9228,40373,49601,13177,66569.58,59147.58,7783.67,40456.0,48239.67,10907.92,798835,709771,93404,485472,578876,130895,2022,'ALTAMIRA',Altamira,'PA',1500602,14103.0,14103,1175.2,1175.2,3,863.0,863.0,Médio
159,159,150070,30343,28907,828,26811,27639,1268,29466.0,28182.0,789.33,26268.25,27057.58,1124.42,353592,338184,9472,315219,324691,13493,2022,'ANAJAS',Anajás,'PA',1500701,2225.0,2225,185.4,185.4,1,61.0,61.0,Pequeno II
160,160,150080,241945,215097,58094,82840,140934,74163,229659.08,205002.92,54359.08,78204.33,132563.42,72439.5,2755909,2460035,652309,938452,1590761,869274,2022,'ANANINDEUA',Ananindeua,'PA',1500800,21320.0,21320,1776.7,1776.7,10,1302.0,1302.0,Grande
161,161,150085,26958,25672,386,24290,24676,996,25472.5,24333.42,367.83,23042.42,23410.25,923.17,305670,292001,4414,276509,280923,11078,2022,'ANAPU',Anapu,'PA',1500859,1445.0,1445,120.4,120.4,1,38.0,38.0,Pequeno II
162,162,150090,39951,38186,1602,33313,34915,3271,38573.33,37117.17,1842.33,32094.08,33936.42,3180.75,462880,445406,22108,385129,407237,38169,2022,'AUGUSTO CORREA',Augusto Corrêa,'PA',1500909,2822.0,2822,235.2,235.2,2,89.0,89.0,Pequeno II
163,163,150095,19525,18170,1177,15693,16870,1300,18755.5,17606.33,878.75,15661.92,16540.67,1065.67,225066,211276,10545,187943,198488,12788,2022,'AURORA DO PARA',Aurora do Pará,'PA',1500958,397.0,397,33.1,33.1,1,10.0,10.0,Pequeno II
164,164,150100,11232,10506,717,8660,9377,1129,10703.0,10060.0,730.5,8206.42,8936.92,1123.08,128436,120720,8766,98477,107243,13477,2022,'AVEIRO',Aveiro,'PA',1501006,3779.0,3779,314.9,314.9,1,21.0,21.0,Pequeno I
165,165,150110,19497,19036,659,17847,18506,530,18581.42,18163.67,646.25,17046.5,17692.75,470.92,222977,217964,7755,204558,212313,5651,2022,'BAGRE',Bagre,'PA',1501105,4834.0,4834,402.8,402.8,1,587.0,587.0,Pequeno II
166,166,150120,26592,25685,674,23316,23990,1695,26233.0,25467.17,673.25,23314.5,23987.75,1479.42,314796,305606,8079,279774,287853,17753,2022,'BAIAO',Baião,'PA',1501204,266.0,266,22.2,22.2,1,14.0,14.0,Pequeno II
167,167,150125,2540,2107,309,1288,1597,510,2355.08,1983.5,300.92,1251.75,1552.67,430.83,28261,23802,3611,15021,18632,5170,2022,'BANNACH',Bannach,'PA',1501253,1969.0,1969,164.1,164.1,1,87.0,87.0,Pequeno I
168,168,150130,76272,69573,12123,44779,56902,12671,70870.58,65143.75,10461.17,43811.33,54272.5,10871.25,850447,781725,125534,525736,651270,130455,2022,'BARCARENA',Barcarena,'PA',1501303,31533.0,31533,2627.8,2627.8,5,2456.0,2456.0,Médio
169,169,150140,719301,649907,62486,459095,521581,128326,680909.0,617384.67,67646.33,416490.17,484136.5,133248.17,8170908,7408616,811756,4997882,5809638,1598978,2022,'BELEM',Belém,'PA',1501402,266617.0,272437,22218.1,22703.1,12,16525.0,16525.0,Metrópole
170,170,150145,14605,13165,4776,5296,10072,3093,14177.67,12884.67,3903.83,6288.0,10191.83,2692.83,170132,154616,46846,75456,122302,32314,2022,'BELTERRA',Belterra,'PA',1501451,855.0,855,71.2,71.2,1,72.0,72.0,Pequeno I
171,171,150150,48971,44666,3382,33958,37340,7326,46936.08,43273.33,2863.5,34300.5,37164.0,6109.33,563233,519280,34362,411606,445968,73312,2022,'BENEVIDES',Benevides,'PA',1501501,3635.0,3635,302.9,302.9,2,343.0,343.0,Médio
172,172,150157,10992,9664,1191,6460,7651,2013,10644.33,9479.75,1085.67,6640.42,7726.08,1753.67,127732,113757,13028,79685,92713,21044,2022,'BOM JESUS DO TOCANTINS',Bom Jesus do Tocantins,'PA',1501576,1732.0,1732,144.3,144.3,2,102.0,102.0,Pequeno I
173,173,150160,10674,10164,936,8008,8944,1220,10190.08,9762.08,929.5,7650.25,8579.75,1182.33,122281,117145,11154,91803,102957,14188,2022,'BONITO',Bonito,'PA',1501600,1487.0,1487,135.2,135.2,1,59.0,59.0,Pequeno I
174,174,150170,90306,83904,12381,58039,70420,13484,86311.33,80646.83,11349.92,56386.42,67736.33,12910.5,1035736,967762,136199,676637,812836,154926,2022,'BRAGANCA',Bragança,'PA',1501709,8643.0,8643,720.2,720.2,4,690.0,690.0,Grande
175,175,150172,15973,14166,813,11190,12003,2163,15149.83,13543.08,725.33,10739.58,11464.92,2078.17,181798,162517,8704,128875,137579,24938,2022,'BRASIL NOVO',Brasil Novo,'PA',1501725,2831.0,12328,235.9,1027.3,1,443.0,443.0,Pequeno I
176,176,150175,5966,5340,633,3813,4446,894,5611.17,5031.0,682.75,3394.0,4076.75,954.25,67334,60372,8193,40728,48921,11451,2022,'BREJO GRANDE DO ARAGUAIA',Brejo Grande do Araguaia,'PA',1501758,1090.0,1090,90.8,90.8,1,60.0,60.0,Pequeno I
177,177,150178,32891,28591,1667,24386,26053,2538,30867.33,27525.08,1221.58,24070.83,25292.42,2232.67,370408,330301,14659,288850,303509,26792,2022,'BREU BRANCO',Breu Branco,'PA',1501782,11160.0,11160,930.0,930.0,3,797.0,797.0,Médio
178,178,150180,90380,86517,4728,75754,80482,6035,86349.67,83142.33,4148.92,73971.17,78120.08,5022.25,1036196,997708,49787,887654,937441,60267,2022,'BREVES',Breves,'PA',1501808,21475.0,21475,1789.6,1789.6,5,1839.0,1839.0,Médio
179,179,150190,23438,22533,465,20907,21372,1161,23003.92,22260.25,625.67,20526.58,21152.25,1108.0,276047,267123,7508,246319,253827,13296,2022,'BUJARU',Bujaru,'PA',1501907,3614.0,3614,301.2,301.2,1,547.0,547.0,Pequeno II
180,180,150195,17482,16819,660,15175,15835,984,17285.33,16680.5,699.67,15016.58,15716.25,964.25,207424,200166,8396,180199,188595,11571,2022,'CACHOEIRA DO PIRIA',Cachoeira do Piriá,'PA',1501956,1279.0,1279,106.6,106.6,1,26.0,26.0,Pequeno II
181,181,150200,18182,17338,165,16015,16180,1158,18017.42,17285.67,137.92,16274.75,16412.67,873.0,216209,207428,1655,195297,196952,10476,2022,'CACHOEIRA DO ARARI',Cachoeira do Arari,'PA',1502004,7870.0,7870,655.8,655.8,1,597.0,597.0,Pequeno II
182,182,150210,105113,102269,3323,92644,95967,6302,100220.25,97649.33,3820.67,87535.83,91356.5,6292.83,1202643,1171792,45848,1050430,1096278,75514,2022,'CAMETA',Cametá,'PA',1502103,39879.0,39879,3323.2,3323.2,6,2680.0,2680.0,Grande
183,183,150215,33158,30011,5270,17892,23162,6849,29526.33,27109.75,4574.33,16628.25,21202.58,5907.17,354316,325317,54892,199539,254431,70886,2022,'CANAA DOS CARAJAS',Canaã Dos Carajás,'PA',1502152,25725.0,25725,2143.8,2143.8,3,1356.0,1356.0,Pequeno II
184,184,150220,40591,37664,2022,28869,30891,6773,38920.08,36282.25,2288.83,27485.75,29774.58,6507.67,467041,435387,27466,329829,357295,78092,2022,'CAPANEMA',Capanema,'PA',1502202,4815.0,4815,401.2,401.2,2,268.0,268.0,Médio
185,185,150230,41295,38670,2678,30034,32712,5958,39423.08,37085.08,2900.42,28081.58,30982.0,6103.08,473077,445021,34805,336979,371784,73237,2022,'CAPITAO POCO',Capitão Poço,'PA',1502301,4611.0,4611,384.2,384.2,1,343.0,343.0,Médio
186,186,150240,109854,97474,21202,44034,65236,32238,102701.42,92084.33,19846.0,42157.17,62003.17,30081.17,1232417,1105012,238152,505886,744038,360974,2022,'CASTANHAL',Castanhal,'PA',1502400,28453.0,28453,2371.1,2371.1,7,1209.0,1209.0,Grande
187,187,150250,17424,17051,1607,14851,16458,593,16872.83,16517.75,1677.75,14203.5,15881.25,636.5,202474,198213,20133,170442,190575,7638,2022,'CHAVES',Chaves,'PA',1502509,1031.0,1031,85.9,85.9,1,23.0,23.0,Pequeno II
188,188,150260,9560,8864,311,7524,7835,1029,9100.17,8579.67,339.5,7289.42,7628.92,950.75,109202,102956,4074,87473,91547,11409,2022,'COLARES',Colares,'PA',1502608,2094.0,2094,174.5,174.5,1,111.0,111.0,Pequeno I
189,189,150270,28489,22595,6588,6550,13138,9457,27707.92,22285.33,6467.5,6790.33,13257.83,9027.5,332495,267424,77610,81484,159094,108330,2022,'CONCEICAO DO ARAGUAIA',Conceição do Araguaia,'PA',1502707,4038.0,4038,336.5,336.5,2,184.0,184.0,Pequeno II
190,190,150275,24157,23042,698,20213,20911,2131,22992.08,22005.0,729.0,19275.0,20004.0,2001.0,275905,264060,8748,231300,240048,24012,2022,'CONCORDIA DO PARA',Concórdia do Pará,'PA',1502756,2729.0,2729,227.4,227.4,1,200.0,200.0,Pequeno II
191,191,150276,7063,6599,694,5037,5731,868,6718.5,6265.58,660.83,4809.75,5470.58,795.0,80622,75187,7930,57717,65647,9540,2022,'CUMARU DO NORTE',Cumaru do Norte,'PA',1502764,9016.0,9016,751.3,751.3,1,737.0,737.0,Pequeno I
192,192,150277,15149,13476,1722,9838,11560,1916,14362.67,12904.58,1530.67,9642.5,11173.17,1731.42,172352,154855,18368,115710,134078,20777,2022,'CURIONOPOLIS',Curionópolis,'PA',1502772,2862.0,2862,260.2,260.2,2,,,Pequeno I
193,193,150280,29410,28869,1645,25252,26897,1972,28990.58,28513.67,1467.25,25279.67,26746.92,1766.75,347887,342164,17607,303356,320963,21201,2022,'CURRALINHO',Curralinho,'PA',1502806,885.0,885,73.8,73.8,1,59.0,59.0,Pequeno II
194,194,150285,12685,11693,679,9228,9907,1786,12236.58,11393.25,779.17,8925.08,9704.25,1689.0,146839,136719,9350,107101,116451,20268,2022,'CURUA',Curuá,'PA',1502855,5536.0,7639,461.3,636.6,1,651.0,651.0,Pequeno I
195,195,150290,31965,30538,786,28281,29067,1471,31117.83,29811.75,746.17,27700.25,28446.42,1365.33,373414,357741,8954,332403,341357,16384,2022,'CURUCA',Curuçá,'PA',1502905,2293.0,2293,229.3,229.3,1,188.0,188.0,Pequeno II
196,196,150293,26516,23049,2560,15983,18543,4506,25375.83,22234.75,2545.5,15336.67,17882.17,4352.58,304510,266817,30546,184040,214586,52231,2022,'DOM ELISEU',Dom Eliseu,'PA',1502939,4799.0,4799,399.9,399.9,3,126.0,126.0,Médio
197,197,150295,22296,18416,6033,7107,13140,5276,21336.75,17921.0,5722.42,7510.75,13233.17,4687.83,256041,215052,68669,90129,158798,56254,2022,'ELDORADO DOS CARAJAS',Eldorado Dos Carajás,'PA',1502954,5058.0,5058,421.5,421.5,2,297.0,297.0,Pequeno II
198,198,150300,8568,8155,106,7644,7750,405,7813.83,7456.5,105.42,6967.67,7073.08,383.42,93766,89478,1265,83612,84877,4601,2022,'FARO',Faro,'PA',1503002,2496.0,2496,226.9,226.9,1,,,Pequeno I
199,199,150304,13977,12589,1646,8942,10588,2001,13593.17,12309.75,1545.33,8867.42,10412.75,1897.0,163118,147717,18544,106409,124953,22764,2022,'FLORESTA DO ARAGUAIA',Floresta do Araguaia,'PA',1503044,6099.0,6099,508.2,508.2,1,453.0,453.0,Pequeno I
200,200,150307,19825,18671,878,15008,15886,2785,19636.5,18619.83,960.25,15030.83,15991.08,2628.75,235638,223438,11523,180370,191893,31545,2022,'GARRAFAO DO NORTE',Garrafão do Norte,'PA',1503077,3180.0,3180,265.0,265.0,1,106.0,106.0,Pequeno II
201,201,150309,20483,17961,2308,11563,13871,4090,20059.92,17741.0,2217.08,11672.42,13889.5,3851.5,240719,212892,26605,140069,166674,46218,2022,'GOIANESIA DO PARA',Goianésia do Pará,'PA',1503093,100.0,100,100.0,100.0,1,100.0,100.0,Pequeno II
202,202,150310,30723,30018,1186,26884,28070,1948,30417.92,29813.75,1137.0,26886.5,28023.5,1790.25,365015,357765,13644,322638,336282,21483,2022,'GURUPA',Gurupá,'PA',1503101,2129.0,2129,177.4,177.4,1,89.0,89.0,Pequeno II
203,203,150320,27285,25707,1927,19513,21440,4267,26537.5,25131.83,1643.83,19437.67,21081.5,4050.33,318450,301582,19726,233252,252978,48604,2022,'IGARAPE-ACU',Igarapé-açu,'PA',1503200,3813.0,3813,317.8,317.8,1,282.0,282.0,Pequeno II
204,204,150330,50070,47967,4993,36575,41568,6399,47060.92,45286.17,4144.08,35358.0,39502.08,5784.08,564731,543434,49729,424296,474025,69409,2022,'IGARAPE-MIRI',Igarapé-miri,'PA',1503309,5995.0,5995,499.6,499.6,3,339.0,339.0,Médio
205,205,150340,7923,7379,863,5338,6201,1178,7735.83,7247.5,767.17,5426.75,6193.92,1053.58,92830,86970,9206,65121,74327,12643,2022,'INHANGAPI',Inhangapi,'PA',1503408,1994.0,1994,166.2,166.2,1,142.0,142.0,Pequeno I
206,206,150345,26805,25070,1063,21816,22879,2191,26055.17,24551.42,1044.17,21577.33,22621.5,1929.92,312662,294617,12530,258928,271458,23159,2022,'IPIXUNA DO PARA',Ipixuna do Pará,'PA',1503457,2682.0,2682,223.5,223.5,1,455.0,455.0,Médio
207,207,150350,26032,24380,1370,20974,22344,2036,24577.0,23309.42,1146.33,20271.83,21418.17,1891.25,294924,279713,13756,243262,257018,22695,2022,'IRITUIA',Irituia,'PA',1503507,6668.0,6668,555.7,555.7,2,1102.0,1102.0,Pequeno II
208,208,150360,76363,68551,4820,54250,59070,9481,72244.58,65136.5,4793.5,51414.58,56208.08,8928.42,866935,781638,57522,616975,674497,107141,2022,'ITAITUBA',Itaituba,'PA',1503606,5517.0,5517,459.8,459.8,3,396.0,396.0,Médio
209,209,150370,36691,33185,3583,25242,28825,4360,35646.67,32404.67,3244.67,25180.75,28425.42,3979.25,427760,388856,38936,302169,341105,47751,2022,'ITUPIRANGA',Itupiranga,'PA',1503705,25443.0,25443,2120.2,2120.2,5,861.0,861.0,Médio
210,210,150375,17315,16661,1066,14588,15654,1007,16480.67,15904.58,904.42,14150.08,15054.5,850.08,197768,190855,10853,169801,180654,10201,2022,'JACAREACANGA',Jacareacanga,'PA',1503754,1452.0,1452,132.0,132.0,1,75.0,75.0,Pequeno I
211,211,150380,28809,25462,778,21632,22410,3052,28954.58,25914.42,638.83,22545.42,23184.25,2730.17,347455,310973,7666,270545,278211,32762,2022,'JACUNDA',Jacundá,'PA',1503804,6752.0,6752,562.7,562.7,1,436.0,436.0,Médio
212,212,150390,33405,31500,5726,20955,26681,4819,31372.08,29891.08,3938.58,22331.42,26270.0,3621.08,376465,358693,47263,267977,315240,43453,2022,'JURUTI',Juruti,'PA',1503903,5401.0,5401,450.1,450.1,1,303.0,303.0,Pequeno II
213,213,150400,25201,24457,531,21501,22032,2425,24774.42,24148.0,541.25,21409.67,21950.92,2197.08,297293,289776,6495,256916,263411,26365,2022,'LIMOEIRO DO AJURU',Limoeiro do Ajuru,'PA',1504000,2532.0,2532,211.0,211.0,1,750.0,750.0,Pequeno II
214,214,150405,25195,23382,1278,19222,20500,2882,24938.17,23276.42,1129.0,19471.92,20600.92,2675.5,299258,279317,13548,233663,247211,32106,2022,'MAE DO RIO',Mãe do Rio,'PA',1504059,10589.0,10589,882.4,882.4,1,1519.0,1519.0,Pequeno II
215,215,150410,6442,5828,495,4157,4652,1176,6343.92,5803.08,515.0,4181.0,4696.0,1107.08,76127,69637,6180,50172,56352,13285,2022,'MAGALHAES BARATA',Magalhães Barata,'PA',1504109,1972.0,1972,164.3,164.3,1,112.0,112.0,Pequeno I
216,216,150420,139924,121848,29240,59810,89050,32798,128393.08,112250.42,26370.83,55092.17,81463.0,30787.42,1540717,1347005,316450,661106,977556,369449,2022,'MARABA',Marabá,'PA',1504208,21092.0,21092,1757.7,1757.7,4,1169.0,1169.0,Grande
217,217,150430,25629,24447,1294,21082,22376,2071,25178.08,24091.75,1414.67,20657.58,22072.25,2019.5,302137,289101,16976,247891,264867,24234,2022,'MARACANA',Maracanã,'PA',1504307,2698.0,2698,224.8,224.8,1,264.0,264.0,Pequeno II
218,218,150440,19674,18673,1193,15532,16725,1948,18872.17,17985.17,1561.33,14361.0,15922.33,2062.83,226466,215822,18736,172332,191068,24754,2022,'MARAPANIM',Marapanim,'PA',1504406,4445.0,4445,370.4,370.4,1,206.0,206.0,Pequeno II
219,219,150442,77820,70605,4467,55183,59650,10955,73296.5,66699.25,4690.42,51418.92,56109.33,10589.92,879558,800391,56285,617027,673312,127079,2022,'MARITUBA',Marituba,'PA',1504422,11174.0,11174,931.2,931.2,4,645.0,645.0,Grande
220,220,150445,23288,21834,486,19848,20334,1500,21804.0,20441.67,500.58,18391.33,18891.92,1549.75,261648,245300,6007,220696,226703,18597,2022,'MEDICILANDIA',Medicilândia,'PA',1504455,1618.0,1618,134.8,134.8,1,119.0,119.0,Pequeno II
221,221,150450,23713,23003,1463,20521,21984,1019,22981.25,22364.33,1704.0,19614.08,21318.08,1046.25,275775,268372,20448,235369,255817,12555,2022,'MELGACO',Melgaço,'PA',1504505,2716.0,2716,226.3,226.3,1,175.0,175.0,Pequeno II
222,222,150460,29269,27942,1230,24144,25374,2568,28970.83,27840.67,1084.17,24549.5,25633.67,2207.0,347650,334088,13010,294594,307604,26484,2022,'MOCAJUBA',Mocajuba,'PA',1504604,346.0,346,28.8,28.8,1,39.0,39.0,Pequeno II
223,223,150470,60815,57359,1484,51676,53160,4199,59168.33,56193.67,1077.33,52411.92,53489.25,2704.42,710020,674324,12928,628943,641871,32453,2022,'MOJU',Moju,'PA',1504703,5675.0,5675,472.9,472.9,3,400.0,400.0,Médio
224,224,150475,18586,16916,2412,11678,14090,2826,17623.75,16162.58,2066.42,11648.5,13714.92,2447.67,211485,193951,24797,139782,164579,29372,2022,'MOJUI DOS CAMPOS',Mojuí dos Campos,'PA',1504752,2129.0,2129,177.4,177.4,1,150.0,150.0,Pequeno I
225,225,150480,47160,44559,8151,30942,39093,5466,45899.75,43535.75,6164.33,32423.5,38587.83,4947.92,550797,522429,73972,389082,463054,59375,2022,'MONTE ALEGRE',Monte Alegre,'PA',1504802,5121.0,5121,426.8,426.8,2,242.0,242.0,Médio
226,226,150490,31119,29671,1983,24466,26449,3222,30675.0,29443.83,1712.17,25042.0,26754.17,2689.67,368100,353326,20546,300504,321050,32276,2022,'MUANA',Muaná,'PA',1504901,1712.0,1712,142.7,142.7,1,79.0,79.0,Pequeno II
227,227,150495,18821,18245,663,16487,17150,1095,18711.17,18239.17,620.25,16568.08,17188.33,1050.83,224534,218870,7443,198817,206260,12610,2022,'NOVA ESPERANCA DO PIRIA',Nova Esperança do Piriá,'PA',1504950,2686.0,2686,223.8,223.8,1,634.0,634.0,Pequeno II
228,228,150497,9467,8231,1688,4695,6383,1848,9216.58,8106.67,1564.33,4774.92,6339.25,1767.42,110599,97280,18772,57299,76071,21209,2022,'NOVA IPIXUNA',Nova Ipixuna,'PA',1504976,487.0,487,44.3,44.3,1,80.0,80.0,Pequeno I
229,229,150500,9033,8323,535,6476,7011,1312,8879.92,8251.83,529.75,6455.75,6985.5,1266.33,106559,99022,6357,77469,83826,15196,2022,'NOVA TIMBOTEUA',Nova Timboteua,'PA',1505007,508.0,508,42.3,42.3,1,50.0,50.0,Pequeno I
230,230,150503,16643,14133,4185,5894,10079,4054,14913.67,12673.42,3658.0,5604.75,9262.75,3410.67,178964,152081,43896,67257,111153,40928,2022,'NOVO PROGRESSO',Novo Progresso,'PA',1505031,12582.0,12582,1048.5,1048.5,1,1125.0,1125.0,Pequeno II
231,231,150506,40799,37574,5836,26885,32721,4853,37357.75,34432.25,5112.67,25090.67,30203.33,4228.92,448293,413187,61352,301088,362440,50747,2022,'NOVO REPARTIMENTO',Novo Repartimento,'PA',1505064,5679.0,5679,473.2,473.2,3,762.0,762.0,Médio
232,232,150510,41045,37717,2966,29720,32686,5031,38726.25,35877.25,3183.17,27642.0,30825.17,5052.08,464715,430527,38198,331704,369902,60625,2022,'OBIDOS',Óbidos,'PA',1505106,14850.0,14850,1237.5,1237.5,2,883.0,883.0,Pequeno II
233,233,150520,30811,30266,846,28327,29173,1093,30277.67,29801.33,986.67,27648.08,28634.75,1166.58,363332,357616,11840,331777,343617,13999,2022,'OEIRAS DO PARA',Oeiras do Pará,'PA',1505205,7970.0,7970,724.5,724.5,1,,,Pequeno II
234,234,150530,45815,42844,3237,34140,37377,5467,44135.58,41473.42,2955.75,33478.33,36434.08,5039.33,529627,497681,35469,401740,437209,60472,2022,'ORIXIMINA',Oriximiná,'PA',1505304,9174.0,9174,764.5,764.5,3,393.0,393.0,Médio
235,235,150540,14743,13337,746,11027,11773,1564,14392.33,13162.58,657.67,11075.75,11733.42,1429.17,172708,157951,7892,132909,140801,17150,2022,'OUREM',Ourém,'PA',1505403,1730.0,1730,144.2,144.2,2,120.0,120.0,Pequeno I
236,236,150543,22781,20736,1806,15995,17801,2935,21397.25,19595.0,1499.83,15684.92,17184.75,2410.25,256767,235140,17998,188219,206217,28923,2022,'OURILANDIA DO NORTE',Ourilândia do Norte,'PA',1505437,2306.0,2306,209.6,209.6,1,,,Pequeno II
237,237,150548,34755,32646,1468,28418,29886,2760,33751.17,31944.17,1145.5,28362.58,29508.08,2436.08,405014,383330,13746,340351,354097,29233,2022,'PACAJA',Pacajá,'PA',1505486,2495.0,2495,207.9,207.9,1,33.0,33.0,Pequeno II
238,238,150549,6020,5443,261,4384,4645,798,5995.67,5484.0,219.75,4515.42,4735.17,748.83,71948,65808,2637,54185,56822,8986,2022,'PALESTINA DO PARA',Palestina do Pará,'PA',1505494,1171.0,1171,106.5,106.5,1,,,Pequeno I
239,239,150550,67115,59265,16313,23686,39999,19266,65466.17,58526.17,14331.33,26481.5,40812.83,17713.33,785594,702314,171976,317778,489754,212560,2022,'PARAGOMINAS',Paragominas,'PA',1505502,6621.0,6621,551.8,551.8,2,511.0,511.0,Médio
240,240,150553,120004,100488,26628,42826,69454,31034,110679.92,94140.58,22919.42,42582.5,65501.92,28638.67,1328159,1129687,275033,510990,786023,343664,2022,'PARAUAPEBAS',Parauapebas,'PA',1505536,29882.0,29882,2490.2,2490.2,5,1281.0,1281.0,Grande
241,241,150555,5961,5105,456,3491,3947,1158,5678.67,4900.5,380.75,3396.0,3776.75,1123.75,68144,58806,4569,40752,45321,13485,2022,'PAU DARCO',Pau D´arco,'PA',1505551,317.0,317,35.2,35.2,1,50.0,50.0,Pequeno I
242,242,150560,6014,5526,607,3655,4262,1264,5905.67,5471.17,618.08,3637.25,4255.33,1215.83,70868,65654,7417,43647,51064,14590,2022,'PEIXE-BOI',Peixe-boi,'PA',1505601,5397.0,5397,449.8,449.8,1,393.0,393.0,Pequeno I
243,243,150563,8696,7584,1626,4054,5680,1904,8412.67,7427.5,1480.0,4173.17,5653.17,1774.33,100952,89130,17760,50078,67838,21292,2022,'PICARRA',Piçarra,'PA',1505635,3498.0,3498,291.5,291.5,1,145.0,145.0,Pequeno I
244,244,150565,15685,14640,476,11872,12348,2292,15213.0,14310.58,481.92,11848.67,12330.58,1980.0,182556,171727,5783,142184,147967,23760,2022,'PLACAS',Placas,'PA',1505650,5955.0,5955,496.2,496.2,1,592.0,592.0,Pequeno II
245,245,150570,23141,22063,873,19453,20326,1737,21912.33,21045.42,945.08,18518.5,19463.58,1581.83,262948,252545,11341,222222,233563,18982,2022,'PONTA DE PEDRAS',Ponta de Pedras,'PA',1505700,1335.0,1335,111.2,111.2,1,71.0,71.0,Pequeno II
246,246,150580,47489,45212,4550,37313,41863,3349,45028.58,42993.67,3937.33,36082.5,40019.83,2973.83,540343,515924,47248,432990,480238,35686,2022,'PORTEL',Portel,'PA',1505809,1864.0,1864,155.3,155.3,3,122.0,122.0,Médio
247,247,150590,30066,28293,957,25654,26611,1682,29386.0,27761.0,924.83,25382.17,26307.0,1454.0,352632,333132,11098,304586,315684,17448,2022,'PORTO DE MOZ',Porto de Moz,'PA',1505908,4999.0,4999,416.6,416.6,3,746.0,746.0,Pequeno II
248,248,150600,34168,32926,1019,30045,31064,1862,33533.33,32446.92,865.08,29989.33,30854.42,1592.5,402400,389363,10381,359872,370253,19110,2022,'PRAINHA',Prainha,'PA',1506005,1761.0,1761,176.1,176.1,2,207.0,207.0,Pequeno II
249,249,150610,9131,8445,411,7123,7534,911,8826.08,8236.0,394.83,6958.58,7353.42,882.58,105913,98832,4738,83503,88241,10591,2022,'PRIMAVERA',Primavera,'PA',1506104,5302.0,5302,441.8,441.8,1,336.0,336.0,Pequeno I
250,250,150611,9676,8916,266,7643,7909,1007,9478.58,8828.42,299.42,7703.92,8003.33,825.08,113743,105941,3593,92447,96040,9901,2022,'QUATIPURU',Quatipuru,'PA',1506112,2092.0,2092,174.3,174.3,1,226.0,226.0,Pequeno I
251,251,150613,45626,38307,7851,18554,26405,11902,42822.67,36356.5,6880.83,18804.58,25685.42,10671.08,513872,436278,82570,225655,308225,128053,2022,'REDENCAO',Redenção,'PA',1506138,18090.0,26551,1507.5,2212.6,1,1308.0,1308.0,Médio
252,252,150616,11921,9570,2052,4274,6326,3244,11319.42,9236.42,1940.75,4203.92,6144.67,3091.75,135833,110837,23289,50447,73736,37101,2022,'RIO MARIA',Rio Maria,'PA',1506161,1595.0,1595,132.9,132.9,1,200.0,200.0,Pequeno I
253,253,150618,22698,20012,2995,12310,15305,4707,21638.08,19312.17,2519.58,12393.92,14913.5,4398.67,259657,231746,30235,148727,178962,52784,2022,'RONDON DO PARA',Rondon do Pará,'PA',1506187,2111.0,2111,175.9,175.9,2,185.0,185.0,Pequeno II
254,254,150619,20749,18613,1707,14021,15728,2885,20089.33,18183.75,1207.0,14684.83,15891.83,2291.92,241072,218205,14484,176218,190702,27503,2022,'RUROPOLIS',Rurópolis,'PA',1506195,4182.0,4182,380.2,380.2,1,260.0,260.0,Pequeno II
255,255,150620,26697,24649,4670,14579,19249,5400,24506.42,22752.83,2902.25,15276.75,18179.0,4573.83,294077,273034,34827,183321,218148,54886,2022,'SALINOPOLIS',Salinópolis,'PA',1506203,670.0,670,60.9,60.9,1,,,Pequeno II
256,256,150630,18711,17783,380,16006,16386,1397,18233.83,17407.33,480.75,15606.5,16087.25,1320.08,218806,208888,5769,187278,193047,15841,2022,'SALVATERRA',Salvaterra,'PA',1506302,13108.0,13108,1092.3,1092.3,1,1208.0,1208.0,Pequeno II
257,257,150635,16144,14327,1621,9555,11176,3151,15386.25,13797.25,1498.0,9373.42,10871.42,2925.83,184635,165567,17976,112481,130457,35110,2022,'SANTA BARBARA DO PARA',Santa Bárbara do Pará,'PA',1506351,7141.0,7141,595.1,595.1,3,404.0,404.0,Pequeno I
258,258,150640,6827,6520,135,5946,6081,439,6830.83,6551.75,120.17,6065.0,6185.17,366.58,81970,78621,1442,72780,74222,4399,2022,'SANTA CRUZ DO ARARI',Santa Cruz do Arari,'PA',1506401,494.0,494,41.2,41.2,1,45.0,45.0,Pequeno I
259,259,150650,36226,33080,8604,16029,24633,8447,34583.75,31821.0,7595.75,16502.08,24097.83,7723.17,415005,381852,91149,198025,289174,92678,2022,'SANTA ISABEL DO PARA',Santa Isabel do Pará,'PA',1506500,2890.0,2890,240.8,240.8,1,168.0,168.0,Médio
260,260,150655,17136,16125,364,14284,14648,1477,16746.0,15854.75,440.58,14001.42,14442.0,1412.75,200952,190257,5287,168017,173304,16953,2022,'SANTA LUZIA DO PARA',Santa Luzia do Pará,'PA',1506559,1148.0,1148,95.7,95.7,1,29.0,29.0,Pequeno I
261,261,150658,14570,11975,3150,5280,8430,3545,14072.92,11812.92,2728.75,5849.33,8578.08,3234.83,168875,141755,32745,70192,102937,38818,2022,'SANTA MARIA DAS BARREIRAS',Santa Maria Das Barreiras,'PA',1506583,2377.0,2377,198.1,198.1,1,249.0,249.0,Pequeno I
262,262,150660,17665,16307,3283,9316,12599,3708,17297.33,16137.5,2423.83,10444.75,12868.58,3268.92,207568,193650,29086,125337,154423,39227,2022,'SANTA MARIA DO PARA',Santa Maria do Pará,'PA',1506609,4319.0,4319,392.6,392.6,1,63.0,63.0,Pequeno II
263,263,150670,24310,21368,1770,17230,19000,2368,22876.67,20263.17,1330.08,17080.17,18410.25,1852.92,274520,243158,15961,204962,220923,22235,2022,'SANTANA DO ARAGUAIA',Santana do Araguaia,'PA',1506708,1905.0,1905,158.8,158.8,1,93.0,93.0,Médio
264,264,150680,241693,212047,43429,119132,162561,49486,226644.58,199607.25,40525.83,111412.17,151938.0,47669.25,2719735,2395287,486310,1336946,1823256,572031,2022,'SANTAREM',Santarém,'PA',1506807,83831.0,254526,6985.9,21210.5,8,6258.0,14388.0,Grande
265,265,150690,7050,6509,234,5743,5977,532,7046.67,6545.83,238.0,5808.67,6046.67,499.17,84560,78550,2856,69704,72560,5990,2022,'SANTAREM NOVO',Santarém Novo,'PA',1506906,1800.0,1800,150.0,150.0,1,70.0,70.0,Pequeno I
266,266,150700,21274,20065,1861,15689,17550,2515,20346.17,19301.67,1441.92,15676.0,17117.92,2183.75,244154,231620,17303,188112,205415,26205,2022,'SANTO ANTONIO DO TAUA',Santo Antônio do Tauá,'PA',1507003,5477.0,5477,456.4,456.4,1,361.0,361.0,Pequeno II
267,267,150710,13414,12601,1500,9037,10537,2064,13182.67,12502.42,1064.17,9567.67,10631.83,1870.58,158192,150029,12770,114812,127582,22447,2022,'SAO CAETANO DE ODIVELAS',São Caetano de Odivelas,'PA',1507102,4654.0,4654,387.8,387.8,1,202.0,202.0,Pequeno I
268,268,150715,16164,14388,814,11765,12579,1809,15604.83,14001.25,719.75,11606.83,12326.58,1674.67,187258,168015,8637,139282,147919,20096,2022,'SAO DOMINGOS DO ARAGUAIA',São Domingos do Araguaia,'PA',1507151,1737.0,1737,144.8,144.8,1,81.0,81.0,Pequeno II
269,269,150720,26086,24956,1110,21858,22968,1988,25389.58,24419.67,1265.33,21178.25,22443.58,1976.08,304675,293036,15184,254139,269323,23713,2022,'SAO DOMINGOS DO CAPIM',São Domingos do Capim,'PA',1507201,588.0,588,49.0,49.0,1,39.0,39.0,Pequeno II
270,270,150730,43887,40234,5809,28354,34163,6071,41908.25,38585.83,4827.92,28516.25,33344.17,5241.67,502899,463030,57935,342195,400130,62900,2022,'SAO FELIX DO XINGU',São Félix do Xingu,'PA',1507300,737.0,737,61.4,61.4,2,38.0,38.0,Médio
271,271,150740,12162,11143,1002,8428,9430,1713,11841.83,10934.92,813.83,8468.33,9282.17,1652.75,142102,131219,9766,101620,111386,19833,2022,'SAO FRANCISCO DO PARA',São Francisco do Pará,'PA',1507409,3248.0,3248,270.7,270.7,2,440.0,440.0,Pequeno I
272,272,150745,16990,15063,2016,10745,12761,2302,16233.5,14554.42,1839.25,10748.0,12587.25,1967.17,194802,174653,22071,128976,151047,23606,2022,'SAO GERALDO DO ARAGUAIA',São Geraldo do Araguaia,'PA',1507458,2106.0,2106,175.5,175.5,1,335.0,335.0,Pequeno II
273,273,150746,5472,5085,161,4170,4331,754,5357.17,5029.75,181.5,4211.83,4393.33,636.42,64286,60357,2178,50542,52720,7637,2022,'SAO JOAO DA PONTA',São João da Ponta,'PA',1507466,1413.0,1413,117.8,117.8,1,76.0,76.0,Pequeno I
274,274,150747,16635,15510,1069,12350,13419,2091,16019.33,15043.67,1073.08,11922.17,12995.25,2048.42,192232,180524,12877,143066,155943,24581,2022,'SAO JOAO DE PIRABAS',São João de Pirabas,'PA',1507474,2171.0,2171,180.9,180.9,1,96.0,96.0,Pequeno II
275,275,150750,12487,11186,1269,8073,9342,1844,12135.33,10962.5,1058.33,8219.92,9278.25,1684.25,145624,131550,12700,98639,111339,20211,2022,'SAO JOAO DO ARAGUAIA',São João do Araguaia,'PA',1507508,5947.0,5947,540.6,540.6,1,782.0,782.0,Pequeno I
276,276,150760,37349,35212,6014,23455,29469,5743,36263.25,34458.08,4673.42,24907.58,29581.0,4877.08,435159,413497,56081,298891,354972,58525,2022,'SAO MIGUEL DO GUAMA',São Miguel do Guamá,'PA',1507607,4407.0,4407,367.2,367.2,2,68.0,68.0,Médio
277,277,150770,25793,24965,563,23403,23966,999,24991.0,24278.5,534.83,22873.5,23408.33,870.17,299892,291342,6418,274482,280900,10442,2022,'SAO SEBASTIAO DA BOA VISTA,São Sebastião da Boa Vista,'PA',1507706,3426.0,3426,285.5,285.5,2,207.0,207.0,Pequeno II
278,278,150775,3459,3049,416,2090,2506,543,3248.75,2874.0,383.0,2009.33,2392.33,481.67,38985,34488,4596,24112,28708,5780,2022,'SAPUCAIA',Sapucaia,'PA',1507755,5011.0,5011,417.6,417.6,1,196.0,196.0,Pequeno I
279,279,150780,16063,15224,894,13602,14496,728,15006.75,14292.33,649.75,13011.25,13661.0,631.33,180081,171508,7797,156135,163932,7576,2022,'SENADOR JOSE PORFIRIO',Senador José Porfírio,'PA',1507805,5721.0,5721,476.8,476.8,1,447.0,447.0,Pequeno I
280,280,150790,17996,16646,1136,13158,14294,2352,17558.92,16351.42,994.42,13265.0,14259.42,2092.0,210707,196217,11933,159180,171113,25104,2022,'SOURE',Soure,'PA',1507904,4729.0,4729,394.1,394.1,1,311.0,311.0,Pequeno II
281,281,150795,52607,48478,8940,30749,39689,8789,49076.0,45500.83,8135.5,29730.5,37866.0,7634.83,588912,546010,97626,356766,454392,91618,2022,'TAILANDIA',Tailândia,'PA',1507953,8090.0,8090,674.2,674.2,1,641.0,641.0,Médio
282,282,150796,10460,9599,395,8348,8743,856,9961.5,9235.67,348.17,8117.33,8465.5,770.17,119538,110828,4178,97408,101586,9242,2022,'TERRA ALTA',Terra Alta,'PA',1507961,5703.0,6834,475.2,569.5,1,517.0,517.0,Pequeno I
283,283,150797,14339,13110,1367,10273,11640,1470,13708.17,12669.92,953.08,10363.92,11317.0,1352.92,164498,152039,11437,124367,135804,16235,2022,'TERRA SANTA',Terra Santa,'PA',1507979,3592.0,3592,299.3,299.3,1,128.0,128.0,Pequeno I
284,284,150800,48593,45953,7172,31592,38764,7189,45325.58,43139.92,5112.58,32607.17,37719.75,5420.17,543907,517679,61351,391286,452637,65042,2022,'TOME-ACU',Tomé-açu,'PA',1508001,7001.0,32368,583.4,2697.3,1,0.0,3129.0,Médio
285,285,150803,25031,23871,779,21331,22110,1761,24299.25,23283.25,877.83,20720.0,21597.83,1685.42,291591,279399,10534,248640,259174,20225,2022,'TRACUATEUA',Tracuateua,'PA',1508035,6306.0,6306,525.5,525.5,2,666.0,666.0,Pequeno II
286,286,150805,12069,11100,1021,8489,9510,1590,11640.75,10774.25,859.75,8484.17,9343.92,1430.33,139689,129291,10317,101810,112127,17164,2022,'TRAIRAO',Trairão,'PA',1508050,4883.0,4883,406.9,406.9,1,412.0,412.0,Pequeno I
287,287,150808,21774,18143,6900,2893,9793,8350,20606.92,17340.92,6552.92,3507.83,10060.75,7280.17,247283,208091,78635,42094,120729,87362,2022,'TUCUMA',Tucumã,'PA',1508084,3551.0,5651,295.9,470.9,1,1250.0,1250.0,Pequeno II
288,288,150810,60155,52423,11206,29970,41176,11247,57813.08,50674.17,10120.5,29814.58,39935.08,10739.08,693757,608090,121446,357775,479221,128869,2022,'TUCURUI',Tucuruí,'PA',1508100,16278.0,16278,1356.5,1356.5,3,2088.0,2088.0,Médio
289,289,150812,18651,17224,1365,13140,14505,2719,17463.0,16213.67,1267.0,12461.92,13728.92,2484.75,209556,194564,15204,149543,164747,29817,2022,'ULIANOPOLIS',Ulianópolis,'PA',1508126,2530.0,2530,210.8,210.8,1,182.0,182.0,Pequeno II
290,290,150815,31031,28670,3945,21951,25896,2774,30091.42,27917.5,3034.5,22479.08,25513.58,2403.92,361097,335010,36414,269749,306163,28847,2022,'URUARA',Uruará,'PA',1508159,6474.0,6474,539.5,539.5,1,454.0,454.0,Pequeno II
291,291,150820,38453,35694,2959,29406,32365,3329,36406.75,33851.17,2966.42,27551.08,30517.5,3333.67,436881,406214,35597,330613,366210,40004,2022,'VIGIA',Vigia,'PA',1508209,2793.0,2793,232.8,232.8,2,172.0,172.0,Pequeno II
292,292,150830,46003,44568,1604,40472,42076,2492,44856.92,43563.08,1906.92,39224.42,41131.33,2431.75,538283,522757,22883,470693,493576,29181,2022,'VISEU',Viseu,'PA',1508308,3605.0,3605,300.4,300.4,2,117.0,117.0,Médio
293,293,150835,11534,10543,1217,7277,8494,2049,10403.25,9663.83,1084.75,6976.67,8061.42,1602.42,124839,115966,13017,83720,96737,19229,2022,'VITORIA DO XINGU',Vitória do Xingu,'PA',1508357,3094.0,3094,257.8,257.8,1,952.0,952.0,Pequeno I
294,294,150840,26331,23221,3623,13735,17358,5863,24479.33,21680.08,3421.83,12899.67,16321.5,5358.58,293752,260161,41062,154796,195858,64303,2022,'XINGUARA',Xinguara,'PA',1508407,3224.0,3224,268.7,268.7,1,197.0,197.0,Pequeno II
295,295,160005,3762,3509,192,3029,3221,288,3546.5,3335.83,180.67,2881.42,3062.08,273.75,42558,40030,2168,34577,36745,3285,2022,'SERRA DO NAVIO',Serra do Navio,'AP',1600055,1695.0,1695,141.2,141.2,1,136.0,136.0,Pequeno I
296,296,160010,6580,6356,89,6088,6177,179,6545.33,6340.17,103.42,6072.5,6175.92,164.25,78544,76082,1241,72870,74111,1971,2022,'AMAPA',Amapá,'AP',1600105,1519.0,1519,138.1,138.1,1,121.0,121.0,Pequeno I
297,297,160015,10306,9745,206,9161,9367,378,9617.0,9129.17,187.0,8592.92,8779.92,349.25,115404,109550,2244,103115,105359,4191,2022,'PEDRA BRANCA DO AMAPARI',Pedra Branca do Amapari,'AP',1600154,1551.0,1551,172.3,172.3,1,98.0,98.0,Pequeno I
298,298,160020,8111,7526,809,5799,6608,918,7522.83,7047.83,658.33,5625.0,6283.33,764.5,90274,84574,7900,67500,75400,9174,2022,'CALCOENE',Calçoene,'AP',1600204,4427.0,6130,368.9,510.8,1,0.0,1703.0,Pequeno I
299,299,160021,5012,4797,268,3662,3930,867,4895.5,4717.0,285.5,3746.25,4031.75,685.25,58746,56604,3426,44955,48381,8223,2022,'CUTIAS',Cutias,'AP',1600212,1593.0,1593,132.8,132.8,1,720.0,720.0,Pequeno I
300,300,160023,5177,4845,839,3100,3939,906,4975.08,4692.67,698.75,3205.33,3904.08,788.58,59701,56312,8385,38464,46849,9463,2022,'FERREIRA GOMES',Ferreira Gomes,'AP',1600238,1415.0,1415,117.9,117.9,1,46.0,46.0,Pequeno I
301,301,160025,6179,5985,103,5749,5852,133,5960.75,5798.83,74.42,5595.0,5669.42,129.42,71529,69586,893,67140,68033,1553,2022,'ITAUBAL',Itaubal,'AP',1600253,3728.0,4778,372.8,477.8,1,0.0,1050.0,Pequeno I
302,302,160027,29457,27745,1661,23915,25576,2169,27578.58,26128.33,1582.5,22408.33,23990.83,2137.5,330943,313540,18990,268900,287890,25650,2022,'LARANJAL DO JARI',Laranjal do Jari,'AP',1600279,7595.0,7595,632.9,632.9,1,203.0,203.0,Pequeno II
303,303,160030,259476,235275,41777,146582,188359,46916,240580.42,219307.75,38136.25,138422.42,176558.67,42749.08,2886965,2631693,457635,1661069,2118704,512989,2022,'MACAPA',Macapá,'AP',1600303,64768.0,75534,5397.3,6294.5,7,3394.0,3394.0,Grande
304,304,160040,21607,20335,1354,17519,18873,1462,20724.83,19723.25,914.33,17714.33,18628.67,1094.58,248698,236679,10972,212572,223544,13135,2022,'MAZAGAO',Mazagão,'AP',1600402,1059.0,1059,88.2,88.2,1,74.0,74.0,Pequeno I
305,305,160050,19152,17511,5616,9557,15173,2338,16980.33,15456.83,4362.75,8946.67,13309.42,2147.42,203764,185482,52353,107360,159713,25769,2022,'OIAPOQUE',Oiapoque,'AP',1600501,898.0,898,74.8,74.8,1,123.0,123.0,Pequeno II
306,306,160053,13853,12921,700,10948,11648,1273,13166.75,12445.08,639.25,10659.83,11299.08,1146.0,158001,149341,7671,127918,135589,13752,2022,'PORTO GRANDE',Porto Grande,'AP',1600535,7277.0,9617,606.4,801.4,1,0.0,2340.0,Pequeno I
307,307,160055,3919,3830,86,3651,3737,93,3348.33,3288.75,67.0,3127.0,3194.0,94.75,40180,39465,804,37524,38328,1137,2022,'PRACUUBA',Pracuúba,'AP',1600550,160.0,160,40.0,40.0,1,,,Pequeno I
308,308,160060,81632,74857,5796,61536,67332,7525,76098.08,69976.92,4698.42,58318.08,63016.5,6960.42,913177,839723,56381,699817,756198,83525,2022,'SANTANA',Santana,'AP',1600600,20063.0,23854,1671.9,1987.8,1,0.0,3791.0,Grande
309,309,160070,11599,10868,1145,8393,9538,1330,11107.42,10467.83,913.42,8398.33,9311.75,1156.08,133289,125614,10961,100780,111741,13873,2022,'TARTARUGALZINHO',Tartarugalzinho,'AP',1600709,2309.0,3320,192.4,276.7,1,0.0,1011.0,Pequeno I
310,310,160080,10569,9997,165,9338,9503,494,10654.75,10123.67,175.25,9530.58,9705.83,417.83,127857,121484,2103,114367,116470,5014,2022,'VITORIA DO JARI',Vitória do Jari,'AP',1600808,2319.0,3348,210.8,304.4,1,513.0,513.0,Pequeno I
311,311,170025,1911,1340,236,383,619,721,1865.58,1394.25,242.25,553.42,795.67,598.58,22387,16731,2907,6641,9548,7183,2022,'ABREULANDIA',Abreulândia,'TO',1700251,330.0,330,27.5,27.5,1,21.0,21.0,Pequeno I
312,312,170030,3759,3085,586,1184,1770,1315,3798.58,3196.83,601.75,1350.0,1951.75,1245.08,45583,38362,7221,16200,23421,14941,2022,'AGUIARNOPOLIS',Aguiarnópolis,'TO',1700301,1693.0,1693,141.1,141.1,1,48.0,48.0,Pequeno I
313,313,170035,4191,3432,323,1958,2281,1151,4112.92,3400.42,291.0,2034.0,2325.0,1075.42,49355,40805,3492,24408,27900,12905,2022,'ALIANCA DO TOCANTINS',Aliança do Tocantins,'TO',1700350,1502.0,1502,125.2,125.2,1,30.0,30.0,Pequeno I
314,314,170040,5504,4785,725,2671,3396,1389,5515.33,4876.08,549.67,3056.0,3605.67,1270.42,66184,58513,6596,36672,43268,15245,2022,'ALMAS',Almas,'TO',1700400,1299.0,1299,108.2,108.2,1,111.0,111.0,Pequeno I
315,315,170070,4923,4043,257,2422,2679,1364,4772.17,3970.5,224.0,2466.58,2690.58,1279.92,57266,47646,2688,29599,32287,15359,2022,'ALVORADA',Alvorada,'TO',1700707,5913.0,5913,492.8,492.8,1,378.0,378.0,Pequeno I
316,316,170100,7366,6458,845,4133,4978,1480,7248.67,6432.83,707.42,4209.92,4917.33,1515.5,86984,77194,8489,50519,59008,18186,2022,'ANANAS',Ananás,'TO',1701002,3439.0,3439,286.6,286.6,1,384.0,384.0,Pequeno I
317,317,170105,2096,1571,351,442,793,778,2100.58,1617.17,378.75,479.0,857.75,759.42,25207,19406,4545,5748,10293,9113,2022,'ANGICO',Angico,'TO',1701051,950.0,950,79.2,79.2,1,61.0,61.0,Pequeno I
318,318,170110,3275,2793,274,1623,1897,896,3158.33,2712.42,280.33,1585.75,1866.08,846.33,37900,32549,3364,19029,22393,10156,2022,'APARECIDA DO RIO NEGRO',Aparecida do Rio Negro,'TO',1701101,3182.0,3182,265.2,265.2,1,253.0,253.0,Pequeno I
319,319,170130,4357,3650,407,2222,2629,1021,4216.08,3555.42,456.75,2088.0,2544.75,1010.67,50593,42665,5481,25056,30537,12128,2022,'ARAGOMINAS',Aragominas,'TO',1701309,423.0,423,35.2,35.2,1,12.0,12.0,Pequeno I
320,320,170190,4442,3775,649,2148,2797,978,4364.25,3731.92,708.67,2000.75,2709.42,1022.5,52371,44783,8504,24009,32513,12270,2022,'ARAGUACEMA',Araguacema,'TO',1701903,2684.0,2684,223.7,223.7,1,84.0,84.0,Pequeno I
321,321,170200,5329,3972,724,1508,2232,1740,5260.67,3982.17,677.08,1632.08,2309.17,1673.0,63128,47786,8125,19585,27710,20076,2022,'ARAGUACU',Araguaçu,'TO',1702000,1365.0,1365,113.8,113.8,1,51.0,51.0,Pequeno I
322,322,170210,83632,69944,20932,13450,34382,35562,79382.67,67168.25,20668.92,13959.17,34628.08,32540.17,952592,806019,248027,167510,415537,390482,2022,'ARAGUAINA',Araguaína,'TO',1702109,6396.0,6396,533.0,533.0,3,323.0,323.0,Grande
323,323,170215,3731,3287,223,2423,2646,641,3733.33,3320.08,193.42,2557.67,2751.08,569.0,44800,39841,2321,30692,33013,6828,2022,'ARAGUANA',Araguanã,'TO',1702158,400.0,400,33.3,33.3,1,53.0,53.0,Pequeno I
324,324,170220,19468,17176,6894,4834,11728,5448,19222.83,17185.25,5602.5,6330.25,11932.75,5252.5,230674,206223,67230,75963,143193,63030,2022,'ARAGUATINS',Araguatins,'TO',1702208,3496.0,3496,291.3,291.3,1,72.0,72.0,Pequeno II
325,325,170230,3929,3239,824,1001,1825,1414,3848.5,3193.58,884.17,904.67,1788.83,1404.75,46182,38323,10610,10856,21466,16857,2022,'ARAPOEMA',Arapoema,'TO',1702307,1476.0,1476,123.0,123.0,1,26.0,26.0,Pequeno I
326,326,170240,8138,7048,543,5104,5647,1401,7828.08,6872.25,503.33,4999.0,5502.33,1369.92,93937,82467,6040,59988,66028,16439,2022,'ARRAIAS',Arraias,'TO',1702406,3114.0,3114,259.5,259.5,1,103.0,103.0,Pequeno I
327,327,170255,12039,9916,1808,4734,6542,3374,11818.5,9820.58,1833.67,4715.75,6549.42,3271.17,141822,117847,22004,56589,78593,39254,2022,'AUGUSTINOPOLIS',Augustinópolis,'TO',1702554,1017.0,1017,84.8,84.8,1,68.0,68.0,Pequeno I
328,328,170270,2352,1821,230,943,1173,648,2337.92,1860.42,212.33,1020.33,1232.67,627.75,28055,22325,2548,12244,14792,7533,2022,'AURORA DO TOCANTINS',Aurora do Tocantins,'TO',1702703,311.0,311,28.3,28.3,1,13.0,13.0,Pequeno I
329,329,170290,9302,8555,539,6817,7356,1199,9108.0,8477.83,519.5,6841.5,7361.0,1116.83,109296,101734,6234,82098,88332,13402,2022,'AXIXA DO TOCANTINS',Axixá do Tocantins,'TO',1702901,6664.0,6664,555.3,555.3,1,185.0,185.0,Pequeno I
330,330,170300,5931,5184,371,3769,4140,1044,5849.67,5174.42,397.5,3801.0,4198.5,975.92,70196,62093,4770,45612,50382,11711,2022,'BABACULANDIA',Babaçulândia,'TO',1703008,969.0,969,80.8,80.8,1,35.0,35.0,Pequeno I
331,331,170305,2000,1726,204,927,1131,595,1957.5,1726.5,198.42,954.33,1152.75,573.75,23490,20718,2381,11452,13833,6885,2022,'BANDEIRANTES DO TOCANTINS',Bandeirantes do Tocantins,'TO',1703057,533.0,533,44.4,44.4,1,48.0,48.0,Pequeno I
332,332,170307,3608,3211,492,1903,2395,816,3512.75,3137.5,402.0,1920.33,2322.33,815.17,42153,37650,4824,23044,27868,9782,2022,'BARRA DO OURO',Barra do Ouro,'TO',1703073,469.0,469,39.1,39.1,1,6.0,6.0,Pequeno I
333,333,170310,4325,3467,498,1792,2290,1177,4250.0,3460.92,469.42,1826.83,2296.25,1164.67,51000,41531,5633,21922,27555,13976,2022,'BARROLANDIA',Barrolândia,'TO',1703107,1404.0,1404,117.0,117.0,1,135.0,135.0,Pequeno I
334,334,170320,3123,2577,377,1500,1877,700,2988.58,2516.67,326.42,1533.75,1860.17,656.5,35863,30200,3917,18405,22322,7878,2022,'BERNARDO SAYAO',Bernardo Sayão,'TO',1703206,155.0,155,12.9,12.9,1,6.0,6.0,Pequeno I
335,335,170330,3247,3087,139,2622,2761,326,3036.0,2890.33,139.58,2423.5,2563.08,327.25,36432,34684,1675,29082,30757,3927,2022,'BOM JESUS DO TOCANTINS',Bom Jesus do Tocantins,'TO',1703305,1826.0,3168,152.2,264.0,1,118.0,118.0,Pequeno I
336,336,170360,1625,1318,83,789,872,446,1588.25,1308.0,87.42,830.58,918.0,390.0,19059,15696,1049,9967,11016,4680,2022,'BRASILANDIA DO TOCANTINS',Brasilândia do Tocantins,'TO',1703602,1651.0,1651,137.6,137.6,1,71.0,71.0,Pequeno I
337,337,170370,3633,2924,501,1373,1874,1050,3584.0,2912.83,523.67,1311.42,1835.08,1077.75,43008,34954,6284,15737,22021,12933,2022,'BREJINHO DE NAZARE',Brejinho de Nazaré,'TO',1703701,1188.0,1188,99.0,99.0,1,45.0,45.0,Pequeno I
338,338,170380,5640,4816,444,2884,3328,1488,5554.42,4785.67,394.83,2933.67,3328.5,1457.17,66653,57428,4738,35204,39942,17486,2022,'BURITI DO TOCANTINS',Buriti do Tocantins,'TO',1703800,1532.0,1532,127.7,127.7,1,23.0,23.0,Pequeno I
339,339,170382,1599,1407,83,951,1034,373,1636.25,1457.58,92.33,1033.33,1125.67,331.92,19635,17491,1108,12400,13508,3983,2022,'CACHOEIRINHA',Cachoeirinha,'TO',1703826,1278.0,1278,106.5,106.5,1,33.0,33.0,Pequeno I
340,340,170384,6232,5589,1081,3004,4085,1504,6071.5,5469.08,1089.0,2964.75,4053.75,1415.33,72858,65629,13068,35577,48645,16984,2022,'CAMPOS LINDOS',Campos Lindos,'TO',1703842,1846.0,1846,153.8,153.8,1,447.0,447.0,Pequeno I
341,341,170386,2875,2018,280,645,925,1093,2836.25,2033.42,265.5,701.67,967.17,1066.25,34035,24401,3186,8420,11606,12795,2022,'CARIRI DO TOCANTINS',Cariri do Tocantins,'TO',1703867,1469.0,1469,122.4,122.4,1,22.0,22.0,Pequeno I
342,342,170388,2121,1700,264,849,1113,587,2092.92,1690.75,242.67,812.58,1055.25,635.5,25115,20289,2912,9751,12663,7626,2022,'CARMOLANDIA',Carmolândia,'TO',1703883,988.0,988,82.3,82.3,1,29.0,29.0,Pequeno I
343,343,170389,2922,2553,309,1599,1908,645,3014.17,2661.17,299.83,1744.67,2044.5,616.67,36170,31934,3598,20936,24534,7400,2022,'CARRASCO BONITO',Carrasco Bonito,'TO',1703891,956.0,956,79.7,79.7,1,17.0,17.0,Pequeno I
344,344,170390,4349,3711,97,3235,3332,379,4259.08,3662.67,94.58,3176.58,3271.17,391.5,51109,43952,1135,38119,39254,4698,2022,'CASEARA',Caseara,'TO',1703909,2628.0,2628,219.0,219.0,1,170.0,170.0,Pequeno I
345,345,170410,1695,1366,86,874,960,406,1722.67,1411.75,103.5,921.5,1025.0,386.75,20672,16941,1242,11058,12300,4641,2022,'CENTENARIO',Centenário,'TO',1704105,1270.0,1270,105.8,105.8,1,76.0,76.0,Pequeno I
346,346,170460,1227,1062,155,666,821,241,1177.92,1041.83,136.58,699.83,836.42,205.42,14135,12502,1639,8398,10037,2465,2022,'CHAPADA DE AREIA',Chapada de Areia,'TO',1704600,3012.0,3012,251.0,251.0,1,61.0,61.0,Pequeno I
347,347,170510,2762,2213,131,1315,1446,767,2711.0,2205.33,149.42,1317.92,1467.33,738.0,32532,26464,1793,15815,17608,8856,2022,'CHAPADA DA NATIVIDADE',Chapada da Natividade,'TO',1705102,957.0,957,79.8,79.8,1,45.0,45.0,Pequeno I
348,348,170550,19745,16600,4886,5105,9991,6609,19137.25,16228.42,4699.67,4973.58,9673.25,6555.17,229647,194741,56396,59683,116079,78662,2022,'COLINAS DO TOCANTINS',Colinas do Tocantins,'TO',1705508,4479.0,4479,373.2,373.2,3,341.0,341.0,Pequeno II
349,349,170555,3946,3397,325,1746,2071,1326,3912.83,3427.42,289.58,1790.08,2079.67,1347.75,46954,41129,3475,21481,24956,16173,2022,'COMBINADO',Combinado,'TO',1705557,867.0,867,72.2,72.2,1,88.0,88.0,Pequeno I
350,350,170560,2989,2574,275,1552,1827,747,2992.92,2613.58,292.5,1653.92,1946.42,667.17,35915,31363,3510,19847,23357,8006,2022,'CONCEICAO DO TOCANTINS',Conceição do Tocantins,'TO',1705607,414.0,414,34.5,34.5,1,19.0,19.0,Pequeno I
351,351,170600,4066,3498,570,2032,2602,896,3874.42,3385.5,587.25,1944.0,2531.25,854.25,46493,40626,7047,23328,30375,10251,2022,'COUTO DE MAGALHAES',Couto de Magalhães,'TO',1706001,2496.0,2496,208.0,208.0,1,29.0,29.0,Pequeno I
352,352,170610,4580,3813,371,2419,2790,1023,4479.08,3780.83,376.58,2377.17,2753.75,1027.08,53749,45370,4519,28526,33045,12325,2022,'CRISTALANDIA',Cristalândia,'TO',1706100,346.0,346,28.8,28.8,1,3.0,3.0,Pequeno I
353,353,170625,1244,926,100,348,448,478,1223.0,920.33,90.42,355.17,445.58,474.75,14676,11044,1085,4262,5347,5697,2022,'CRIXAS DO TOCANTINS',Crixás do Tocantins,'TO',1706258,1185.0,1185,98.8,98.8,1,9.0,9.0,Pequeno I
354,354,170650,4449,3938,442,2503,2945,993,4194.42,3737.17,431.58,2396.33,2827.92,909.25,50333,44846,5179,28756,33935,10911,2022,'DARCINOPOLIS',Darcinópolis,'TO',1706506,1126.0,1126,93.8,93.8,1,22.0,22.0,Pequeno I
355,355,170700,11447,9421,1981,3942,5923,3498,11050.0,9250.25,1891.75,4017.17,5908.92,3341.33,132600,111003,22701,48206,70907,40096,2022,'DIANOPOLIS',Dianópolis,'TO',1707009,1561.0,1561,130.1,130.1,1,73.0,73.0,Pequeno I
356,356,170710,4381,3681,418,2434,2852,829,4185.83,3576.08,436.42,2352.75,2789.17,786.92,50230,42913,5237,28233,33470,9443,2022,'DIVINOPOLIS DO TOCANTINS',Divinópolis do Tocantins,'TO',1707108,392.0,392,32.7,32.7,1,24.0,24.0,Pequeno I
357,357,170720,4797,3979,409,2669,3078,901,4715.42,3964.17,484.25,2565.17,3049.42,914.75,56585,47570,5811,30782,36593,10977,2022,'DOIS IRMAOS DO TOCANTINS',Dois Irmãos do Tocantins,'TO',1707207,2780.0,2780,231.7,231.7,1,100.0,100.0,Pequeno I
358,358,170730,3150,2672,262,1662,1924,748,3075.25,2614.25,254.58,1619.33,1873.92,740.33,36903,31371,3055,19432,22487,8884,2022,'DUERE',Dueré,'TO',1707306,909.0,909,75.8,75.8,1,51.0,51.0,Pequeno I
359,359,170740,7075,6413,562,4704,5266,1147,7059.67,6457.75,591.0,4696.33,5287.33,1170.42,84716,77493,7092,56356,63448,14045,2022,'ESPERANTINA',Esperantina,'TO',1707405,1740.0,1740,145.0,145.0,1,102.0,102.0,Pequeno I
360,360,170755,2465,1977,398,865,1263,714,2475.33,2014.17,380.0,850.5,1230.5,783.67,29704,24170,4560,10206,14766,9404,2022,'FATIMA',Fátima,'TO',1707553,1228.0,1228,102.3,102.3,1,41.0,41.0,Pequeno I
361,361,170765,3236,2566,405,1289,1694,872,3141.0,2549.83,444.58,1289.17,1733.75,816.08,37692,30598,5335,15470,20805,9793,2022,'FIGUEIROPOLIS',Figueirópolis,'TO',1707652,1347.0,1347,112.2,112.2,1,150.0,150.0,Pequeno I
362,362,170770,5679,5003,502,3517,4019,984,5547.0,4928.75,491.67,3459.33,3951.0,977.75,66564,59145,5900,41512,47412,11733,2022,'FILADELFIA',Filadélfia,'TO',1707702,3510.0,3510,292.5,292.5,1,268.0,268.0,Pequeno I
363,363,170820,12306,10429,2030,5227,7257,3172,11702.75,10029.75,1897.25,5154.0,7051.25,2978.5,140433,120357,22767,61848,84615,35742,2022,'FORMOSO DO ARAGUAIA',Formoso do Araguaia,'TO',1708205,4135.0,4135,344.6,344.6,1,278.0,278.0,Pequeno I
364,364,170825,2584,2283,216,1721,1937,346,2511.17,2235.67,188.25,1710.5,1898.75,336.92,30134,26828,2259,20526,22785,4043,2022,'FORTALEZA DO TABOCAO',Fortaleza do Tabocão,'TO',1708254,1323.0,1323,110.2,110.2,1,133.0,133.0,Pequeno I
365,365,170830,3805,3121,862,1304,2166,955,3774.17,3212.08,858.92,1441.42,2300.33,911.75,45290,38545,10307,17297,27604,10941,2022,'GOIANORTE',Goianorte,'TO',1708304,1332.0,1332,111.0,111.0,1,123.0,123.0,Pequeno I
366,366,170900,9728,8984,939,7104,8043,941,9177.17,8500.83,718.67,6910.67,7629.33,871.5,110126,102010,8624,82928,91552,10458,2022,'GOIATINS',Goiatins,'TO',1709005,943.0,943,78.6,78.6,1,47.0,47.0,Pequeno I
367,367,170930,11977,9823,2416,2972,5388,4435,11376.75,9461.33,2272.08,3002.5,5274.58,4186.75,136521,113536,27265,36030,63295,50241,2022,'GUARAI',Guaraí,'TO',1709302,1095.0,1095,91.2,91.2,1,58.0,58.0,Pequeno II
368,368,170950,36034,28730,9207,3873,13080,15650,34467.58,27774.42,8609.92,4136.67,12746.58,15027.83,413611,333293,103319,49640,152959,180334,2022,'GURUPI',Gurupi,'TO',1709500,3874.0,3874,322.8,322.8,3,363.0,363.0,Médio
369,369,170980,1394,1083,154,567,721,362,1378.58,1121.42,147.08,602.75,749.83,371.58,16543,13457,1765,7233,8998,4459,2022,'IPUEIRAS',Ipueiras,'TO',1709807,767.0,767,63.9,63.9,1,71.0,71.0,Pequeno I
370,370,171050,5580,5088,421,3916,4337,751,5458.58,5034.83,328.0,4007.25,4335.25,699.58,65503,60418,3936,48087,52023,8395,2022,'ITACAJA',Itacajá,'TO',1710508,2188.0,2188,182.3,182.3,1,185.0,185.0,Pequeno I
371,371,171070,4037,3672,710,2100,2810,862,3992.08,3665.08,659.33,2207.58,2866.92,798.17,47905,43981,7912,26491,34403,9578,2022,'ITAGUATINS',Itaguatins,'TO',1710706,918.0,918,76.5,76.5,1,89.0,89.0,Pequeno I
372,372,171090,2871,2453,418,1243,1661,792,2825.25,2461.92,385.42,1344.33,1729.75,732.17,33903,29543,4625,16132,20757,8786,2022,'ITAPIRATINS',Itapiratins,'TO',1710904,1668.0,1668,139.0,139.0,1,78.0,78.0,Pequeno I
373,373,171110,1718,1320,195,567,762,558,1652.17,1279.75,220.5,536.83,757.33,522.42,19826,15357,2646,6442,9088,6269,2022,'ITAPORA DO TOCANTINS',Itaporã do Tocantins,'TO',1711100,1181.0,1181,98.4,98.4,1,20.0,20.0,Pequeno I
374,374,171150,2695,1936,197,1129,1326,610,2730.67,2007.17,177.17,1220.33,1397.5,609.67,32768,24086,2126,14644,16770,7316,2022,'JAU DO TOCANTINS',Jaú do Tocantins,'TO',1711506,1900.0,2978,158.3,248.2,1,43.0,43.0,Pequeno I
375,375,171180,2249,1631,284,654,938,693,2220.5,1671.67,248.58,735.17,983.75,687.92,26646,20060,2983,8822,11805,8255,2022,'JUARINA',Juarina,'TO',1711803,972.0,972,81.0,81.0,1,34.0,34.0,Pequeno I
376,376,171190,6700,6023,995,3517,4512,1511,6696.17,6128.92,978.67,3835.08,4813.75,1315.17,80354,73547,11744,46021,57765,15782,2022,'LAGOA DA CONFUSAO',Lagoa da Confusão,'TO',1711902,3538.0,3538,294.8,294.8,1,211.0,211.0,Pequeno I
377,377,171195,2799,2379,416,1370,1786,593,2730.0,2358.58,399.08,1380.5,1779.58,579.0,32760,28303,4789,16566,21355,6948,2022,'LAGOA DO TOCANTINS',Lagoa do Tocantins,'TO',1711951,1809.0,1809,150.8,150.8,1,85.0,85.0,Pequeno I
378,378,171200,1889,1538,437,429,866,672,1836.75,1528.92,414.17,502.83,917.0,611.92,22041,18347,4970,6034,11004,7343,2022,'LAJEADO',Lajeado,'TO',1712009,3190.0,3190,265.8,265.8,1,289.0,289.0,Pequeno I
379,379,171215,1137,966,121,494,615,351,1106.83,953.83,118.67,537.17,655.83,298.0,13282,11446,1424,6446,7870,3576,2022,'LAVANDEIRA',Lavandeira,'TO',1712157,1243.0,1243,103.6,103.6,1,72.0,72.0,Pequeno I
380,380,171240,2631,2274,97,1504,1601,673,2626.83,2293.0,147.67,1520.17,1667.83,625.17,31522,27516,1772,18242,20014,7502,2022,'LIZARDA',Lizarda,'TO',1712405,1016.0,1016,84.7,84.7,1,31.0,31.0,Pequeno I
381,381,171245,2380,1968,185,1063,1248,720,2341.83,1951.08,181.5,1133.58,1315.08,636.0,28102,23413,2178,13603,15781,7632,2022,'LUZINOPOLIS',Luzinópolis,'TO',1712454,1457.0,1457,121.4,121.4,1,50.0,50.0,Pequeno I
382,382,171250,2909,2300,399,981,1380,920,2851.75,2343.33,432.5,1089.08,1521.58,821.75,34221,28120,5190,13069,18259,9861,2022,'MARIANOPOLIS DO TOCANTINS',Marianópolis do Tocantins,'TO',1712504,1193.0,1193,99.4,99.4,1,35.0,35.0,Pequeno I
383,383,171270,1819,1536,298,727,1025,511,1786.83,1521.25,319.0,731.75,1050.75,470.5,21442,18255,3828,8781,12609,5646,2022,'MATEIROS',Mateiros,'TO',1712702,1371.0,1371,114.2,114.2,1,70.0,70.0,Pequeno I
384,384,171280,2813,2459,204,1584,1788,671,2783.5,2452.08,215.83,1607.67,1823.5,628.58,33402,29425,2590,19292,21882,7543,2022,'MAURILANDIA DO TOCANTINS',Maurilândia do Tocantins,'TO',1712801,903.0,903,75.2,75.2,1,10.0,10.0,Pequeno I
385,385,171320,12063,10135,2020,4040,6060,4075,11872.42,10174.17,1880.08,4401.5,6281.58,3892.58,142469,122090,22561,52818,75379,46711,2022,'MIRACEMA DO TOCANTINS',Miracema do Tocantins,'TO',1713205,2497.0,2497,208.1,208.1,1,280.0,280.0,Pequeno II
386,386,171330,8565,7170,1925,3102,5027,2143,8298.5,7045.33,1712.58,3226.33,4938.92,2106.42,99582,84544,20551,38716,59267,25277,2022,'MIRANORTE',Miranorte,'TO',1713304,5157.0,5157,429.8,429.8,1,394.0,394.0,Pequeno I
387,387,171360,4507,3869,389,2644,3033,836,4406.25,3838.92,341.75,2704.83,3046.58,792.33,52875,46067,4101,32458,36559,9508,2022,'MONTE DO CARMO',Monte do Carmo,'TO',1713601,2059.0,2059,171.6,171.6,1,190.0,190.0,Pequeno I
388,388,171370,1946,1645,197,993,1190,455,1924.33,1650.58,161.67,1097.58,1259.25,391.33,23092,19807,1940,13171,15111,4696,2022,'MONTE SANTO DO TOCANTINS',Monte Santo do Tocantins,'TO',1713700,3207.0,3207,267.2,267.2,1,229.0,229.0,Pequeno I
389,389,171380,4388,3945,449,2810,3259,686,4347.25,3962.92,397.58,2958.0,3355.58,607.33,52167,47555,4771,35496,40267,7288,2022,'PALMEIRAS DO TOCANTINS',Palmeiras do Tocantins,'TO',1713809,935.0,935,77.9,77.9,1,12.0,12.0,Pequeno I
390,390,171395,2839,2173,293,1282,1575,598,2816.75,2194.17,237.67,1384.75,1622.42,571.75,33801,26330,2852,16617,19469,6861,2022,'MURICILANDIA',Muricilândia,'TO',1713957,1396.0,1396,116.3,116.3,1,116.0,116.0,Pequeno I
391,391,171420,5922,4873,950,2424,3374,1499,5896.17,4901.75,907.67,2425.0,3332.67,1569.08,70754,58821,10892,29100,39992,18829,2022,'NATIVIDADE',Natividade,'TO',1714203,2925.0,2925,243.8,243.8,1,511.0,511.0,Pequeno I
392,392,171430,3401,2950,229,1811,2040,910,3337.17,2963.25,223.08,1901.42,2124.5,838.75,40046,35559,2677,22817,25494,10065,2022,'NAZARE',Nazaré,'TO',1714302,159.0,159,13.2,13.2,1,6.0,6.0,Pequeno I
393,393,171488,7522,6388,1150,3269,4419,1969,7363.5,6387.67,1081.92,3475.33,4557.25,1830.42,88362,76652,12983,41704,54687,21965,2022,'NOVA OLINDA',Nova Olinda,'TO',1714880,3104.0,3104,258.7,258.7,1,30.0,30.0,Pequeno I
394,394,171500,2456,1934,241,1108,1349,585,2474.75,2004.25,220.08,1231.67,1451.75,552.5,29697,24051,2641,14780,17421,6630,2022,'NOVA ROSALANDIA',Nova Rosalândia,'TO',1715002,1189.0,1189,99.1,99.1,1,41.0,41.0,Pequeno I
395,395,171510,2790,2529,283,1633,1916,613,2760.67,2520.08,247.92,1717.5,1965.42,554.67,33128,30241,2975,20610,23585,6656,2022,'NOVO ACORDO',Novo Acordo,'TO',1715101,1476.0,1476,123.0,123.0,1,64.0,64.0,Pequeno I
396,396,171515,1327,1059,99,636,735,324,1305.58,1070.33,107.83,635.08,742.92,327.42,15667,12844,1294,7621,8915,3929,2022,'NOVO ALEGRE',Novo Alegre,'TO',1715150,609.0,609,50.8,50.8,1,25.0,25.0,Pequeno I
397,397,171525,2059,1709,225,986,1211,498,2065.33,1733.25,188.83,1053.33,1242.17,491.08,24784,20799,2266,12640,14906,5893,2022,'NOVO JARDIM',Novo Jardim,'TO',1715259,111.0,111,9.2,9.2,1,12.0,12.0,Pequeno I
398,398,171550,1045,912,156,409,565,347,1024.25,899.92,153.67,462.17,615.83,284.08,12291,10799,1844,5546,7390,3409,2022,'OLIVEIRA DE FATIMA',Oliveira de Fátima,'TO',1715507,485.0,485,40.4,40.4,1,35.0,35.0,Pequeno I
399,399,171570,3374,2983,456,1755,2211,772,3385.0,3032.83,415.08,1852.17,2267.25,765.58,40620,36394,4981,22226,27207,9187,2022,'PALMEIRANTE',Palmeirante,'TO',1715705,409.0,409,34.1,34.1,1,59.0,59.0,Pequeno I
400,400,171575,4843,3660,381,1841,2222,1438,4835.75,3712.75,392.0,1793.83,2185.83,1526.92,58029,44553,4704,21526,26230,18323,2022,'PALMEIROPOLIS',Palmeirópolis,'TO',1715754,2748.0,2748,229.0,229.0,2,55.0,55.0,Pequeno I
401,401,171610,18889,15591,4213,3553,7766,7825,17959.75,15042.33,3804.08,3901.75,7705.83,7336.5,215517,180508,45649,46821,92470,88038,2022,'PARAISO DO TOCANTINS',Paraíso do Tocantins,'TO',1716109,3884.0,3884,323.7,323.7,2,145.0,145.0,Pequeno II
402,402,171620,8082,7355,445,6059,6504,851,7854.58,7185.58,443.17,5975.08,6418.25,767.33,94255,86227,5318,71701,77019,9208,2022,'PARANA',Paranã,'TO',1716208,4317.0,4317,359.8,359.8,1,194.0,194.0,Pequeno I
403,403,171630,3122,2648,390,1693,2083,565,2964.42,2572.25,330.58,1745.33,2075.92,496.33,35573,30867,3967,20944,24911,5956,2022,'PAU DARCO',Pau D´arco,'TO',1716307,1011.0,1011,84.2,84.2,1,50.0,50.0,Pequeno I
404,404,171650,7052,5952,1602,1675,3277,2675,6713.33,5787.58,1537.58,1857.92,3395.5,2392.08,80560,69451,18451,22295,40746,28705,2022,'PEDRO AFONSO',Pedro Afonso,'TO',1716505,5311.0,5311,442.6,442.6,1,254.0,254.0,Pequeno I
405,405,171660,6414,5074,471,3259,3730,1344,6248.25,4989.0,502.33,3146.75,3649.08,1339.92,74979,59868,6028,37761,43789,16079,2022,'PEIXE',Peixe,'TO',1716604,3812.0,3812,317.7,317.7,1,182.0,182.0,Pequeno I
406,406,171665,3815,3290,743,1409,2152,1138,3730.92,3261.92,673.67,1555.08,2228.75,1033.17,44771,39143,8084,18661,26745,12398,2022,'PEQUIZEIRO',Pequizeiro,'TO',1716653,796.0,796,66.3,66.3,1,46.0,46.0,Pequeno I
407,407,171670,5472,4482,716,2002,2718,1764,5393.42,4488.92,685.92,2084.25,2770.17,1718.75,64721,53867,8231,25011,33242,20625,2022,'COLMEIA',Colméia,'TO',1716703,3038.0,3038,253.2,253.2,1,91.0,91.0,Pequeno I
408,408,171700,3464,2775,377,1547,1924,851,3456.0,2825.33,346.92,1622.0,1968.92,856.42,41472,33904,4163,19464,23627,10277,2022,'PINDORAMA DO TOCANTINS',Pindorama do Tocantins,'TO',1717008,545.0,545,45.4,45.4,1,22.0,22.0,Pequeno I
409,409,171720,2135,1792,207,1202,1409,383,2122.75,1820.33,150.33,1310.5,1460.83,359.5,25473,21844,1804,15726,17530,4314,2022,'PIRAQUE',Piraquê,'TO',1717206,701.0,701,58.4,58.4,1,13.0,13.0,Pequeno I
410,410,171750,4681,3740,819,1248,2067,1673,4189.83,3317.33,803.42,879.75,1683.17,1634.17,50278,39808,9641,10557,20198,19610,2022,'PIUM',Pium,'TO',1717503,330.0,330,27.5,27.5,1,16.0,16.0,Pequeno I
411,411,171780,3501,2805,313,1749,2062,743,3422.42,2810.75,277.67,1888.08,2165.75,645.0,41069,33729,3332,22657,25989,7740,2022,'PONTE ALTA DO BOM JESUS',Ponte Alta do Bom Jesus,'TO',1717800,2103.0,2103,175.2,175.2,1,105.0,105.0,Pequeno I
412,412,171790,4907,4176,632,2108,2740,1436,4791.67,4147.17,638.33,2113.42,2751.75,1395.42,57500,49766,7660,25361,33021,16745,2022,'PONTE ALTA DO TOCANTINS',Ponte Alta do Tocantins,'TO',1717909,1102.0,1102,91.8,91.8,1,62.0,62.0,Pequeno I
413,413,171800,2074,1775,191,960,1151,624,2059.08,1780.83,211.33,979.83,1191.17,589.67,24709,21370,2536,11758,14294,7076,2022,'PORTO ALEGRE DO TOCANTINS',Porto Alegre do Tocantins,'TO',1718006,399.0,399,33.2,33.2,1,34.0,34.0,Pequeno I
414,414,171820,36770,30455,7833,7997,15830,14625,35408.42,29721.25,7526.17,8624.08,16150.25,13571.0,424901,356655,90314,103489,193803,162852,2022,'PORTO NACIONAL',Porto Nacional,'TO',1718204,17243.0,17243,1436.9,1436.9,3,759.0,759.0,Pequeno II
415,415,171830,5222,4767,864,2605,3469,1298,5142.0,4705.25,741.92,2783.08,3525.0,1180.25,61704,56463,8903,33397,42300,14163,2022,'PRAIA NORTE',Praia Norte,'TO',1718303,2290.0,2290,190.8,190.8,1,71.0,71.0,Pequeno I
416,416,171840,2050,1699,70,980,1050,649,2054.83,1744.08,94.83,1032.0,1126.83,617.25,24658,20929,1138,12384,13522,7407,2022,'PRESIDENTE KENNEDY',Presidente Kennedy,'TO',1718402,1337.0,1337,111.4,111.4,1,135.0,135.0,Pequeno I
417,417,171845,1788,1497,157,970,1127,370,1710.17,1448.0,155.58,962.33,1117.92,330.08,20522,17376,1867,11548,13415,3961,2022,'PUGMIL',Pugmil,'TO',1718451,983.0,983,81.9,81.9,1,182.0,182.0,Pequeno I
418,418,171850,3196,2822,176,2139,2315,507,3164.75,2817.25,237.17,2053.75,2290.92,526.33,37977,33807,2846,24645,27491,6316,2022,'RECURSOLANDIA',Recursolândia,'TO',1718501,1909.0,1909,159.1,159.1,1,105.0,105.0,Pequeno I
419,419,171855,3429,3026,332,1711,2043,983,3309.67,2974.75,262.58,1811.08,2073.67,901.08,39716,35697,3151,21733,24884,10813,2022,'RIACHINHO',Riachinho,'TO',1718550,1306.0,1306,108.8,108.8,1,272.0,272.0,Pequeno I
420,420,171865,1523,1379,190,785,975,404,1478.08,1352.42,186.75,777.58,964.33,388.08,17737,16229,2241,9331,11572,4657,2022,'RIO DA CONCEICAO',Rio da Conceição,'TO',1718659,316.0,316,26.3,26.3,1,13.0,13.0,Pequeno I
421,421,171870,2385,1883,341,870,1211,672,2355.83,1880.67,276.67,945.92,1222.58,658.08,28270,22568,3320,11351,14671,7897,2022,'RIO DOS BOIS',Rio Dos Bois,'TO',1718709,1949.0,1949,162.4,162.4,1,59.0,59.0,Pequeno I
422,422,171875,4195,3727,232,2819,3051,676,4032.08,3599.75,186.17,2748.58,2934.75,665.0,48385,43197,2234,32983,35217,7980,2022,'RIO SONO',Rio Sono,'TO',1718758,466.0,466,38.8,38.8,1,66.0,66.0,Pequeno I
423,423,171880,4127,3813,138,3047,3185,628,3977.25,3700.75,135.0,2973.75,3108.75,592.0,47727,44409,1620,35685,37305,7104,2022,'SAMPAIO',Sampaio,'TO',1718808,512.0,512,42.7,42.7,1,18.0,18.0,Pequeno I
424,424,171884,3167,2637,550,1343,1893,744,3017.25,2536.67,533.67,1203.75,1737.42,799.25,36207,30440,6404,14445,20849,9591,2022,'SANDOLANDIA',Sandolândia,'TO',1718840,1591.0,1591,132.6,132.6,1,36.0,36.0,Pequeno I
425,425,171886,4501,3786,1061,1040,2101,1685,4347.75,3669.42,1033.25,1021.0,2054.25,1615.17,52173,44033,12399,12252,24651,19382,2022,'SANTA FE DO ARAGUAIA',Santa fé do Araguaia,'TO',1718865,860.0,860,71.7,71.7,1,58.0,58.0,Pequeno I
426,426,171888,1833,1401,117,756,873,528,1861.75,1461.67,113.83,827.58,941.42,520.25,22341,17540,1366,9931,11297,6243,2022,'SANTA MARIA DO TOCANTINS',Santa Maria do Tocantins,'TO',1718881,1715.0,1715,142.9,142.9,1,130.0,130.0,Pequeno I
427,427,171889,1412,1044,271,313,584,460,1333.5,1051.0,245.17,353.08,598.25,452.75,16002,12612,2942,4237,7179,5433,2022,'SANTA RITA DO TOCANTINS',Santa Rita do Tocantins,'TO',1718899,422.0,422,35.2,35.2,1,30.0,30.0,Pequeno I
428,428,171890,3839,3200,464,1849,2313,887,3698.58,3111.75,433.33,1884.25,2317.58,794.17,44383,37341,5200,22611,27811,9530,2022,'SANTA ROSA DO TOCANTINS',Santa Rosa do Tocantins,'TO',1718907,948.0,948,79.0,79.0,1,84.0,84.0,Pequeno I
429,429,171900,2025,1717,216,793,1009,708,2000.42,1714.08,230.5,801.58,1032.08,682.0,24005,20569,2766,9619,12385,8184,2022,'SANTA TEREZA DO TOCANTINS',Santa Tereza do Tocantins,'TO',1719004,1531.0,1531,139.2,139.2,1,49.0,49.0,Pequeno I
430,430,172000,1852,1568,310,578,888,680,1813.42,1580.25,286.0,693.25,979.25,601.0,21761,18963,3432,8319,11751,7212,2022,'SANTA TEREZINHA DO TOCANTI,Santa Terezinha do Tocantins,'TO',1720002,693.0,693,57.8,57.8,1,11.0,11.0,Pequeno I
431,431,172010,4176,3768,348,2355,2703,1065,3922.75,3593.0,350.33,2304.42,2654.75,938.25,47073,43116,4204,27653,31857,11259,2022,'SAO BENTO DO TOCANTINS',São Bento do Tocantins,'TO',1720101,1310.0,1310,109.2,109.2,1,26.0,26.0,Pequeno I
432,432,172015,1374,1169,219,500,719,450,1339.42,1148.92,197.08,505.75,702.83,446.08,16073,13787,2365,6069,8434,5353,2022,'SAO FELIX DO TOCANTINS',São Félix do Tocantins,'TO',1720150,809.0,809,67.4,67.4,1,87.0,87.0,Pequeno I
433,433,172020,8586,8015,711,5913,6624,1391,8324.83,7798.42,581.0,5940.58,6521.58,1276.83,99898,93581,6972,71287,78259,15322,2022,'SAO MIGUEL DO TOCANTINS',São Miguel do Tocantins,'TO',1720200,6417.0,7508,534.8,625.7,1,679.0,679.0,Pequeno I
434,434,172025,2075,1685,141,1120,1261,424,2067.75,1715.25,139.42,1182.25,1321.67,393.58,24813,20583,1673,14187,15860,4723,2022,'SAO SALVADOR DO TOCANTINS',São Salvador do Tocantins,'TO',1720259,1091.0,1091,90.9,90.9,1,55.0,55.0,Pequeno I
435,435,172030,3930,3462,291,2474,2765,697,3900.17,3477.0,277.58,2539.83,2817.42,659.58,46802,41724,3331,30478,33809,7915,2022,'SAO SEBASTIAO DO TOCANTINS,São Sebastião do Tocantins,'TO',1720309,1530.0,1530,127.5,127.5,1,80.0,80.0,Pequeno I
436,436,172049,3352,2636,352,1375,1727,909,3313.58,2635.5,355.75,1439.0,1794.75,840.75,39763,31626,4269,17268,21537,10089,2022,'SAO VALERIO DA NATIVIDADE',São Valério da Natividade,'TO',1720499,2518.0,2518,209.8,209.8,1,57.0,57.0,Pequeno I
437,437,172065,3959,3468,298,2659,2957,511,3888.58,3442.92,269.25,2772.33,3041.58,401.33,46663,41315,3231,33268,36499,4816,2022,'SILVANOPOLIS',Silvanópolis,'TO',1720655,784.0,784,65.3,65.3,1,6.0,6.0,Pequeno I
438,438,172080,7481,6505,403,4257,4660,1845,7363.75,6451.33,420.08,4259.58,4679.67,1771.67,88365,77416,5041,51115,56156,21260,2022,'SITIO NOVO DO TOCANTINS',Sítio Novo do Tocantins,'TO',1720804,857.0,857,71.4,71.4,1,109.0,109.0,Pequeno I
439,439,172085,1324,927,173,293,466,461,1322.5,933.08,173.17,317.75,490.92,442.17,15870,11197,2078,3813,5891,5306,2022,'SUCUPIRA',Sucupira,'TO',1720853,688.0,688,57.3,57.3,1,41.0,41.0,Pequeno I
440,440,172090,10713,9280,371,7319,7690,1590,10460.5,9157.83,376.5,7271.17,7647.67,1510.17,125526,109894,4518,87254,91772,18122,2022,'TAGUATINGA',Taguatinga,'TO',1720903,8479.0,10303,706.6,858.6,1,481.0,481.0,Pequeno I
441,441,172093,1490,1205,139,652,791,414,1441.5,1191.25,117.17,659.42,776.58,414.67,17298,14295,1406,7913,9319,4976,2022,'TAIPAS DO TOCANTINS',Taipas do Tocantins,'TO',1720937,304.0,304,25.3,25.3,1,20.0,20.0,Pequeno I
442,442,172097,1983,1504,268,520,788,716,1945.33,1520.5,241.5,587.5,829.0,691.5,23344,18246,2898,7050,9948,8298,2022,'TALISMA',Talismã,'TO',1720978,1124.0,1124,93.7,93.7,1,90.0,90.0,Pequeno I
443,443,172100,140260,115906,23941,47665,71606,44300,134393.08,111785.92,21948.58,46631.75,68580.33,43205.58,1612717,1341431,263383,559581,822964,518467,2022,'PALMAS',Palmas,'TO',1721000,104756.0,104756,8729.7,8729.7,7,8150.0,8150.0,Grande
444,444,172110,6302,5843,476,4509,4985,858,6100.0,5701.42,447.92,4478.75,4926.67,774.75,73200,68417,5375,53745,59120,9297,2022,'TOCANTINIA',Tocantínia,'TO',1721109,5986.0,5986,498.8,498.8,1,454.0,454.0,Pequeno I
445,445,172120,16204,14003,1570,8381,9951,4052,15730.33,13774.42,1627.17,8260.42,9887.58,3886.83,188764,165293,19526,99125,118651,46642,2022,'TOCANTINOPOLIS',Tocantinópolis,'TO',1721208,2322.0,2322,193.5,193.5,1,150.0,150.0,Pequeno II
446,446,172125,1205,1007,112,503,615,392,1169.33,996.75,103.25,534.5,637.75,359.0,14032,11961,1239,6414,7653,4308,2022,'TUPIRAMA',Tupirama,'TO',1721257,427.0,427,35.6,35.6,1,25.0,25.0,Pequeno I
447,447,172130,1635,1343,78,812,890,453,1625.25,1350.17,84.83,842.67,927.5,422.67,19503,16202,1018,10112,11130,5072,2022,'TUPIRATINS',Tupiratins,'TO',1721307,483.0,483,40.2,40.2,1,21.0,21.0,Pequeno I
448,448,172208,6657,5753,433,4146,4579,1174,6647.17,5846.0,427.33,4354.83,4782.17,1063.83,79766,70152,5128,52258,57386,12766,2022,'WANDERLANDIA',Wanderlândia,'TO',1722081,3137.0,4411,261.4,367.6,1,0.0,1274.0,Pequeno I
449,449,172210,7031,6138,585,4173,4758,1380,6971.17,6131.92,663.67,4133.75,4797.42,1334.5,83654,73583,7964,49605,57569,16014,2022,'XAMBIOA',Xambioá,'TO',1722107,515.0,515,42.9,42.9,1,16.0,16.0,Pequeno I
450,450,210005,60434,51082,14006,21629,35635,15447,57984.25,49479.83,12828.08,22111.83,34939.92,14539.92,695811,593758,153937,265342,419279,174479,2022,'ACAILANDIA',Açailândia,'MA',2100055,15526.0,15526,1293.8,1293.8,3,680.0,680.0,Grande
451,451,210010,6508,6257,181,5677,5858,399,6233.25,5998.25,222.92,5371.17,5594.08,404.17,74799,71979,2675,64454,67129,4850,2022,'AFONSO CUNHA',Afonso Cunha,'MA',2100105,316.0,316,26.3,26.3,1,38.0,38.0,Pequeno I
452,452,210015,10132,9403,440,7819,8259,1144,10116.25,9441.58,505.5,7857.92,8363.42,1078.17,121395,113299,6066,94295,100361,12938,2022,'AGUA DOCE DO MARANHAO',Água Doce do Maranhão,'MA',2100154,1055.0,1055,87.9,87.9,1,82.0,82.0,Pequeno I
453,453,210020,19128,17585,765,15799,16564,1021,18185.92,16765.5,423.83,15362.67,15786.5,979.0,218231,201186,5086,184352,189438,11748,2022,'ALCANTARA',Alcântara,'MA',2100204,897.0,897,74.8,74.8,1,28.0,28.0,Pequeno II
454,454,210030,16059,15262,1634,12031,13665,1597,15777.58,15077.75,1556.08,12068.92,13625.0,1452.75,189331,180933,18673,144827,163500,17433,2022,'ALDEIAS ALTAS',Aldeias Altas,'MA',2100303,3128.0,3128,260.7,260.7,2,176.0,176.0,Pequeno II
455,455,210040,5021,4626,165,4088,4253,373,4856.08,4503.67,152.58,3906.83,4059.42,444.25,58273,54044,1831,46882,48713,5331,2022,'ALTAMIRA DO MARANHAO',Altamira do Maranhão,'MA',2100402,1487.0,1487,123.9,123.9,1,51.0,51.0,Pequeno I
456,456,210043,17690,16155,1138,12714,13852,2303,17603.08,16153.08,1124.92,12929.25,14054.17,2098.92,211237,193837,13499,155151,168650,25187,2022,'ALTO ALEGRE DO MARANHAO',Alto Alegre do Maranhão,'MA',2100436,1734.0,1734,144.5,144.5,1,102.0,102.0,Pequeno II
457,457,210047,21775,19503,653,16766,17419,2084,21373.0,19350.25,743.58,16682.75,17426.33,1923.92,256476,232203,8923,200193,209116,23087,2022,'ALTO ALEGRE DO PINDARE',Alto Alegre do Pindaré,'MA',2100477,1154.0,1154,96.2,96.2,1,56.0,56.0,Pequeno II
458,458,210050,8064,7005,658,5074,5732,1273,7797.42,6851.75,703.67,4930.17,5633.83,1217.92,93569,82221,8444,59162,67606,14615,2022,'ALTO PARNAIBA',Alto Parnaíba,'MA',2100501,576.0,576,52.4,52.4,1,,,Pequeno I
459,459,210055,6461,6007,159,5305,5464,543,6368.25,6025.25,179.17,5327.92,5507.08,518.17,76419,72303,2150,63935,66085,6218,2022,'AMAPA DO MARANHAO',Amapá do Maranhão,'MA',2100550,512.0,512,42.7,42.7,1,70.0,70.0,Pequeno I
460,460,210060,28986,27063,3021,18812,21833,5230,28376.58,26689.33,2696.75,19152.5,21849.25,4840.08,340519,320272,32361,229830,262191,58081,2022,'AMARANTE DO MARANHAO',Amarante do Maranhão,'MA',2100600,1323.0,1323,110.2,110.2,2,84.0,84.0,Pequeno II
461,461,210070,19076,18280,247,17095,17342,938,19591.42,18850.33,210.33,17687.5,17897.83,952.5,235097,226204,2524,212250,214774,11430,2022,'ANAJATUBA',Anajatuba,'MA',2100709,2176.0,2176,181.3,181.3,1,318.0,318.0,Pequeno II
462,462,210080,14486,14110,235,13104,13339,771,14574.92,14251.33,251.92,13240.33,13492.25,759.08,174899,171016,3023,158884,161907,9109,2022,'ANAPURUS',Anapurus,'MA',2100808,4956.0,4956,413.0,413.0,1,418.0,418.0,Pequeno I
463,463,210083,16626,15360,332,14420,14752,608,16514.33,15341.58,361.92,14412.08,14774.0,567.58,198172,184099,4343,172945,177288,6811,2022,'APICUM-ACU',Apicum-açu,'MA',2100832,627.0,627,52.2,52.2,1,38.0,38.0,Pequeno I
464,464,210087,8219,7538,505,5924,6429,1109,8321.83,7680.25,487.83,6139.58,6627.42,1052.83,99862,92163,5854,73675,79529,12634,2022,'ARAGUANA',Araguanã,'MA',2100873,381.0,381,31.8,31.8,1,21.0,21.0,Pequeno I
465,465,210090,29767,28340,1023,24457,25480,2860,29381.83,28131.58,1381.67,24087.33,25469.0,2662.58,352582,337579,16580,289048,305628,31951,2022,'ARAIOSES',Araioses,'MA',2100907,1776.0,1776,148.0,148.0,2,97.0,97.0,Pequeno II
466,466,210095,22410,21445,1576,17602,19178,2267,22072.17,21214.83,1436.92,17853.33,19290.25,1924.58,264866,254578,17243,214240,231483,23095,2022,'ARAME',Arame,'MA',2100956,2998.0,2998,249.8,249.8,1,135.0,135.0,Pequeno II
467,467,210100,21090,19282,2604,12762,15366,3916,21172.08,19496.5,2190.83,13661.67,15852.5,3644.0,254065,233958,26290,163940,190230,43728,2022,'ARARI',Arari,'MA',2101004,5116.0,5116,426.3,426.3,2,363.0,363.0,Pequeno II
468,468,210110,9278,8893,224,7997,8221,672,9273.58,8929.67,291.17,7972.33,8263.5,666.17,111283,107156,3494,95668,99162,7994,2022,'AXIXA',Axixá,'MA',2101103,423.0,423,35.2,35.2,1,15.0,15.0,Pequeno I
469,469,210120,74668,68286,3018,55317,58335,9951,70343.75,64520.83,3529.92,50890.58,54420.5,10100.33,844125,774250,42359,610687,653046,121204,2022,'BACABAL',Bacabal,'MA',2101202,2045.0,2045,170.4,170.4,2,150.0,150.0,Grande
470,470,210125,12762,11955,1581,9020,10601,1354,12446.42,11708.75,1382.25,9112.5,10494.75,1214.0,149357,140505,16587,109350,125937,14568,2022,'BACABEIRA',Bacabeira,'MA',2101251,6303.0,6303,525.2,525.2,2,489.0,489.0,Pequeno I
471,471,210130,11388,10208,198,8983,9181,1027,11331.83,10245.75,241.67,8985.33,9227.0,1018.75,135982,122949,2900,107824,110724,12225,2022,'BACURI',Bacuri,'MA',2101301,214.0,214,23.8,23.8,1,30.0,30.0,Pequeno I
472,472,210135,4738,4216,124,3649,3773,443,4629.33,4160.08,129.83,3589.67,3719.5,440.58,55552,49921,1558,43076,44634,5287,2022,'BACURITUBA',Bacurituba,'MA',2101350,397.0,397,36.1,36.1,1,15.0,15.0,Pequeno I
473,473,210140,59845,52665,7389,33516,40905,11760,56839.33,50255.0,7535.33,31973.83,39509.17,10745.83,682072,603060,90424,383686,474110,128950,2022,'BALSAS',Balsas,'MA',2101400,28329.0,41552,2360.8,3462.7,2,644.0,8499.0,Médio
474,474,210150,11840,10869,321,9182,9503,1366,11425.0,10586.25,316.0,9085.67,9401.67,1184.58,137100,127035,3792,109028,112820,14215,2022,'BARAO DE GRAJAU',Barão de Grajaú,'MA',2101509,1396.0,1396,116.3,116.3,1,107.0,107.0,Pequeno I
475,475,210160,58891,54095,3866,43024,46890,7205,54963.58,50883.0,3803.33,40221.67,44025.0,6858.0,659563,610596,45640,482660,528300,82296,2022,'BARRA DO CORDA',Barra do Corda,'MA',2101608,2287.0,2287,190.6,190.6,3,65.0,65.0,Médio
476,476,210170,53071,50439,3993,40856,44849,5590,50205.25,48278.83,2594.08,41796.83,44390.92,3887.92,602463,579346,31129,501562,532691,46655,2022,'BARREIRINHAS',Barreirinhas,'MA',2101707,5097.0,5097,424.8,424.8,2,363.0,363.0,Médio
477,477,210173,9093,8807,477,7672,8149,658,9043.33,8787.25,531.5,7594.58,8126.08,661.17,108520,105447,6378,91135,97513,7934,2022,'BELAGUA',Belágua,'MA',2101731,100.0,100,8.3,8.3,1,8.0,8.0,Pequeno I
478,478,210177,9527,8823,1129,6732,7861,962,9532.08,8875.5,1006.83,6967.83,7974.67,900.83,114385,106506,12082,83614,95696,10810,2022,'BELA VISTA DO MARANHAO',Bela Vista do Maranhão,'MA',2101772,635.0,635,52.9,52.9,1,144.0,144.0,Pequeno I
479,479,210180,4082,3807,90,3431,3521,286,3970.58,3715.17,82.75,3352.83,3435.58,279.58,47647,44582,993,40234,41227,3355,2022,'BENEDITO LEITE',Benedito Leite,'MA',2101806,1611.0,1611,134.2,134.2,1,162.0,162.0,Pequeno I
480,480,210190,15014,13416,281,11562,11843,1573,14745.42,13338.83,318.25,11423.5,11741.75,1597.08,176945,160066,3819,137082,140901,19165,2022,'BEQUIMAO',Bequimão,'MA',2101905,711.0,711,64.6,64.6,1,9.0,9.0,Pequeno II
481,481,210193,4036,3666,140,2823,2963,703,3991.33,3669.83,148.33,2808.25,2956.58,713.25,47896,44038,1780,33699,35479,8559,2022,'BERNARDO DO MEARIM',Bernardo do Mearim,'MA',2101939,1084.0,4292,98.5,390.2,1,0.0,2140.0,Pequeno I
482,482,210197,6544,6207,427,5055,5482,725,6561.67,6268.0,388.58,5278.75,5667.33,600.67,78740,75216,4663,63345,68008,7208,2022,'BOA VISTA DO GURUPI',Boa Vista do Gurupi,'MA',2101970,3016.0,3016,251.3,251.3,1,127.0,127.0,Pequeno I
483,483,210200,26465,24683,1688,19453,21141,3542,25950.42,24339.5,1645.17,19419.5,21064.67,3274.83,311405,292074,19742,233034,252776,39298,2022,'BOM JARDIM',Bom Jardim,'MA',2102002,955.0,955,86.8,86.8,2,,,Pequeno II
484,484,210203,22108,20282,1607,16234,17841,2441,21794.5,20112.25,1367.33,16443.08,17810.42,2301.83,261534,241347,16408,197317,213725,27622,2022,'BOM JESUS DAS SELVAS',Bom Jesus Das Selvas,'MA',2102036,284.0,284,23.7,23.7,1,22.0,22.0,Pequeno II
485,485,210207,9972,9022,332,7559,7891,1131,9826.92,8855.92,304.5,7481.25,7785.75,1070.17,117923,106271,3654,89775,93429,12842,2022,'BOM LUGAR',Bom Lugar,'MA',2102077,706.0,706,58.8,58.8,1,50.0,50.0,Pequeno I
486,486,210210,24986,23712,707,20179,20886,2826,25249.42,24104.0,869.83,20520.08,21389.92,2714.08,302993,289248,10438,246241,256679,32569,2022,'BREJO',Brejo,'MA',2102101,1167.0,1167,97.2,97.2,2,107.0,107.0,Pequeno II
487,487,210215,8019,7468,631,6004,6635,833,8013.33,7476.92,708.0,5807.83,6515.83,961.08,96160,89723,8496,69694,78190,11533,2022,'BREJO DE AREIA',Brejo de Areia,'MA',2102150,3116.0,3116,259.7,259.7,1,188.0,188.0,Pequeno I
488,488,210220,22936,22228,843,19612,20455,1773,22412.5,21777.83,919.67,19174.67,20094.33,1683.5,268950,261334,11036,230096,241132,20202,2022,'BURITI',Buriti,'MA',2102200,498.0,498,41.5,41.5,1,17.0,17.0,Pequeno II
489,489,210230,17237,16231,393,14762,15155,1076,16652.67,15771.42,511.75,14219.25,14731.0,1040.42,199832,189257,6141,170631,176772,12485,2022,'BURITI BRAVO',Buriti Bravo,'MA',2102309,1965.0,1965,178.6,178.6,1,86.0,86.0,Pequeno II
490,490,210232,38737,34925,4896,24127,29023,5902,37347.25,33807.92,4917.33,23370.67,28288.0,5519.92,448167,405695,59008,280448,339456,66239,2022,'BURITICUPU',Buriticupu,'MA',2102325,1544.0,1544,128.7,128.7,2,35.0,35.0,Médio
491,491,210235,10876,10100,569,8374,8943,1157,10710.42,10019.17,580.75,8382.0,8962.75,1056.42,128525,120230,6969,100584,107553,12677,2022,'BURITIRANA',Buritirana,'MA',2102358,404.0,404,33.7,33.7,1,23.0,23.0,Pequeno I
492,492,210237,10639,9852,119,9264,9383,469,10322.08,9576.75,152.08,8986.83,9138.92,437.83,123865,114921,1825,107842,109667,5254,2022,'CACHOEIRA GRANDE',Cachoeira Grande,'MA',2102374,214.0,214,17.8,17.8,1,3.0,3.0,Pequeno I
493,493,210240,8155,7635,245,6215,6460,1175,8177.58,7753.0,264.08,6294.0,6558.08,1194.92,98131,93036,3169,75528,78697,14339,2022,'CAJAPIO',Cajapió,'MA',2102408,512.0,512,51.2,51.2,1,30.0,30.0,Pequeno I
494,494,210250,17830,16940,410,15396,15806,1134,17816.92,17005.42,407.58,15422.5,15830.08,1175.33,213803,204065,4891,185070,189961,14104,2022,'CAJARI',Cajari,'MA',2102507,3167.0,14336,263.9,1194.7,1,0.0,1117.0,Pequeno I
495,495,210255,8544,7664,1018,4541,5559,2105,8392.83,7643.17,967.92,4813.92,5781.83,1861.33,100714,91718,11615,57767,69382,22336,2022,'CAMPESTRE DO MARANHAO',Campestre do Maranhão,'MA',2102556,489.0,489,40.8,40.8,1,30.0,30.0,Pequeno I
496,496,210260,16800,15513,1273,12364,13637,1876,16683.17,15555.08,1175.25,12658.0,13833.25,1721.83,200198,186661,14103,151896,165999,20662,2022,'CANDIDO MENDES',Cândido Mendes,'MA',2102606,5073.0,10383,422.8,865.2,1,749.0,749.0,Pequeno I
497,497,210270,13931,13051,346,11631,11977,1074,14009.75,13204.75,376.83,11827.33,12204.17,1000.58,168117,158457,4522,141928,146450,12007,2022,'CANTANHEDE',Cantanhede,'MA',2102705,591.0,591,49.2,49.2,1,470.0,470.0,Pequeno II
498,498,210275,9036,8269,374,6833,7207,1062,9018.33,8340.92,411.58,6840.33,7251.92,1089.0,108220,100091,4939,82084,87023,13068,2022,'CAPINZAL DO NORTE',Capinzal do Norte,'MA',2102754,325.0,325,46.4,46.4,1,,,Pequeno I
499,499,210280,17283,15414,671,12214,12885,2529,16749.83,14970.33,779.42,11703.75,12483.17,2487.17,200998,179644,9353,140445,149798,29846,2022,'CAROLINA',Carolina,'MA',2102804,2080.0,2080,173.3,173.3,2,92.0,92.0,Pequeno II
500,500,210290,21500,20243,304,19041,19345,898,20955.83,19816.75,365.75,18574.67,18940.42,876.33,251470,237801,4389,222896,227285,10516,2022,'CARUTAPERA',Carutapera,'MA',2102903,2929.0,2929,244.1,244.1,1,212.0,212.0,Pequeno II
501,501,210300,97381,86709,16284,47838,64122,22587,94308.83,84478.42,13438.83,51480.42,64919.25,19559.17,1131706,1013741,161266,617765,779031,234710,2022,'CAXIAS',Caxias,'MA',2103000,15572.0,15572,1297.7,1297.7,6,459.0,459.0,Grande
502,502,210310,8014,7341,116,6672,6788,553,8008.0,7391.92,151.0,6687.75,6838.75,553.17,96096,88703,1812,80253,82065,6638,2022,'CEDRAL',Cedral,'MA',2103109,2201.0,2201,183.4,183.4,1,174.0,174.0,Pequeno I
503,503,210312,7205,6776,84,6151,6235,541,7065.67,6690.5,79.0,6237.0,6316.0,374.5,84788,80286,948,74844,75792,4494,2022,'CENTRAL DO MARANHAO',Central do Maranhão,'MA',2103125,523.0,523,47.5,47.5,1,80.0,80.0,Pequeno I
504,504,210315,9362,8836,276,8187,8463,373,9001.58,8500.42,273.83,7806.33,8080.17,420.25,108019,102005,3286,93676,96962,5043,2022,'CENTRO DO GUILHERME',Centro do Guilherme,'MA',2103158,1982.0,1982,165.2,165.2,1,169.0,169.0,Pequeno I
505,505,210317,14252,13662,463,12358,12821,841,14001.5,13457.17,458.42,12213.25,12671.67,785.5,168018,161486,5501,146559,152060,9426,2022,'CENTRO NOVO DO MARANHAO',Centro Novo do Maranhão,'MA',2103174,6566.0,6566,547.2,547.2,3,573.0,573.0,Pequeno I
506,506,210320,68948,66206,1131,61348,62479,3727,65403.42,62928.75,1420.58,57728.75,59149.33,3779.42,784841,755145,17047,692745,709792,45353,2022,'CHAPADINHA',Chapadinha,'MA',2103208,11071.0,14588,922.6,1215.7,3,528.0,528.0,Médio
507,507,210325,10577,9599,1186,7099,8285,1314,10551.08,9698.67,933.33,7739.08,8672.42,1026.25,126613,116384,11200,92869,104069,12315,2022,'CIDELANDIA',Cidelândia,'MA',2103257,2133.0,2133,213.3,213.3,2,210.0,210.0,Pequeno I
508,508,210330,74509,67107,8454,48751,57205,9902,72016.75,65125.83,8792.75,46666.83,55459.58,9666.25,864201,781510,105513,560002,665515,115995,2022,'CODO',Codó,'MA',2103307,22273.0,22273,1856.1,1856.1,5,554.0,554.0,Grande
509,509,210340,33121,31211,1367,26713,28080,3131,31568.08,29856.33,1288.92,25458.42,26747.33,3109.0,378817,358276,15467,305501,320968,37308,2022,'COELHO NETO',Coelho Neto,'MA',2103406,1287.0,1287,107.2,107.2,2,129.0,129.0,Pequeno II
510,510,210350,27652,25906,428,23254,23682,2224,26861.5,25301.0,493.33,22751.17,23244.5,2056.5,322338,303612,5920,273014,278934,24678,2022,'COLINAS',Colinas,'MA',2103505,5123.0,5123,426.9,426.9,5,267.0,267.0,Pequeno II
511,511,210355,13683,12784,492,10709,11201,1583,13931.0,13089.83,539.67,11078.08,11617.75,1472.08,167172,157078,6476,132937,139413,17665,2022,'CONCEICAO DO LAGO-ACU',Conceição do Lago-açu,'MA',2103554,86.0,86,7.2,7.2,1,5.0,5.0,Pequeno I
512,512,210360,41926,39477,2327,28639,30966,8511,41859.67,39590.25,2468.33,29233.75,31702.08,7888.17,502316,475083,29620,350805,380425,94658,2022,'COROATA',Coroatá,'MA',2103604,13560.0,16491,1130.0,1374.2,3,464.0,464.0,Médio
513,513,210370,26897,23089,487,21579,22066,1023,26305.67,22898.67,575.42,21291.0,21866.42,1032.25,315668,274784,6905,255492,262397,12387,2022,'CURURUPU',Cururupu,'MA',2103703,2449.0,2449,204.1,204.1,1,121.0,121.0,Pequeno II
514,514,210375,9673,8060,2916,2015,4931,3129,9408.25,8001.67,2672.58,2577.17,5249.75,2751.92,112899,96020,32071,30926,62997,33023,2022,'DAVINOPOLIS',Davinópolis,'MA',2103752,2309.0,2309,230.9,230.9,1,190.0,190.0,Pequeno I
515,515,210380,14986,13882,693,11871,12564,1318,14597.08,13567.5,703.08,11556.17,12259.25,1308.25,175165,162810,8437,138674,147111,15699,2022,'DOM PEDRO',Dom Pedro,'MA',2103802,760.0,760,63.3,63.3,1,74.0,74.0,Pequeno II
516,516,210390,9703,9287,263,8393,8656,631,9541.33,9157.17,354.58,8149.33,8503.92,653.25,114496,109886,4255,97792,102047,7839,2022,'DUQUE BACELAR',Duque Bacelar,'MA',2103901,2218.0,2218,184.8,184.8,1,30.0,30.0,Pequeno I
517,517,210400,14031,13251,488,12053,12541,710,13888.33,13172.42,449.92,11975.17,12425.08,747.33,166660,158069,5399,143702,149101,8968,2022,'ESPERANTINOPOLIS',Esperantinópolis,'MA',2104008,1061.0,1061,88.4,88.4,1,89.0,89.0,Pequeno I
518,518,210405,20829,18574,2710,11958,14668,3906,19952.17,17881.92,2731.17,11417.0,14148.17,3733.75,239426,214583,32774,137004,169778,44805,2022,'ESTREITO',Estreito,'MA',2104057,4538.0,4538,378.2,378.2,1,242.0,242.0,Pequeno II
519,519,210407,6911,6178,418,4740,5158,1020,6833.0,6178.92,384.5,4800.5,5185.0,993.92,81996,74147,4614,57606,62220,11927,2022,'FEIRA NOVA DO MARANHAO',Feira Nova do Maranhão,'MA',2104073,927.0,927,77.2,77.2,1,8.0,8.0,Pequeno I
520,520,210408,10298,9959,735,8015,8750,1209,10111.58,9805.75,730.08,7887.33,8617.42,1188.33,121339,117669,8761,94648,103409,14260,2022,'FERNANDO FALCAO',Fernando Falcão,'MA',2104081,190.0,190,15.8,15.8,1,4.0,4.0,Pequeno I
521,521,210409,13623,12934,778,10663,11441,1493,13432.42,12840.08,709.25,10750.25,11459.5,1380.58,161189,154081,8511,129003,137514,16567,2022,'FORMOSA DA SERRA NEGRA',Formosa da Serra Negra,'MA',2104099,963.0,963,80.2,80.2,1,65.0,65.0,Pequeno I
522,522,210410,11124,9938,336,7979,8315,1623,10983.33,9895.58,407.5,7939.0,8346.5,1549.08,131800,118747,4890,95268,100158,18589,2022,'FORTALEZA DOS NOGUEIRAS',Fortaleza Dos Nogueiras,'MA',2104107,597.0,597,49.8,49.8,1,26.0,26.0,Pequeno I
523,523,210420,12686,11748,634,9652,10286,1462,12574.92,11723.75,611.25,9772.08,10383.33,1340.42,150899,140685,7335,117265,124600,16085,2022,'FORTUNA',Fortuna,'MA',2104206,583.0,583,48.6,48.6,1,35.0,35.0,Pequeno I
524,524,210430,6959,6469,539,5306,5845,624,6804.5,6372.5,442.42,5283.08,5725.5,647.0,81654,76470,5309,63397,68706,7764,2022,'GODOFREDO VIANA',Godofredo Viana,'MA',2104305,584.0,584,48.7,48.7,1,30.0,30.0,Pequeno I
525,525,210440,12265,11425,382,10241,10623,802,12091.42,11289.58,335.08,10177.33,10512.42,777.17,145097,135475,4021,122128,126149,9326,2022,'GONCALVES DIAS',Gonçalves Dias,'MA',2104404,1277.0,1277,116.1,116.1,2,55.0,55.0,Pequeno I
526,526,210450,7083,6521,619,4970,5589,932,7010.83,6485.75,478.92,5171.17,5650.08,835.67,84130,77829,5747,62054,67801,10028,2022,'GOVERNADOR ARCHER',Governador Archer,'MA',2104503,3381.0,3381,281.8,281.8,1,190.0,190.0,Pequeno I
527,527,210455,13283,11645,2865,5653,8518,3127,12672.42,11148.5,2711.33,5805.67,8517.0,2631.5,152069,133782,32536,69668,102204,31578,2022,'GOVERNADOR EDISON LOBAO',Governador Edison Lobão,'MA',2104552,829.0,829,69.1,69.1,2,60.0,60.0,Pequeno I
528,528,210460,11011,10041,420,8332,8752,1289,10947.42,10078.5,371.17,8565.08,8936.25,1142.25,131369,120942,4454,102781,107235,13707,2022,'GOVERNADOR EUGENIO BARROS',Governador Eugênio Barros,'MA',2104602,1485.0,1485,123.8,123.8,1,117.0,117.0,Pequeno I
529,529,210462,5324,4825,184,3800,3984,841,5245.08,4785.75,185.58,3803.75,3989.33,796.42,62941,57429,2227,45645,47872,9557,2022,'GOVERNADOR LUIZ ROCHA',Governador Luiz Rocha,'MA',2104628,2202.0,2202,183.5,183.5,1,180.0,180.0,Pequeno I
530,530,210465,8014,7424,504,6067,6571,853,7991.33,7442.0,503.25,6031.08,6534.33,907.67,95896,89304,6039,72373,78412,10892,2022,'GOVERNADOR NEWTON BELLO',Governador Newton Bello,'MA',2104651,701.0,701,58.4,58.4,1,41.0,41.0,Pequeno I
531,531,210467,19306,17964,1507,14541,16048,1916,19262.67,18058.83,1155.17,15150.5,16305.67,1753.17,231152,216706,13862,181806,195668,21038,2022,'GOVERNADOR NUNES FREIRE',Governador Nunes Freire,'MA',2104677,2009.0,2009,167.4,167.4,1,61.0,61.0,Pequeno II
532,532,210470,5482,4684,445,3367,3812,872,5441.42,4677.58,395.17,3494.42,3889.58,788.0,65297,56131,4742,41933,46675,9456,2022,'GRACA ARANHA',Graça Aranha,'MA',2104701,425.0,425,35.4,35.4,1,30.0,30.0,Pequeno I
533,533,210480,53239,48900,4578,37661,42239,6661,51807.08,47850.17,3996.17,37886.75,41882.92,5967.25,621685,574202,47954,454641,502595,71607,2022,'GRAJAU',Grajaú,'MA',2104800,12749.0,12749,1062.4,1062.4,2,601.0,601.0,Médio
534,534,210490,8851,7753,232,6516,6748,1005,8975.67,7944.5,216.0,6726.75,6942.75,1001.75,107708,95334,2592,80721,83313,12021,2022,'GUIMARAES',Guimarães,'MA',2104909,1094.0,1094,109.4,109.4,1,82.0,82.0,Pequeno I
535,535,210500,24866,23879,1544,19940,21484,2395,24619.08,23705.0,1659.67,19766.33,21426.0,2279.0,295429,284460,19916,237196,257112,27348,2022,'HUMBERTO DE CAMPOS',Humberto de Campos,'MA',2105005,5380.0,5380,448.3,448.3,1,281.0,281.0,Pequeno II
536,536,210510,20840,19914,365,18602,18967,947,20238.83,19349.67,494.58,17823.67,18318.25,1031.42,242866,232196,5935,213884,219819,12377,2022,'ICATU',Icatu,'MA',2105104,1581.0,1581,131.8,131.8,1,140.0,140.0,Pequeno II
537,537,210515,11769,10926,615,9160,9775,1151,11430.58,10675.83,608.0,9023.0,9631.0,1044.83,137167,128110,7296,108276,115572,12538,2022,'IGARAPE DO MEIO',Igarapé do Meio,'MA',2105153,364.0,364,33.1,33.1,1,,,Pequeno I
538,538,210520,7963,7517,437,6216,6653,864,7789.08,7389.0,387.42,6149.75,6537.17,851.83,93469,88668,4649,73797,78446,10222,2022,'IGARAPE GRANDE',Igarapé Grande,'MA',2105203,504.0,4569,42.0,380.8,1,25.0,25.0,Pequeno I
539,539,210530,150813,129809,26197,58688,84885,44924,141781.92,122484.67,23759.92,52993.33,76753.25,45731.42,1701383,1469816,285119,635920,921039,548777,2022,'IMPERATRIZ',Imperatriz,'MA',2105302,63799.0,135451,5316.6,11287.6,6,5182.0,9023.0,Grande
540,540,210535,12013,11425,461,10006,10467,958,11743.83,11203.58,472.42,9800.42,10272.83,930.75,140926,134443,5669,117605,123274,11169,2022,'ITAIPAVA DO GRAJAU',Itaipava do Grajaú,'MA',2105351,310.0,310,31.0,31.0,1,,,Pequeno I
541,541,210540,46570,42066,5202,29412,34614,7452,45299.5,41293.08,4588.75,29955.5,34544.25,6748.83,543594,495517,55065,359466,414531,80986,2022,'ITAPECURU MIRIM',Itapecuru Mirim,'MA',2105401,11544.0,11544,962.0,962.0,2,888.0,888.0,Médio
542,542,210542,16528,14564,1197,11484,12681,1883,16152.17,14326.58,1123.75,11607.67,12731.42,1595.17,193826,171919,13485,139292,152777,19142,2022,'ITINGA DO MARANHAO',Itinga do Maranhão,'MA',2105427,934.0,934,77.8,77.8,1,63.0,63.0,Pequeno II
543,543,210545,7102,6730,192,5693,5885,845,7112.0,6798.33,182.5,5857.08,6039.58,758.75,85344,81580,2190,70285,72475,9105,2022,'JATOBA',Jatobá,'MA',2105450,329.0,329,27.4,27.4,1,20.0,20.0,Pequeno I
544,544,210547,13818,12898,762,10249,11011,1887,13508.92,12646.92,798.0,10096.25,10894.25,1752.67,162107,151763,9576,121155,130731,21032,2022,'JENIPAPO DOS VIEIRAS',Jenipapo Dos Vieiras,'MA',2105476,369.0,369,41.0,41.0,1,16.0,16.0,Pequeno I
545,545,210550,19173,16571,2182,10368,12550,4021,18730.75,16318.67,1824.42,10953.08,12777.5,3541.17,224769,195824,21893,131437,153330,42494,2022,'JOAO LISBOA',João Lisboa,'MA',2105500,4160.0,4160,346.7,346.7,2,99.0,99.0,Pequeno II
546,546,210560,12018,11169,351,9381,9732,1437,11777.25,11000.33,374.5,9275.83,9650.33,1350.0,141327,132004,4494,111310,115804,16200,2022,'JOSELANDIA',Joselândia,'MA',2105609,866.0,866,72.2,72.2,1,30.0,30.0,Pequeno I
547,547,210565,4684,4247,361,3218,3579,668,4715.83,4315.67,358.08,3333.67,3691.75,623.92,56590,51788,4297,40004,44301,7487,2022,'JUNCO DO MARANHAO',Junco do Maranhão,'MA',2105658,275.0,275,22.9,22.9,1,23.0,23.0,Pequeno I
548,548,210570,31779,29906,738,26861,27599,2307,30859.08,29148.58,830.83,26161.83,26992.67,2155.92,370309,349783,9970,313942,323912,25871,2022,'LAGO DA PEDRA',Lago da Pedra,'MA',2105708,3651.0,3651,304.2,304.2,2,80.0,80.0,Pequeno II
549,549,210580,8066,7137,455,5447,5902,1235,8139.42,7270.58,484.0,5473.67,5957.67,1312.92,97673,87247,5808,65684,71492,15755,2022,'LAGO DO JUNCO',Lago do Junco,'MA',2105807,1099.0,1099,91.6,91.6,1,98.0,98.0,Pequeno I
550,550,210590,13093,12189,421,10723,11144,1045,12988.42,12157.08,401.25,10791.83,11193.08,964.0,155861,145885,4815,129502,134317,11568,2022,'LAGO VERDE',Lago Verde,'MA',2105906,300.0,300,30.0,30.0,1,,,Pequeno I
551,551,210592,8173,7792,139,6727,6866,926,8016.33,7650.58,135.42,6578.5,6713.92,936.67,96196,91807,1625,78942,80567,11240,2022,'LAGOA DO MATO',Lagoa do Mato,'MA',2105922,1899.0,1899,158.2,158.2,1,154.0,154.0,Pequeno I
552,552,210594,7282,6309,548,4547,5095,1214,7147.92,6221.0,434.0,4655.75,5089.75,1131.25,85775,74652,5208,55869,61077,13575,2022,'LAGO DOS RODRIGUES',Lago Dos Rodrigues,'MA',2105948,1061.0,1061,88.4,88.4,1,36.0,36.0,Pequeno I
553,553,210596,10287,9606,1114,7256,8370,1236,9998.67,9377.83,999.83,7210.33,8210.17,1167.67,119984,112534,11998,86524,98522,14012,2022,'LAGOA GRANDE DO MARANHAO',Lagoa Grande do Maranhão,'MA',2105963,855.0,855,122.1,122.1,1,,,Pequeno I
554,554,210598,5821,5481,244,4772,5016,465,5595.83,5303.5,253.58,4609.0,4862.58,440.92,67150,63642,3043,55308,58351,5291,2022,'LAJEADO NOVO',Lajeado Novo,'MA',2105989,1083.0,1083,98.5,98.5,1,98.0,98.0,Pequeno I
555,555,210600,8787,7803,863,5140,6003,1800,8560.0,7683.75,718.33,5244.42,5962.75,1721.0,102720,92205,8620,62933,71553,20652,2022,'LIMA CAMPOS',Lima Campos,'MA',2106003,502.0,502,41.8,41.8,1,61.0,61.0,Pequeno I
556,556,210610,8333,7672,214,6595,6809,863,8121.42,7537.5,248.67,6518.92,6767.58,769.92,97457,90450,2984,78227,81211,9239,2022,'LORETO',Loreto,'MA',2106102,1198.0,1198,99.8,99.8,1,180.0,180.0,Pequeno I
557,557,210620,7728,6888,318,5796,6114,774,7625.83,6873.67,287.0,5891.83,6178.83,694.83,91510,82484,3444,70702,74146,8338,2022,'LUIS DOMINGUES',Luís Domingues,'MA',2106201,468.0,468,39.0,39.0,1,30.0,30.0,Pequeno I
558,558,210630,10684,9943,633,7812,8445,1498,10519.92,9864.08,596.92,7916.17,8513.08,1351.0,126239,118369,7163,94994,102157,16212,2022,'MAGALHAES DE ALMEIDA',Magalhães de Almeida,'MA',2106300,942.0,942,78.5,78.5,1,90.0,90.0,Pequeno I
559,559,210632,16358,15342,616,13402,14018,1324,15597.5,14683.17,745.33,12544.92,13290.25,1392.92,187170,176198,8944,150539,159483,16715,2022,'MARACACUME',Maracaçumé,'MA',2106326,398.0,398,33.2,33.2,1,18.0,18.0,Pequeno I
560,560,210635,6221,5989,589,4629,5218,771,6224.33,6015.58,495.33,4800.0,5295.33,720.25,74692,72187,5944,57600,63544,8643,2022,'MARAJA DO SENA',Marajá do Sena,'MA',2106359,391.0,391,32.6,32.6,1,39.0,39.0,Pequeno I
561,561,210637,8772,8043,575,6210,6785,1258,8670.83,8028.08,622.75,6203.17,6825.92,1202.17,104050,96337,7473,74438,81911,14426,2022,'MARANHAOZINHO',Maranhãozinho,'MA',2106375,2549.0,2549,212.4,212.4,1,182.0,182.0,Pequeno I
562,562,210640,17002,16508,311,15291,15602,906,16729.58,16299.92,320.58,15127.92,15448.5,851.42,200755,195599,3847,181535,185382,10217,2022,'MATA ROMA',Mata Roma,'MA',2106409,4817.0,4817,401.4,401.4,1,260.0,260.0,Pequeno I
563,563,210650,20730,19589,385,17498,17883,1706,20878.83,19838.42,400.17,17736.17,18136.33,1702.08,250546,238061,4802,212834,217636,20425,2022,'MATINHA',Matinha,'MA',2106508,4913.0,4913,409.4,409.4,1,69.0,69.0,Pequeno II
564,564,210660,24589,22910,722,19355,20077,2833,24427.08,22898.83,914.17,19233.42,20147.58,2751.25,293125,274786,10970,230801,241771,33015,2022,'MATOES',Matões,'MA',2106607,1287.0,1287,107.2,107.2,2,29.0,29.0,Pequeno II
565,565,210663,8166,7644,504,6209,6713,931,8024.83,7580.75,451.75,6259.92,6711.67,869.08,96298,90969,5421,75119,80540,10429,2022,'MATOES DO NORTE',Matões do Norte,'MA',2106631,491.0,491,40.9,40.9,1,35.0,35.0,Pequeno I
566,566,210667,6490,6099,193,5341,5534,565,6553.75,6196.92,171.75,5477.08,5648.83,548.08,78645,74363,2061,65725,67786,6577,2022,'MILAGRES DO MARANHAO',Milagres do Maranhão,'MA',2106672,1033.0,1033,86.1,86.1,1,15.0,15.0,Pequeno I
567,567,210670,17032,16025,490,14175,14665,1360,16391.33,15512.08,489.67,13718.58,14208.25,1303.83,196696,186145,5876,164623,170499,15646,2022,'MIRADOR',Mirador,'MA',2106706,1206.0,1206,100.5,100.5,1,42.0,42.0,Pequeno II
568,568,210675,14402,13059,1218,10345,11563,1496,14315.0,13211.67,1038.58,10791.08,11829.67,1382.0,171780,158540,12463,129493,141956,16584,2022,'MIRANDA DO NORTE',Miranda do Norte,'MA',2106755,13285.0,17550,1107.1,1462.5,1,0.0,4265.0,Pequeno II
569,569,210680,11754,10713,157,10030,10187,526,11604.17,10632.5,186.25,9862.08,10048.33,584.17,139250,127590,2235,118345,120580,7010,2022,'MIRINZAL',Mirinzal,'MA',2106805,691.0,691,57.6,57.6,1,20.0,20.0,Pequeno I
570,570,210690,24979,23100,745,20847,21592,1508,24071.25,22352.0,924.08,20004.42,20928.5,1423.5,288855,268224,11089,240053,251142,17082,2022,'MONCAO',Monção,'MA',2106904,1414.0,1414,117.8,117.8,1,44.0,44.0,Pequeno II
571,571,210700,8041,7049,431,5452,5883,1166,7977.42,7070.5,448.92,5423.75,5872.67,1197.83,95729,84846,5387,65085,70472,14374,2022,'MONTES ALTOS',Montes Altos,'MA',2107001,1628.0,1628,135.7,135.7,1,41.0,41.0,Pequeno I
572,572,210710,16366,15312,429,13647,14076,1236,16033.17,15106.25,476.25,13435.0,13911.25,1195.0,192398,181275,5715,161220,166935,14340,2022,'MORROS',Morros,'MA',2107100,1368.0,1368,114.0,114.0,1,96.0,96.0,Pequeno I
573,573,210720,10114,9519,413,8311,8724,795,10082.25,9539.75,413.0,8389.17,8802.17,737.58,120987,114477,4956,100670,105626,8851,2022,'NINA RODRIGUES',Nina Rodrigues,'MA',2107209,673.0,673,61.2,61.2,1,38.0,38.0,Pequeno I
574,574,210725,4431,4088,176,3031,3207,881,4423.25,4115.0,192.67,3031.92,3224.58,890.42,53079,49380,2312,36383,38695,10685,2022,'NOVA COLINAS',Nova Colinas,'MA',2107258,311.0,311,25.9,25.9,1,33.0,33.0,Pequeno I
575,576,210735,13724,12657,760,10686,11446,1211,13745.17,12744.83,618.42,11026.75,11645.17,1099.67,164942,152938,7421,132321,139742,13196,2022,'NOVA OLINDA DO MARANHAO',Nova Olinda do Maranhão,'MA',2107357,1210.0,1210,100.8,100.8,1,200.0,200.0,Pequeno I
576,577,210740,13969,12880,272,10903,11175,1705,13948.08,12955.75,286.17,11027.0,11313.17,1642.58,167377,155469,3434,132324,135758,19711,2022,'OLHO DAGUA DAS CUNHAS',Olho D´água Das Cunhãs,'MA',2107407,383.0,383,54.7,54.7,2,80.0,80.0,Pequeno I
577,578,210745,12117,11495,195,10254,10449,1046,12202.0,11659.83,223.58,10488.42,10712.0,947.83,146424,139918,2683,125861,128544,11374,2022,'OLINDA NOVA DO MARANHAO',Olinda Nova do Maranhão,'MA',2107456,3182.0,3182,265.2,265.2,1,147.0,147.0,Pequeno I
578,579,210750,72711,67396,8913,45720,54633,12763,67651.58,62989.08,7186.42,44676.25,51862.67,11126.42,811819,755869,86237,536115,622352,133517,2022,'PACO DO LUMIAR',Paço do Lumiar,'MA',2107506,9387.0,9387,782.2,782.2,2,487.0,487.0,Grande
579,580,210760,15476,14248,231,13431,13662,586,15482.08,14326.17,225.75,13577.08,13802.83,523.33,185785,171914,2709,162925,165634,6280,2022,'PALMEIRANDIA',Palmeirândia,'MA',2107605,2019.0,2019,201.9,201.9,1,228.0,228.0,Pequeno I
580,581,210770,16290,15040,221,13909,14130,910,16166.33,15021.25,248.92,13923.67,14172.58,848.67,193996,180255,2987,167084,170071,10184,2022,'PARAIBANO',Paraibano,'MA',2107704,1194.0,1194,99.5,99.5,2,101.0,101.0,Pequeno II
581,582,210780,24232,22219,1550,17296,18846,3373,24066.42,22225.25,1556.67,17529.5,19086.17,3139.08,288797,266703,18680,210354,229034,37669,2022,'PARNARAMA',Parnarama,'MA',2107803,9319.0,9319,776.6,776.6,2,359.0,359.0,Pequeno II
582,583,210790,14101,13266,758,11106,11864,1402,14032.92,13289.25,652.17,11357.83,12010.0,1279.25,168395,159471,7826,136294,144120,15351,2022,'PASSAGEM FRANCA',Passagem Franca,'MA',2107902,7960.0,9063,663.3,755.2,1,282.0,282.0,Pequeno I
583,584,210800,13702,12542,295,11151,11446,1096,13487.25,12426.58,312.67,11020.67,11333.33,1093.25,161847,149119,3752,132248,136000,13119,2022,'PASTOS BONS',Pastos Bons,'MA',2108009,3138.0,3138,261.5,261.5,2,56.0,56.0,Pequeno I
584,585,210805,15233,14599,705,12365,13070,1529,14956.83,14480.0,714.75,12482.67,13197.42,1282.58,179482,173760,8577,149792,158369,15391,2022,'PAULINO NEVES',Paulino Neves,'MA',2108058,2309.0,3437,192.4,286.4,1,432.0,432.0,Pequeno I
585,586,210810,14989,14252,1009,11943,12952,1300,14661.67,13999.25,1025.25,11675.67,12700.92,1298.33,175940,167991,12303,140108,152411,15580,2022,'PAULO RAMOS',Paulo Ramos,'MA',2108108,422.0,422,60.3,60.3,2,77.0,77.0,Pequeno II
586,587,210820,21846,19553,2653,12048,14701,4852,21231.17,19147.67,2361.33,12209.83,14571.17,4576.5,254774,229772,28336,146518,174854,54918,2022,'PEDREIRAS',Pedreiras,'MA',2108207,1795.0,1795,163.2,163.2,1,,,Pequeno II
587,588,210825,23095,21948,643,19906,20549,1399,22463.42,21384.5,860.67,19033.42,19894.08,1490.42,269561,256614,10328,228401,238729,17885,2022,'PEDRO DO ROSARIO',Pedro do Rosário,'MA',2108256,4831.0,4831,402.6,402.6,1,55.0,55.0,Pequeno II
588,589,210830,24400,23178,1540,19794,21334,1844,23533.25,22433.67,1265.42,19445.83,20711.25,1722.42,282399,269204,15185,233350,248535,20669,2022,'PENALVA',Penalva,'MA',2108306,1403.0,1403,116.9,116.9,1,97.0,97.0,Pequeno II
589,590,210840,10154,9592,121,8892,9013,579,9172.17,8700.42,152.42,7883.17,8035.58,664.83,110066,104405,1829,94598,96427,7978,2022,'PERI MIRIM',Peri Mirim,'MA',2108405,774.0,774,70.4,70.4,1,246.0,246.0,Pequeno I
590,591,210845,17369,16385,154,15693,15847,538,17495.83,16567.08,155.58,15891.25,16046.83,520.25,209950,198805,1867,190695,192562,6243,2022,'PERITORO',Peritoró,'MA',2108454,1800.0,1800,150.0,150.0,1,73.0,73.0,Pequeno II
591,592,210850,21980,19909,1372,16027,17399,2510,21059.92,19191.58,1312.25,15348.67,16660.92,2530.67,252719,230299,15747,184184,199931,30368,2022,'PINDARE-MIRIM',Pindaré-mirim,'MA',2108504,594.0,594,49.5,49.5,1,42.0,42.0,Pequeno II
592,593,210860,55732,50495,2111,42965,45076,5419,54780.25,49858.17,2258.0,42261.67,44519.67,5338.5,657363,598298,27096,507140,534236,64062,2022,'PINHEIRO',Pinheiro,'MA',2108603,22920.0,22920,1910.0,1910.0,3,1734.0,1734.0,Médio
593,594,210870,19505,17432,415,15517,15932,1500,19408.67,17471.42,400.58,15668.08,16068.67,1402.75,232904,209657,4807,188017,192824,16833,2022,'PIO XII',Pio Xii,'MA',2108702,420.0,420,35.0,35.0,1,20.0,20.0,Pequeno II
594,595,210880,13012,12263,661,9631,10292,1971,12987.58,12348.08,723.33,9752.92,10476.25,1871.83,155851,148177,8680,117035,125715,22462,2022,'PIRAPEMAS',Pirapemas,'MA',2108801,402.0,402,44.7,44.7,1,20.0,20.0,Pequeno I
595,596,210890,12962,12378,495,10961,11456,922,12321.67,11805.08,659.08,10126.08,10785.17,1019.92,147860,141661,7909,121513,129422,12239,2022,'POCAO DE PEDRAS',Poção de Pedras,'MA',2108900,2406.0,2406,200.5,200.5,2,194.0,194.0,Pequeno I
596,597,210900,15154,12841,4663,3012,7675,5166,14569.67,12470.83,4684.5,2969.42,7653.92,4816.92,174836,149650,56214,35633,91847,57803,2022,'PORTO FRANCO',Porto Franco,'MA',2109007,11595.0,11595,966.2,966.2,1,1222.0,1222.0,Pequeno II
597,598,210905,5614,5126,78,4819,4897,229,5613.75,5151.67,84.58,4831.0,4915.58,236.08,67365,61820,1015,57972,58987,2833,2022,'PORTO RICO DO MARANHAO',Porto Rico do Maranhão,'MA',2109056,813.0,813,67.8,67.8,1,165.0,165.0,Pequeno I
598,599,210910,24422,21957,2994,13989,16983,4974,23309.92,21064.0,2507.75,14161.5,16669.25,4394.75,279719,252768,30093,169938,200031,52737,2022,'PRESIDENTE DUTRA',Presidente Dutra,'MA',2109106,3040.0,3040,253.3,253.3,2,253.0,253.0,Pequeno II
599,600,210920,10345,9726,290,8724,9014,712,10419.33,9831.42,366.75,8752.92,9119.67,711.75,125032,117977,4401,105035,109436,8541,2022,'PRESIDENTE JUSCELINO',Presidente Juscelino,'MA',2109205,2022.0,3514,168.5,292.8,1,0.0,0.0,Pequeno I
600,601,210923,5198,4725,230,3807,4037,688,4957.83,4541.75,255.25,3564.75,3820.0,721.75,59494,54501,3063,42777,45840,8661,2022,'PRESIDENTE MEDICI',Presidente Médici,'MA',2109239,2331.0,2331,194.2,194.2,1,53.0,53.0,Pequeno I
601,602,210927,16159,15230,2092,10527,12619,2611,16229.83,15356.83,1839.75,11183.67,13023.42,2333.42,194758,184282,22077,134204,156281,28001,2022,'PRESIDENTE SARNEY',Presidente Sarney,'MA',2109270,3183.0,3183,265.2,265.2,1,248.0,248.0,Pequeno I
602,603,210930,8974,8211,354,6900,7254,957,8684.67,8006.0,421.58,6530.42,6952.0,1054.0,104216,96072,5059,78365,83424,12648,2022,'PRESIDENTE VARGAS',Presidente Vargas,'MA',2109304,1258.0,1258,104.8,104.8,1,32.0,32.0,Pequeno I
603,604,210940,11014,10497,1521,7798,9319,1178,11229.75,10787.33,1141.0,8753.25,9894.25,893.08,134757,129448,13692,105039,118731,10717,2022,'PRIMEIRA CRUZ',Primeira Cruz,'MA',2109403,5322.0,6549,443.5,545.8,1,703.0,703.0,Pequeno I
604,606,210950,15765,13693,1321,9934,11255,2438,15331.33,13443.92,1255.0,9981.58,11236.58,2207.33,183976,161327,15060,119779,134839,26488,2022,'RIACHAO',Riachão,'MA',2109502,1254.0,1254,104.5,104.5,1,43.0,43.0,Pequeno II
605,607,210955,4917,4425,784,2669,3453,972,4885.5,4461.83,897.5,2630.83,3528.33,933.5,58626,53542,10770,31570,42340,11202,2022,'RIBAMAR FIQUENE',Ribamar Fiquene,'MA',2109551,1014.0,1014,84.5,84.5,2,45.0,45.0,Pequeno I
606,608,210960,29006,26537,8537,11712,20249,6288,28465.67,26281.5,6601.67,14336.75,20938.42,5343.08,341588,315378,79220,172041,251261,64117,2022,'ROSARIO',Rosário,'MA',2109601,2403.0,2403,200.2,200.2,2,162.0,162.0,Pequeno II
607,609,210970,4719,4145,276,3335,3611,534,4539.5,4007.83,287.25,3175.92,3463.17,544.67,54474,48094,3447,38111,41558,6536,2022,'SAMBAIBA',Sambaíba,'MA',2109700,1370.0,1370,124.5,124.5,1,,,Pequeno I
608,610,210975,5565,5254,566,3809,4375,879,5586.42,5289.25,497.67,3982.58,4480.25,809.0,67037,63471,5972,47791,53763,9708,2022,'SANTA FILOMENA DO MARANHAO,Santa Filomena do Maranhão,'MA',2109759,730.0,730,60.8,60.8,1,66.0,66.0,Pequeno I
609,611,210980,24589,23109,293,21870,22163,946,23913.67,22486.42,251.17,21303.67,21554.83,931.58,286964,269837,3014,255644,258658,11179,2022,'SANTA HELENA',Santa Helena,'MA',2109809,1240.0,1240,103.3,103.3,2,108.0,108.0,Pequeno II
610,612,210990,51606,45627,4061,33489,37550,8077,49649.5,44071.92,3543.33,33206.58,36749.92,7322.0,595794,528863,42520,398479,440999,87864,2022,'SANTA INES',Santa Inês,'MA',2109908,2723.0,2723,226.9,226.9,1,112.0,112.0,Médio
611,613,211000,43949,40095,6801,27836,34637,5458,43290.92,39734.17,4646.75,30076.08,34722.83,5011.33,519491,476810,55761,360913,416674,60136,2022,'SANTA LUZIA',Santa Luzia,'MA',2110005,1275.0,1275,106.2,106.2,3,115.0,115.0,Médio
612,614,211003,17538,16114,423,14294,14717,1397,17366.17,16052.0,466.42,14248.92,14715.33,1336.67,208394,192624,5597,170987,176584,16040,2022,'SANTA LUZIA DO PARUA',Santa Luzia do Paruá,'MA',2110039,3672.0,3672,306.0,306.0,2,223.0,223.0,Pequeno II
613,615,211010,23460,22454,363,20684,21047,1407,22959.67,22018.5,427.33,20175.67,20603.0,1415.5,275516,264222,5128,242108,247236,16986,2022,'SANTA QUITERIA DO MARANHAO,Santa Quitéria do Maranhão,'MA',2110104,570.0,570,47.5,47.5,1,20.0,20.0,Pequeno II
614,616,211020,25504,24053,630,21697,22327,1726,24775.92,23402.25,741.25,20887.42,21628.67,1773.58,297311,280827,8895,250649,259544,21283,2022,'SANTA RITA',Santa Rita,'MA',2110203,7750.0,7750,645.8,645.8,2,90.0,90.0,Pequeno II
615,617,211023,6996,6720,410,5446,5856,864,6852.5,6614.67,366.25,5505.42,5871.67,743.0,82230,79376,4395,66065,70460,8916,2022,'SANTANA DO MARANHAO',Santana do Maranhão,'MA',2110237,1106.0,1106,92.2,92.2,1,58.0,58.0,Pequeno I
616,618,211027,11187,10800,329,9848,10177,623,10622.08,10308.25,418.08,9297.67,9715.75,592.5,127465,123699,5017,111572,116589,7110,2022,'SANTO AMARO DO MARANHAO',Santo Amaro do Maranhão,'MA',2110278,2027.0,2027,168.9,168.9,1,141.0,141.0,Pequeno I
617,619,211030,11273,10608,968,8022,8990,1618,11056.92,10450.33,863.25,8075.5,8938.75,1511.58,132683,125404,10359,96906,107265,18139,2022,'SANTO ANTONIO DOS LOPES',Santo Antônio Dos Lopes,'MA',2110302,646.0,646,129.2,129.2,1,,,Pequeno I
618,620,211040,16580,15817,623,13948,14571,1246,16665.5,15962.08,628.58,14148.25,14776.83,1185.25,199986,191545,7543,169779,177322,14223,2022,'SAO BENEDITO DO RIO PRETO',São Benedito do Rio Preto,'MA',2110401,2569.0,2569,214.1,214.1,1,74.0,74.0,Pequeno I
619,621,211050,24508,23029,384,20910,21294,1735,24235.58,22923.67,429.5,20817.42,21246.92,1676.75,290827,275084,5154,249809,254963,20121,2022,'SAO BENTO',São Bento,'MA',2110500,3287.0,3287,273.9,273.9,3,91.0,91.0,Pequeno II
620,622,211060,22225,21083,614,18712,19326,1757,21723.92,20710.33,664.92,18303.42,18968.33,1742.0,260687,248524,7979,219641,227620,20904,2022,'SAO BERNARDO',São Bernardo,'MA',2110609,543.0,543,45.2,45.2,1,57.0,57.0,Pequeno II
621,623,211065,6680,6068,247,5290,5537,531,6519.5,5962.75,234.33,5208.75,5443.08,519.67,78234,71553,2812,62505,65317,6236,2022,'SAO DOMINGOS DO AZEITAO',São Domingos do Azeitão,'MA',2110658,2033.0,2033,203.3,203.3,1,63.0,63.0,Pequeno I
622,624,211070,26796,24560,1089,20723,21812,2748,25969.58,23957.42,1157.5,20223.58,21381.08,2576.33,311635,287489,13890,242683,256573,30916,2022,'SAO DOMINGOS DO MARANHAO',São Domingos do Maranhão,'MA',2110708,7219.0,7219,601.6,601.6,3,387.0,387.0,Pequeno II
623,625,211080,3781,3267,164,2332,2496,771,3737.67,3268.67,179.83,2394.92,2574.75,693.92,44852,39224,2158,28739,30897,8327,2022,'SAO FELIX DE BALSAS',São Félix de Balsas,'MA',2110807,1336.0,1336,133.6,133.6,1,,,Pequeno I
624,626,211085,6400,5832,386,4787,5173,659,6211.5,5686.42,342.92,4776.67,5119.58,566.83,74538,68237,4115,57320,61435,6802,2022,'SAO FRANCISCO DO BREJAO',São Francisco do Brejão,'MA',2110856,705.0,705,58.8,58.8,2,32.0,32.0,Pequeno I
625,627,211090,9003,8565,125,7872,7997,568,8954.67,8554.25,140.58,7879.25,8019.83,534.42,107456,102651,1687,94551,96238,6413,2022,'SAO FRANCISCO DO MARANHAO',São Francisco do Maranhão,'MA',2110906,1390.0,1390,115.8,115.8,1,200.0,200.0,Pequeno I
626,628,211100,18004,17182,107,16152,16259,923,17707.42,17026.42,119.58,16048.17,16167.75,858.67,212489,204317,1435,192578,194013,10304,2022,'SAO JOAO BATISTA',São João Batista,'MA',2111003,276.0,276,30.7,30.7,1,34.0,34.0,Pequeno I
627,629,211102,11090,10529,1081,8311,9392,1137,10987.58,10477.67,957.5,8432.75,9390.25,1087.42,131851,125732,11490,101193,112683,13049,2022,'SAO JOAO DO CARU',São João do Carú,'MA',2111029,1001.0,1001,83.4,83.4,1,13.0,13.0,Pequeno I
628,630,211105,7752,6977,376,5270,5646,1331,7619.17,6884.5,411.83,5158.75,5570.58,1313.92,91430,82614,4942,61905,66847,15767,2022,'SAO JOAO DO PARAISO',São João do Paraíso,'MA',2111052,67.0,67,7.4,7.4,1,,,Pequeno I
629,631,211107,15610,14326,568,11954,12522,1804,15567.92,14383.75,611.67,11939.67,12551.33,1832.42,186815,172605,7340,143276,150616,21989,2022,'SAO JOAO DO SOTER',São João do Soter,'MA',2111078,2092.0,2092,174.3,174.3,1,131.0,131.0,Pequeno I
630,632,211110,17751,15441,757,12316,13073,2368,17230.58,15095.25,800.0,11875.33,12675.33,2419.92,206767,181143,9600,142504,152104,29039,2022,'SAO JOAO DOS PATOS',São João Dos Patos,'MA',2111102,679.0,679,56.6,56.6,1,70.0,70.0,Pequeno II
631,633,211120,129459,116750,17932,77102,95034,21716,121559.5,110285.33,16241.5,74213.25,90454.75,19830.58,1458714,1323424,194898,890559,1085457,237967,2022,'SAO JOSE DE RIBAMAR',São José de Ribamar,'MA',2111201,31845.0,31845,2653.8,2653.8,5,2762.0,2762.0,Grande
632,634,211125,6124,5585,152,4732,4884,701,6187.42,5661.25,195.17,4788.92,4984.08,677.17,74249,67935,2342,57467,59809,8126,2022,'SAO JOSE DOS BASILIOS',São José Dos Basílios,'MA',2111250,873.0,873,79.4,79.4,1,81.0,81.0,Pequeno I
633,635,211130,487062,444936,54081,298542,352623,92313,467623.17,429732.5,54258.0,278858.67,333116.67,96615.83,5611478,5156790,651096,3346304,3997400,1159390,2022,'SAO LUIS',São Luís,'MA',2111300,300974.0,300974,25081.2,25081.2,20,11802.0,11802.0,Metrópole
634,636,211140,14734,13736,531,11675,12206,1530,14831.5,13915.5,603.5,11831.25,12434.75,1480.75,177978,166986,7242,141975,149217,17769,2022,'SAO LUIS GONZAGA DO MARANH,São Luís Gonzaga do Maranhão,'MA',2111409,1011.0,1011,84.2,84.2,1,130.0,130.0,Pequeno II
635,637,211150,27005,24656,1138,20450,21588,3068,26365.33,24200.08,1006.0,20375.17,21381.17,2818.92,316384,290401,12072,244502,256574,33827,2022,'SAO MATEUS DO MARANHAO',São Mateus do Maranhão,'MA',2111508,835.0,835,69.6,69.6,1,63.0,63.0,Pequeno II
636,638,211153,8452,7103,1154,4611,5765,1338,8047.83,6944.17,1061.25,4629.33,5690.58,1253.58,96574,83330,12735,55552,68287,15043,2022,'SAO PEDRO DA AGUA BRANCA',São Pedro da Água Branca,'MA',2111532,3444.0,3444,287.0,287.0,1,69.0,69.0,Pequeno I
637,639,211157,4097,3661,249,2635,2884,777,3944.67,3547.92,251.5,2542.25,2793.75,754.17,47336,42575,3018,30507,33525,9050,2022,'SAO PEDRO DOS CRENTES',São Pedro Dos Crentes,'MA',2111573,446.0,446,37.2,37.2,1,35.0,35.0,Pequeno I
638,640,211160,13955,12342,458,9736,10194,2148,13279.92,11781.33,502.08,9189.42,9691.5,2089.83,159359,141376,6025,110273,116298,25078,2022,'SAO RAIMUNDO DAS MANGABEIR,São Raimundo Das Mangabeiras,'MA',2111607,2259.0,14134,188.2,1177.8,1,493.0,493.0,Pequeno I
639,641,211163,5050,4791,203,4129,4332,459,5115.5,4876.75,190.83,4277.92,4468.75,408.0,61386,58521,2290,51335,53625,4896,2022,'SAO RAIMUNDO DO DOCA BEZER,São Raimundo do Doca Bezerra,'MA',2111631,113.0,113,10.3,10.3,1,10.0,10.0,Pequeno I
640,642,211167,5188,4979,108,4585,4693,286,5091.25,4900.17,101.67,4528.67,4630.33,269.83,61095,58802,1220,54344,55564,3238,2022,'SAO ROBERTO',São Roberto,'MA',2111672,1169.0,1169,97.4,97.4,1,59.0,59.0,Pequeno I
641,643,211170,17020,16217,169,15262,15431,786,16630.33,15945.33,145.42,15073.5,15218.92,726.42,199564,191344,1745,180882,182627,8717,2022,'SAO VICENTE FERRER',São Vicente Ferrer,'MA',2111706,1306.0,1306,108.8,108.8,1,33.0,33.0,Pequeno II
642,644,211172,7551,6784,277,5271,5548,1236,7440.17,6790.25,323.83,5289.42,5613.25,1177.0,89282,81483,3886,63473,67359,14124,2022,'SATUBINHA',Satubinha,'MA',2111722,1010.0,1010,84.2,84.2,1,31.0,31.0,Pequeno I
643,645,211174,8482,8106,159,7602,7761,345,8363.17,8015.83,167.17,7520.33,7687.5,328.33,100358,96190,2006,90244,92250,3940,2022,'SENADOR ALEXANDRE COSTA',Senador Alexandre Costa,'MA',2111748,1218.0,4268,121.8,426.8,1,42.0,42.0,Pequeno I
644,646,211176,12723,11129,955,8586,9541,1588,12512.08,10999.75,876.92,8621.5,9498.42,1501.33,150145,131997,10523,103458,113981,18016,2022,'SENADOR LA ROCQUE',Senador la Rocque,'MA',2111763,939.0,5967,78.2,497.2,1,0.0,5028.0,Pequeno I
645,647,211178,12064,11141,123,10642,10765,376,11779.67,10918.0,106.5,10471.58,10578.08,339.92,141356,131016,1278,125659,126937,4079,2022,'SERRANO DO MARANHAO',Serrano do Maranhão,'MA',2111789,1738.0,1738,144.8,144.8,1,46.0,46.0,Pequeno I
646,648,211180,14299,13665,681,11135,11816,1849,14090.67,13534.92,692.58,11211.83,11904.42,1630.5,169088,162419,8311,134542,142853,19566,2022,'SITIO NOVO',Sítio Novo,'MA',2111805,58.0,58,9.7,9.7,1,,,Pequeno I
647,649,211190,9507,8638,168,7742,7910,728,9371.75,8564.92,177.25,7691.67,7868.92,696.0,112461,102779,2127,92300,94427,8352,2022,'SUCUPIRA DO NORTE',Sucupira do Norte,'MA',2111904,1376.0,1376,114.7,114.7,1,117.0,117.0,Pequeno I
648,650,211195,4377,4012,152,3495,3647,365,4235.08,3892.5,165.17,3377.33,3542.5,350.0,50821,46710,1982,40528,42510,4200,2022,'SUCUPIRA DO RIACHAO',Sucupira do Riachão,'MA',2111953,3998.0,3998,399.8,399.8,1,415.0,415.0,Pequeno I
649,651,211200,6707,5821,628,3965,4593,1228,6565.17,5780.58,602.5,4027.0,4629.5,1151.08,78782,69367,7230,48324,55554,13813,2022,'TASSO FRAGOSO',Tasso Fragoso,'MA',2112001,2221.0,2221,185.1,185.1,1,88.0,88.0,Pequeno I
650,652,211210,20004,18891,1509,15142,16651,2240,19542.17,18555.08,1356.08,15165.67,16521.75,2033.33,234506,222661,16273,181988,198261,24400,2022,'TIMBIRAS',Timbiras,'MA',2112100,1939.0,1939,161.6,161.6,1,225.0,225.0,Pequeno II
651,653,211220,110447,99974,8843,75625,84468,15506,104589.58,95041.0,8110.08,72584.42,80694.5,14346.5,1255075,1140492,97321,871013,968334,172158,2022,'TIMON',Timon,'MA',2112209,30084.0,30084,2507.0,2507.0,5,1188.0,1188.0,Grande
652,654,211223,15155,13493,1769,8717,10486,3007,14753.0,13298.5,1591.33,8990.25,10581.58,2716.92,177036,159582,19096,107883,126979,32603,2022,'TRIZIDELA DO VALE',Trizidela do Vale,'MA',2112233,4063.0,10845,338.6,903.8,1,231.0,231.0,Pequeno I
653,655,211227,5587,5182,217,4293,4510,672,5672.08,5310.25,297.67,4312.08,4609.75,700.5,68065,63723,3572,51745,55317,8406,2022,'TUFILANDIA',Tufilândia,'MA',2112274,687.0,687,68.7,68.7,1,56.0,56.0,Pequeno I
654,656,211230,24715,22653,673,19676,20349,2304,23978.83,22013.25,752.33,18870.25,19622.58,2390.67,287746,264159,9028,226443,235471,28688,2022,'TUNTUM',Tuntum,'MA',2112308,1474.0,1474,122.8,122.8,2,169.0,169.0,Pequeno II
655,657,211240,27714,26851,568,25185,25753,1098,25893.75,25159.92,793.17,23068.33,23861.5,1298.42,310725,301919,9518,276820,286338,15581,2022,'TURIACU',Turiaçu,'MA',2112407,5688.0,7725,474.0,643.8,2,160.0,160.0,Pequeno II
656,658,211245,22882,21701,408,20655,21063,638,21075.5,19954.08,340.5,18954.75,19295.25,658.83,252906,239449,4086,227457,231543,7906,2022,'TURILANDIA',Turilândia,'MA',2112456,2875.0,6934,239.6,577.8,1,0.0,4059.0,Pequeno II
657,659,211250,46493,43809,3728,34003,37731,6078,44951.0,42622.17,3481.08,33633.0,37114.08,5508.08,539412,511466,41773,403596,445369,66097,2022,'TUTOIA',Tutóia,'MA',2112506,8993.0,8993,749.4,749.4,3,324.0,324.0,Médio
658,660,211260,26901,25269,701,22867,23568,1701,26551.33,25138.92,824.0,22642.08,23466.08,1672.83,318616,301667,9888,271705,281593,20074,2022,'URBANO SANTOS',Urbano Santos,'MA',2112605,1928.0,1928,214.2,214.2,1,123.0,123.0,Pequeno II
659,661,211270,33392,31076,1513,25537,27050,4026,33138.92,30944.17,1624.58,25470.33,27094.92,3849.25,397667,371330,19495,305644,325139,46191,2022,'VARGEM GRANDE',Vargem Grande,'MA',2112704,2984.0,2984,248.7,248.7,2,164.0,164.0,Pequeno II
660,662,211280,39898,37456,843,34333,35176,2280,37715.92,35639.42,1171.33,32171.42,33342.75,2296.67,452591,427673,14056,386057,400113,27560,2022,'VIANA',Viana,'MA',2112803,692.0,692,57.7,57.7,1,62.0,62.0,Pequeno II
661,663,211285,6554,6206,556,4661,5217,989,6435.0,6120.5,491.67,4731.33,5223.0,897.5,77220,73446,5900,56776,62676,10770,2022,'VILA NOVA DOS MARTIRIOS',Vila Nova Dos Martírios,'MA',2112852,388.0,388,32.3,32.3,1,32.0,32.0,Pequeno I
662,664,211290,22713,21437,1031,17441,18472,2965,22518.25,21372.33,981.08,17725.92,18707.0,2665.33,270219,256468,11773,212711,224484,31984,2022,'VITORIA DO MEARIM',Vitória do Mearim,'MA',2112902,1015.0,1015,84.6,84.6,1,36.0,36.0,Pequeno II
663,665,211300,22579,20685,1442,15454,16896,3789,22545.58,20812.42,1393.33,15866.83,17260.17,3552.25,270547,249749,16720,190402,207122,42627,2022,'VITORINO FREIRE',Vitorino Freire,'MA',2113009,3913.0,3913,326.1,326.1,2,321.0,321.0,Pequeno II
664,666,211400,34550,30869,3896,21235,25131,5738,34049.25,30700.08,3655.92,21513.42,25169.33,5530.75,408591,368401,43871,258161,302032,66369,2022,'ZE DOCA',zé Doca,'MA',2114007,4779.0,116738,398.2,9728.2,2,0.0,14748.0,Médio
665,667,220005,5238,4910,129,3996,4125,785,5103.25,4810.0,105.08,3978.75,4083.83,726.17,61239,57720,1261,47745,49006,8714,2022,'ACAUA',Acauã,'PI',2200053,2111.0,2111,175.9,175.9,1,87.0,87.0,Pequeno I
666,668,220010,4463,3880,153,2988,3141,739,4376.83,3843.58,134.5,2946.5,3081.0,762.58,52522,46123,1614,35358,36972,9151,2022,'AGRICOLANDIA',Agricolândia,'PI',2200103,1705.0,1705,142.1,142.1,1,70.0,70.0,Pequeno I
667,669,220020,11570,10622,540,9014,9554,1068,11128.67,10255.33,428.08,8686.67,9114.75,1140.58,133544,123064,5137,104240,109377,13687,2022,'AGUA BRANCA',Água Branca,'PI',2200202,1602.0,1602,145.6,145.6,1,138.0,138.0,Pequeno I
668,670,220025,5405,4810,113,3901,4014,796,5290.25,4755.08,112.08,3847.25,3959.33,795.75,63483,57061,1345,46167,47512,9549,2022,'ALAGOINHA DO PIAUI',Alagoinha do Piauí,'PI',2200251,2278.0,2278,189.8,189.8,1,134.0,134.0,Pequeno I
669,671,220027,3521,3196,90,2719,2809,387,3449.58,3153.17,94.25,2701.67,2795.92,357.25,41395,37838,1131,32420,33551,4287,2022,'ALEGRETE DO PIAUI',Alegrete do Piauí,'PI',2200277,426.0,426,42.6,42.6,1,60.0,60.0,Pequeno I
670,672,220030,9644,9154,254,7969,8223,931,9252.42,8874.33,276.42,7689.58,7966.0,908.33,111029,106492,3317,92275,95592,10900,2022,'ALTO LONGA',Alto Longá,'PI',2200301,447.0,447,44.7,44.7,1,45.0,45.0,Pequeno I
671,673,220040,25822,23380,4090,13779,17869,5511,24433.58,22294.92,3912.58,13184.83,17097.42,5197.5,293203,267539,46951,158218,205169,62370,2022,'ALTOS',Altos,'PI',2200400,3930.0,3930,327.5,327.5,2,65.0,65.0,Pequeno II
672,674,220045,4812,4305,103,3602,3705,600,4769.08,4293.67,129.25,3589.67,3718.92,574.75,57229,51524,1551,43076,44627,6897,2022,'ALVORADA DO GURGUEIA',Alvorada do Gurguéia,'PI',2200459,2233.0,2233,186.1,186.1,1,96.0,96.0,Pequeno I
673,675,220050,14038,12964,218,11990,12208,756,13456.17,12451.75,247.0,11449.92,11696.92,754.83,161474,149421,2964,137399,140363,9058,2022,'AMARANTE',Amarante,'PI',2200509,1725.0,1725,156.8,156.8,1,78.0,78.0,Pequeno I
674,676,220060,5902,5345,92,5022,5114,231,5652.83,5149.42,56.83,4875.0,4931.83,217.58,67834,61793,682,58500,59182,2611,2022,'ANGICAL DO PIAUI',Angical do Piauí,'PI',2200608,2708.0,2708,270.8,270.8,1,91.0,91.0,Pequeno I
675,677,220070,6533,5822,153,4781,4934,888,6402.25,5763.33,156.5,4789.92,4946.42,816.92,76827,69160,1878,57479,59357,9803,2022,'ANISIO DE ABREU',Anísio de Abreu,'PI',2200707,5753.0,5753,479.4,479.4,1,475.0,475.0,Pequeno I
676,678,220080,2243,2072,77,1687,1764,308,2212.0,2050.83,70.67,1722.17,1792.83,258.0,26544,24610,848,20666,21514,3096,2022,'ANTONIO ALMEIDA',Antônio Almeida,'PI',2200806,4005.0,4005,333.8,333.8,1,229.0,229.0,Pequeno I
677,679,220090,4328,3758,103,3143,3246,512,4369.25,3831.67,110.83,3185.58,3296.42,535.25,52431,45980,1330,38227,39557,6423,2022,'AROAZES',Aroazes,'PI',2200905,6352.0,6352,529.3,529.3,1,521.0,521.0,Pequeno I
678,680,220095,2087,2024,30,1882,1912,112,1976.33,1921.5,50.67,1761.0,1811.67,109.83,23716,23058,608,21132,21740,1318,2022,'AROEIRAS DO ITAIM',Aroeiras do Itaim,'PI',2200954,1009.0,1009,84.1,84.1,1,87.0,87.0,Pequeno I
679,681,220100,4022,3477,134,2699,2833,644,3997.33,3505.83,122.42,2757.0,2879.42,626.42,47968,42070,1469,33084,34553,7517,2022,'ARRAIAL',Arraial,'PI',2201002,2557.0,2557,213.1,213.1,1,67.0,67.0,Pequeno I
680,682,220105,6562,5975,501,4366,4867,1108,6542.75,6020.42,440.25,4489.5,4929.75,1090.67,78513,72245,5283,53874,59157,13088,2022,'ASSUNCAO DO PIAUI',Assunção do Piauí,'PI',2201051,2683.0,2683,223.6,223.6,1,132.0,132.0,Pequeno I
681,683,220110,9927,9012,173,7895,8068,944,9906.67,9114.58,177.25,8030.08,8207.33,907.25,118880,109375,2127,96361,98488,10887,2022,'AVELINO LOPES',Avelino Lopes,'PI',2201101,4234.0,4234,352.8,352.8,1,432.0,432.0,Pequeno I
682,684,220115,8605,8213,458,7047,7505,708,8278.17,7951.58,343.08,7010.42,7353.5,598.08,99338,95419,4117,84125,88242,7177,2022,'BAIXA GRANDE DO RIBEIRO',Baixa Grande do Ribeiro,'PI',2201150,2571.0,2571,214.2,214.2,1,51.0,51.0,Pequeno I
683,685,220117,3486,2989,58,2411,2469,520,3479.17,3019.25,41.58,2452.33,2493.92,525.33,41750,36231,499,29428,29927,6304,2022,'BARRA DALCANTARA',Barra D´alcântara,'PI',2201176,1431.0,1431,119.2,119.2,1,173.0,173.0,Pequeno I
684,686,220120,39405,37368,287,35134,35421,1947,37760.92,36024.67,311.67,33796.58,34108.25,1916.42,453131,432296,3740,405559,409299,22997,2022,'BARRAS',Barras,'PI',2201200,9355.0,9355,779.6,779.6,3,296.0,296.0,Pequeno II
685,687,220130,3126,2815,116,2424,2540,275,3144.5,2857.75,90.75,2498.33,2589.08,268.67,37734,34293,1089,29980,31069,3224,2022,'BARREIRAS DO PIAUI',Barreiras do Piauí,'PI',2201309,1185.0,1185,98.8,98.8,1,95.0,95.0,Pequeno I
686,688,220140,5043,4556,158,4107,4265,291,4823.17,4386.42,140.25,3962.17,4102.42,284.0,57878,52637,1683,47546,49229,3408,2022,'BARRO DURO',Barro Duro,'PI',2201408,2240.0,2240,186.7,186.7,1,120.0,120.0,Pequeno I
687,689,220150,19486,18167,544,14852,15396,2771,19432.5,18271.42,574.5,15129.42,15703.92,2567.5,233190,219257,6894,181553,188447,30810,2022,'BATALHA',Batalha,'PI',2201507,629.0,629,52.4,52.4,1,22.0,22.0,Pequeno II
688,690,220155,3609,3086,85,2126,2211,875,3565.58,3086.33,82.25,2159.25,2241.5,844.83,42787,37036,987,25911,26898,10138,2022,'BELA VISTA DO PIAUI',Bela Vista do Piauí,'PI',2201556,1235.0,1235,102.9,102.9,1,107.0,107.0,Pequeno I
689,691,220157,2770,2457,74,1938,2012,445,2701.92,2414.83,75.25,1911.17,1986.42,428.42,32423,28978,903,22934,23837,5141,2022,'BELEM DO PIAUI',Belém do Piauí,'PI',2201572,1184.0,1184,98.7,98.7,1,46.0,46.0,Pequeno I
690,692,220160,8193,7314,201,5773,5974,1340,8116.83,7298.25,194.0,5762.0,5956.0,1342.25,97402,87579,2328,69144,71472,16107,2022,'BENEDITINOS',Beneditinos,'PI',2201606,7450.0,8514,620.8,709.5,1,809.0,809.0,Pequeno I
691,693,220170,4437,3983,122,3361,3483,500,4385.17,3977.5,107.67,3421.08,3528.75,448.75,52622,47730,1292,41053,42345,5385,2022,'BERTOLINIA',Bertolínia,'PI',2201705,1945.0,1945,162.1,162.1,1,189.0,189.0,Pequeno I
692,694,220173,6287,5404,175,4153,4328,1076,6239.0,5395.5,190.83,4144.67,4335.5,1060.0,74868,64746,2290,49736,52026,12720,2022,'BETANIA DO PIAUI',Betânia do Piauí,'PI',2201739,1499.0,3977,124.9,331.4,1,32.0,32.0,Pequeno I
693,695,220177,6112,5955,28,5838,5866,89,5970.08,5831.67,25.5,5740.0,5765.5,66.17,71641,69980,306,68880,69186,794,2022,'BOA HORA',Boa Hora,'PI',2201770,1011.0,1011,84.2,84.2,1,46.0,46.0,Pequeno I
694,696,220180,2875,2449,17,1928,1945,504,2828.17,2448.08,26.42,1880.5,1906.92,541.17,33938,29377,317,22566,22883,6494,2022,'BOCAINA',Bocaina,'PI',2201804,1174.0,1174,97.8,97.8,1,97.0,97.0,Pequeno I
695,697,220190,19997,18086,1169,14256,15425,2661,19196.25,17498.5,1031.5,14029.25,15060.75,2437.75,230355,209982,12378,168351,180729,29253,2022,'BOM JESUS',Bom Jesus,'PI',2201903,1823.0,1823,151.9,151.9,1,91.0,91.0,Pequeno II
696,698,220191,5129,4817,429,3395,3824,993,4987.42,4704.0,360.33,3334.75,3695.08,1008.92,59849,56448,4324,40017,44341,12107,2022,'BOM PRINCIPIO DO PIAUI',Bom Princípio do Piauí,'PI',2201919,1578.0,1578,131.5,131.5,1,60.0,60.0,Pequeno I
697,699,220192,5690,4544,130,3607,3737,807,5643.75,4550.92,127.08,3619.75,3746.83,804.08,67725,54611,1525,43437,44962,9649,2022,'BONFIM DO PIAUI',Bonfim do Piauí,'PI',2201929,1277.0,1277,127.7,127.7,1,187.0,187.0,Pequeno I
698,700,220194,5291,4843,164,3866,4030,813,5178.83,4786.0,184.25,3855.25,4039.5,746.5,62146,57432,2211,46263,48474,8958,2022,'BOQUEIRAO DO PIAUI',Boqueirão do Piauí,'PI',2201945,450.0,450,37.5,37.5,1,21.0,21.0,Pequeno I
699,702,220198,3526,3225,36,2951,2987,238,3529.75,3249.25,26.75,3003.92,3030.67,218.58,42357,38991,321,36047,36368,2623,2022,'BREJO DO PIAUI',Brejo do Piauí,'PI',2201988,1654.0,1654,137.8,137.8,1,190.0,190.0,Pequeno I
700,703,220200,15659,14589,544,12072,12616,1973,15503.92,14529.58,413.08,12358.17,12771.25,1758.33,186047,174355,4957,148298,153255,21100,2022,'BURITI DOS LOPES',Buriti Dos Lopes,'PI',2202000,2976.0,2976,248.0,248.0,1,55.0,55.0,Pequeno I
701,704,220202,6244,5604,122,4695,4817,787,6206.0,5617.67,143.42,4719.25,4862.67,755.0,74472,67412,1721,56631,58352,9060,2022,'BURITI DOS MONTES',Buriti Dos Montes,'PI',2202026,2355.0,2355,196.2,196.2,1,37.0,37.0,Pequeno I
702,705,220205,7546,6938,247,5730,5977,961,7449.08,6881.83,241.0,5700.92,5941.92,939.92,89389,82582,2892,68411,71303,11279,2022,'CABECEIRAS DO PIAUI',Cabeceiras do Piauí,'PI',2202059,4634.0,4634,386.2,386.2,1,219.0,219.0,Pequeno I
703,706,220207,2409,2175,195,1421,1616,559,2400.5,2168.42,197.0,1433.42,1630.42,538.0,28806,26021,2364,17201,19565,6456,2022,'CAJAZEIRAS DO PIAUI',Cajazeiras do Piauí,'PI',2202075,627.0,627,52.2,52.2,1,29.0,29.0,Pequeno I
704,707,220208,5869,5116,903,2614,3517,1599,5640.92,4961.0,699.92,2855.83,3555.75,1405.25,67691,59532,8399,34270,42669,16863,2022,'CAJUEIRO DA PRAIA',Cajueiro da Praia,'PI',2202083,986.0,986,82.2,82.2,2,68.0,68.0,Pequeno I
705,708,220209,4889,4303,110,3206,3316,987,4740.75,4269.75,106.0,3407.67,3513.67,756.08,56889,51237,1272,40892,42164,9073,2022,'CALDEIRAO GRANDE DO PIAUI',Caldeirão Grande do Piauí,'PI',2202091,3025.0,3025,252.1,252.1,1,584.0,584.0,Pequeno I
706,709,220210,4631,4192,59,3583,3642,550,4536.83,4139.5,66.33,3546.75,3613.08,526.42,54442,49674,796,42561,43357,6317,2022,'CAMPINAS DO PIAUI',Campinas do Piauí,'PI',2202109,495.0,495,41.2,41.2,1,48.0,48.0,Pequeno I
707,710,220211,4212,3977,61,3428,3489,488,4204.75,3991.58,71.92,3474.67,3546.58,445.0,50457,47899,863,41696,42559,5340,2022,'CAMPO ALEGRE DO FIDALGO',Campo Alegre do Fidalgo,'PI',2202117,1847.0,1847,153.9,153.9,1,140.0,140.0,Pequeno I
708,711,220213,5001,4428,101,3418,3519,909,4983.67,4456.08,104.58,3460.25,3564.83,891.25,59804,53473,1255,41523,42778,10695,2022,'CAMPO GRANDE DO PIAUI',Campo Grande do Piauí,'PI',2202133,3282.0,3282,273.5,273.5,1,131.0,131.0,Pequeno I
709,712,220217,6781,6520,241,5962,6203,317,6750.67,6532.83,191.08,6042.92,6234.0,298.83,81008,78394,2293,72515,74808,3586,2022,'CAMPO LARGO DO PIAUI',Campo Largo do Piauí,'PI',2202174,3153.0,3153,262.8,262.8,1,212.0,212.0,Pequeno I
710,713,220220,32517,29347,1048,24157,25205,4142,30670.08,27761.33,1349.58,21857.42,23207.0,4554.33,368041,333136,16195,262289,278484,54652,2022,'CAMPO MAIOR',Campo Maior,'PI',2202208,3417.0,3417,284.8,284.8,3,288.0,288.0,Pequeno II
711,714,220225,2694,2410,12,2244,2256,154,2679.33,2407.92,16.42,2235.17,2251.58,156.33,32152,28895,197,26822,27019,1876,2022,'CANAVIEIRA',Canavieira,'PI',2202251,933.0,933,77.8,77.8,1,326.0,326.0,Pequeno I
712,715,220230,15320,13987,893,11691,12584,1403,14947.33,13684.08,416.08,11932.25,12348.33,1335.75,179368,164209,4993,143187,148180,16029,2022,'CANTO DO BURITI',Canto do Buriti,'PI',2202307,9680.0,11778,806.7,981.5,1,389.0,389.0,Pequeno II
713,716,220240,9592,8348,385,6562,6947,1401,9379.92,8385.5,378.83,6703.92,7082.75,1302.75,112559,100626,4546,80447,84993,15633,2022,'CAPITAO DE CAMPOS',Capitão de Campos,'PI',2202406,1832.0,1832,152.7,152.7,1,40.0,40.0,Pequeno I
714,717,220245,4330,3671,37,3360,3397,274,4257.33,3637.5,46.0,3324.75,3370.75,266.75,51088,43650,552,39897,40449,3201,2022,'CAPITAO GERVASIO OLIVEIRA',Capitão Gervásio Oliveira,'PI',2202455,2315.0,2315,192.9,192.9,1,63.0,63.0,Pequeno I
715,718,220250,8764,8180,100,7582,7682,498,8634.67,8103.17,97.83,7519.5,7617.33,485.83,103616,97238,1174,90234,91408,5830,2022,'CARACOL',Caracol,'PI',2202505,2205.0,2205,183.8,183.8,1,202.0,202.0,Pequeno I
716,719,220253,4759,4274,98,3563,3661,613,4630.75,4188.0,117.83,3509.0,3626.83,561.17,55569,50256,1414,42108,43522,6734,2022,'CARAUBAS DO PIAUI',Caraúbas do Piauí,'PI',2202539,2254.0,4655,225.4,465.5,1,,,Pequeno I
717,720,220255,4864,4338,141,3574,3715,623,4782.5,4313.92,143.33,3594.25,3737.58,576.33,57390,51767,1720,43131,44851,6916,2022,'CARIDADE DO PIAUI',Caridade do Piauí,'PI',2202554,3388.0,3388,282.3,282.3,1,141.0,141.0,Pequeno I
718,721,220260,15000,13585,670,10831,11501,2084,14624.08,13340.33,664.67,10627.75,11292.42,2047.92,175489,160084,7976,127533,135509,24575,2022,'CASTELO DO PIAUI',Castelo do Piauí,'PI',2202604,5419.0,5419,451.6,451.6,2,247.0,247.0,Pequeno I
719,722,220265,4735,4505,275,3689,3964,541,4597.25,4402.0,285.83,3603.58,3889.42,512.58,55167,52824,3430,43243,46673,6151,2022,'CAXINGO',Caxingó,'PI',2202653,1340.0,1340,268.0,268.0,1,189.0,189.0,Pequeno I
720,723,220270,20918,19995,847,16262,17109,2886,20332.58,19563.42,946.67,15885.5,16832.17,2731.25,243991,234761,11360,190626,201986,32775,2022,'COCAL',Cocal,'PI',2202703,5127.0,5127,427.2,427.2,1,307.0,307.0,Pequeno II
721,724,220271,3994,3685,121,3138,3259,426,3961.0,3667.25,107.08,3140.58,3247.67,419.58,47532,44007,1285,37687,38972,5035,2022,'COCAL DE TELHA',Cocal de Telha,'PI',2202711,595.0,595,49.6,49.6,1,44.0,44.0,Pequeno I
722,725,220272,5286,4781,180,3472,3652,1129,5254.0,4805.42,192.92,3480.5,3673.42,1132.0,63048,57665,2315,41766,44081,13584,2022,'COCAL DOS ALVES',Cocal Dos Alves,'PI',2202729,2053.0,2053,171.1,171.1,1,20.0,20.0,Pequeno I
723,726,220273,3866,3405,213,2529,2742,663,3791.33,3368.83,194.5,2526.5,2721.0,647.83,45496,40426,2334,30318,32652,7774,2022,'COIVARAS',Coivaras,'PI',2202737,1133.0,1133,94.4,94.4,1,65.0,65.0,Pequeno I
724,727,220275,5969,5109,101,4587,4688,421,5792.58,5039.42,70.67,4540.25,4610.92,428.5,69511,60473,848,54483,55331,5142,2022,'COLONIA DO GURGUEIA',Colônia do Gurguéia,'PI',2202752,2012.0,2012,167.7,167.7,1,159.0,159.0,Pequeno I
725,728,220277,5900,5263,180,4323,4503,760,5805.42,5238.08,159.58,4306.17,4465.75,772.33,69665,62857,1915,51674,53589,9268,2022,'COLONIA DO PIAUI',Colônia do Piauí,'PI',2202778,2040.0,2040,170.0,170.0,1,143.0,143.0,Pequeno I
726,729,220280,4332,3870,52,3456,3508,362,4192.67,3766.42,61.0,3304.17,3365.17,401.25,50312,45197,732,39650,40382,4815,2022,'CONCEICAO DO CANINDE',Conceição do Canindé,'PI',2202802,2767.0,2767,230.6,230.6,1,93.0,93.0,Pequeno I
727,730,220285,4016,3691,47,3468,3515,176,3854.92,3554.92,45.75,3322.08,3367.83,187.08,46259,42659,549,39865,40414,2245,2022,'CORONEL JOSE DIAS',Coronel José Dias,'PI',2202851,2773.0,2773,231.1,231.1,1,235.0,235.0,Pequeno I
728,731,220290,20447,18099,1497,13122,14619,3480,20008.83,17809.58,1314.75,13212.75,14527.5,3282.08,240106,213715,15777,158553,174330,39385,2022,'CORRENTE',Corrente,'PI',2202901,2204.0,2204,183.7,183.7,2,170.0,170.0,Pequeno II
729,732,220300,6043,5365,173,4310,4483,882,5966.67,5346.83,175.5,4342.17,4517.67,829.17,71600,64162,2106,52106,54212,9950,2022,'CRISTALANDIA DO PIAUI',Cristalândia do Piauí,'PI',2203008,1141.0,1141,95.1,95.1,1,95.0,95.0,Pequeno I
730,733,220310,8934,7978,169,6900,7069,909,8747.92,7855.0,182.5,6762.25,6944.75,910.25,104975,94260,2190,81147,83337,10923,2022,'CRISTINO CASTRO',Cristino Castro,'PI',2203107,2656.0,2656,221.3,221.3,1,197.0,197.0,Pequeno I
731,734,220320,9327,7779,301,5884,6185,1594,9237.5,7843.08,349.5,5950.17,6299.67,1543.42,110850,94117,4194,71402,75596,18521,2022,'CURIMATA',Curimatá,'PI',2203206,8304.0,8304,692.0,692.0,1,287.0,287.0,Pequeno I
732,735,220323,5033,4277,166,3471,3637,640,4954.0,4260.33,194.17,3412.33,3606.5,653.83,59448,51124,2330,40948,43278,7846,2022,'CURRAIS',Currais,'PI',2203230,2369.0,2369,296.1,296.1,1,187.0,187.0,Pequeno I
733,736,220325,3910,3478,137,2722,2859,619,3853.92,3475.33,141.58,2750.83,2892.42,582.92,46247,41704,1699,33010,34709,6995,2022,'CURRALINHOS',Curralinhos,'PI',2203255,2356.0,2356,196.3,196.3,1,127.0,127.0,Pequeno I
734,737,220327,4808,4382,211,3562,3773,609,4657.25,4296.0,202.42,3470.33,3672.75,623.25,55887,51552,2429,41644,44073,7479,2022,'CURRAL NOVO DO PIAUI',Curral Novo do Piauí,'PI',2203271,1550.0,1550,129.2,129.2,1,56.0,56.0,Pequeno I
735,738,220330,12581,11522,259,10356,10615,907,11929.17,10976.08,163.42,10004.25,10167.67,808.42,143150,131713,1961,120051,122012,9701,2022,'DEMERVAL LOBAO',Demerval Lobão,'PI',2203305,2832.0,2832,283.2,283.2,2,214.0,214.0,Pequeno I
736,739,220335,5487,5207,234,4445,4679,528,5369.42,5111.33,177.67,4471.0,4648.67,462.67,64433,61336,2132,53652,55784,5552,2022,'DIRCEU ARCOVERDE',Dirceu Arcoverde,'PI',2203354,0.0,14025,0.0,1168.8,1,0.0,1336.0,Pequeno I
737,740,220340,5212,4328,294,2610,2904,1424,5185.0,4353.92,223.67,2728.25,2951.92,1402.0,62220,52247,2684,32739,35423,16824,2022,'DOM EXPEDITO LOPES',Dom Expedito Lopes,'PI',2203404,546.0,546,49.6,49.6,1,38.0,38.0,Pequeno I
738,741,220342,3712,3483,222,2711,2933,550,3633.17,3426.5,190.58,2694.42,2885.0,541.5,43598,41118,2287,32333,34620,6498,2022,'DOMINGOS MOURAO',Domingos Mourão,'PI',2203420,2049.0,2049,170.8,170.8,1,63.0,63.0,Pequeno I
739,742,220345,7372,6164,57,5417,5474,690,7266.5,6120.17,71.83,5368.92,5440.75,679.42,87198,73442,862,64427,65289,8153,2022,'DOM INOCENCIO',Dom Inocêncio,'PI',2203453,334.0,334,27.8,27.8,1,26.0,26.0,Pequeno I
740,743,220350,9053,7883,521,5497,6018,1865,8931.75,7830.25,469.92,5546.83,6016.75,1813.5,107181,93963,5639,66562,72201,21762,2022,'ELESBAO VELOSO',Elesbão Veloso,'PI',2203503,3850.0,3850,320.8,320.8,1,227.0,227.0,Pequeno I
741,744,220360,3538,2954,48,2327,2375,579,3441.33,2920.83,61.58,2299.33,2360.92,559.92,41296,35050,739,27592,28331,6719,2022,'ELISEU MARTINS',Eliseu Martins,'PI',2203602,757.0,757,63.1,63.1,1,54.0,54.0,Pequeno I
742,745,220370,26859,25175,1082,21021,22103,3072,26083.42,24610.25,962.67,20693.0,21655.67,2954.58,313001,295323,11552,248316,259868,35455,2022,'ESPERANTINA',Esperantina,'PI',2203701,11342.0,11342,945.2,945.2,1,823.0,823.0,Pequeno II
743,746,220375,4792,4501,24,4355,4379,122,4739.5,4467.0,12.42,4313.17,4325.58,141.42,56874,53604,149,51758,51907,1697,2022,'FARTURA DO PIAUI',Fartura do Piauí,'PI',2203750,295.0,295,42.1,42.1,1,51.0,51.0,Pequeno I
744,747,220380,3760,3219,48,2811,2859,360,3703.08,3232.75,42.67,2836.5,2879.17,353.58,44437,38793,512,34038,34550,4243,2022,'FLORES DO PIAUI',Flores do Piauí,'PI',2203800,1728.0,1728,144.0,144.0,1,61.0,61.0,Pequeno I
745,748,220385,2225,1877,10,1649,1659,218,2182.67,1862.5,12.58,1626.25,1638.83,223.67,26192,22350,151,19515,19666,2684,2022,'FLORESTA DO PIAUI',Floresta do Piauí,'PI',2203859,1261.0,1261,126.1,126.1,1,122.0,122.0,Pequeno I
746,749,220390,32822,28405,4690,15590,20280,8125,30509.25,26523.17,4739.75,13811.67,18551.42,7971.75,366111,318278,56877,165740,222617,95661,2022,'FLORIANO',Floriano,'PI',2203909,18243.0,18243,1520.2,1520.2,2,472.0,472.0,Médio
747,750,220400,3842,3184,58,2348,2406,778,3777.08,3155.0,64.75,2324.5,2389.25,765.75,45325,37860,777,27894,28671,9189,2022,'FRANCINOPOLIS',Francinópolis,'PI',2204006,2694.0,2694,224.5,224.5,1,468.0,468.0,Pequeno I
748,751,220410,3499,2990,103,2417,2520,470,3429.17,3004.08,100.75,2437.58,2538.33,465.75,41150,36049,1209,29251,30460,5589,2022,'FRANCISCO AYRES',Francisco Ayres,'PI',2204105,1343.0,1343,122.1,122.1,1,132.0,132.0,Pequeno I
749,752,220415,2327,1965,45,1494,1539,426,2280.25,1981.58,46.83,1539.92,1586.75,394.83,27363,23779,562,18479,19041,4738,2022,'FRANCISCO MACEDO',Francisco Macedo,'PI',2204154,867.0,867,72.2,72.2,1,20.0,20.0,Pequeno I
750,753,220420,5764,4889,258,3436,3694,1195,5756.0,4927.83,247.17,3553.5,3800.67,1127.17,69072,59134,2966,42642,45608,13526,2022,'FRANCISCO SANTOS',Francisco Santos,'PI',2204204,1992.0,1992,166.0,166.0,1,339.0,339.0,Pequeno I
751,754,220430,7435,6920,98,6165,6263,657,7238.5,6787.08,135.75,6005.25,6141.0,646.08,86862,81445,1629,72063,73692,7753,2022,'FRONTEIRAS',Fronteiras,'PI',2204303,1303.0,1303,130.3,130.3,1,,,Pequeno I
752,755,220435,5248,4741,88,3925,4013,728,5050.25,4593.58,102.58,3832.92,3935.5,658.08,60603,55123,1231,45995,47226,7897,2022,'GEMINIANO',Geminiano,'PI',2204352,2934.0,2934,244.5,244.5,1,140.0,140.0,Pequeno I
753,756,220440,8883,8029,254,6868,7122,907,8543.33,7790.08,280.33,6641.17,6921.5,868.58,102520,93481,3364,79694,83058,10423,2022,'GILBUES',Gilbués,'PI',2204402,2481.0,2481,206.8,206.8,1,198.0,198.0,Pequeno I
754,757,220450,7323,6617,193,5740,5933,684,7083.25,6430.33,179.25,5620.83,5800.08,630.25,84999,77164,2151,67450,69601,7563,2022,'GUADALUPE',Guadalupe,'PI',2204501,414.0,414,34.5,34.5,1,35.0,35.0,Pequeno I
755,758,220455,4168,4047,62,3695,3757,290,4080.83,3989.67,57.75,3644.0,3701.75,287.92,48970,47876,693,43728,44421,3455,2022,'GUARIBAS',Guaribas,'PI',2204550,3496.0,3496,291.3,291.3,1,199.0,199.0,Pequeno I
756,759,220460,2790,2623,66,2261,2327,296,2689.67,2563.08,69.83,2201.17,2271.0,292.08,32276,30757,838,26414,27252,3505,2022,'HUGO NAPOLEAO',Hugo Napoleão,'PI',2204600,1164.0,1164,97.0,97.0,1,85.0,85.0,Pequeno I
757,760,220465,7831,7295,517,5739,6256,1039,7612.67,7113.08,480.08,5618.67,6098.75,1014.33,91352,85357,5761,67424,73185,12172,2022,'ILHA GRANDE',Ilha Grande,'PI',2204659,708.0,708,64.4,64.4,1,95.0,95.0,Pequeno I
758,761,220470,11047,10171,434,7741,8175,1996,10677.0,9896.42,400.42,7670.58,8071.0,1825.42,128124,118757,4805,92047,96852,21905,2022,'INHUMA',Inhuma,'PI',2204709,3552.0,3552,296.0,296.0,1,169.0,169.0,Pequeno I
759,762,220480,7445,6434,444,4325,4769,1665,7419.08,6473.67,433.5,4410.58,4844.08,1629.58,89029,77684,5202,52927,58129,19555,2022,'IPIRANGA DO PIAUI',Ipiranga do Piauí,'PI',2204808,2584.0,2584,215.3,215.3,1,215.0,215.0,Pequeno I
760,763,220490,6435,5882,129,5036,5165,717,6412.08,5907.08,125.33,5074.67,5200.0,707.08,76945,70885,1504,60896,62400,8485,2022,'ISAIAS COELHO',Isaías Coelho,'PI',2204907,2207.0,2207,183.9,183.9,2,76.0,76.0,Pequeno I
761,764,220500,8526,7498,242,5722,5964,1534,8265.83,7371.5,238.67,5606.5,5845.17,1526.33,99190,88458,2864,67278,70142,18316,2022,'ITAINOPOLIS',Itainópolis,'PI',2205003,6439.0,6439,536.6,536.6,1,259.0,259.0,Pequeno I
762,765,220510,7631,6547,264,5182,5446,1101,7574.75,6557.67,262.42,5261.0,5523.42,1034.25,90897,78692,3149,63132,66281,12411,2022,'ITAUEIRA',Itaueira,'PI',2205102,1826.0,1826,152.2,152.2,1,172.0,172.0,Pequeno I
763,766,220515,4409,4138,92,3528,3620,518,4303.92,4077.42,85.08,3496.5,3581.58,495.83,51647,48929,1021,41958,42979,5950,2022,'JACOBINA DO PIAUI',Jacobina do Piauí,'PI',2205151,1776.0,1776,148.0,148.0,1,39.0,39.0,Pequeno I
764,767,220520,13810,12914,223,11060,11283,1631,13679.08,12844.08,268.42,10941.67,11210.08,1634.0,164149,154129,3221,131300,134521,19608,2022,'JAICOS',Jaicós,'PI',2205201,7943.0,10135,661.9,844.6,1,745.0,745.0,Pequeno I
765,768,220525,3623,3271,83,2908,2991,280,3612.58,3301.42,44.25,3016.0,3060.25,241.17,43351,39617,531,36192,36723,2894,2022,'JARDIM DO MULATO',Jardim do Mulato,'PI',2205250,1256.0,1256,104.7,104.7,1,35.0,35.0,Pequeno I
766,769,220527,4205,3686,132,3264,3396,290,4014.83,3621.08,98.0,3221.08,3319.08,302.0,48178,43453,1176,38653,39829,3624,2022,'JATOBA DO PIAUI',Jatobá do Piauí,'PI',2205276,2246.0,2246,187.2,187.2,1,172.0,172.0,Pequeno I
767,770,220530,4037,3600,350,2820,3170,430,3959.5,3587.58,312.5,2901.0,3213.5,374.08,47514,43051,3750,34812,38562,4489,2022,'JERUMENHA',Jerumenha,'PI',2205300,1205.0,1205,109.5,109.5,1,75.0,75.0,Pequeno I
768,771,220535,2442,2315,92,1809,1901,414,2388.33,2280.17,110.67,1794.08,1904.75,375.42,28660,27362,1328,21529,22857,4505,2022,'JOAO COSTA',João Costa,'PI',2205359,1780.0,1780,148.3,148.3,1,125.0,125.0,Pequeno I
769,772,220540,10699,10023,630,7969,8599,1424,10620.58,10063.92,593.92,8176.25,8770.17,1293.75,127447,120767,7127,98115,105242,15525,2022,'JOAQUIM PIRES',Joaquim Pires,'PI',2205409,1494.0,1494,124.5,124.5,1,197.0,197.0,Pequeno I
770,773,220545,4604,4340,309,3567,3876,464,4522.58,4291.58,266.0,3551.67,3817.67,473.92,54271,51499,3192,42620,45812,5687,2022,'JOCA MARQUES',Joca Marques,'PI',2205458,2048.0,2048,170.7,170.7,1,83.0,83.0,Pequeno I
771,774,220550,29440,26959,1731,19142,20873,6086,28621.33,26511.25,1624.17,19500.5,21124.67,5386.58,343456,318135,19490,234006,253496,64639,2022,'JOSE DE FREITAS',José de Freitas,'PI',2205508,3147.0,3147,286.1,286.1,2,188.0,188.0,Pequeno II
772,775,220551,4144,3708,83,3053,3136,572,4118.08,3769.83,91.83,3093.42,3185.25,584.58,49417,45238,1102,37121,38223,7015,2022,'JUAZEIRO DO PIAUI',Juazeiro do Piauí,'PI',2205516,2605.0,2605,217.1,217.1,1,137.0,137.0,Pequeno I
773,776,220552,5034,4384,123,3384,3507,877,4995.92,4369.5,123.75,3393.83,3517.58,851.92,59951,52434,1485,40726,42211,10223,2022,'JULIO BORGES',Júlio Borges,'PI',2205524,1598.0,1598,177.6,177.6,1,,,Pequeno I
774,777,220553,4984,4456,49,4007,4056,400,4846.92,4365.83,57.83,3905.67,3963.5,402.33,58163,52390,694,46868,47562,4828,2022,'JUREMA',Jurema,'PI',2205532,2918.0,2918,265.3,265.3,1,108.0,108.0,Pequeno I
775,778,220554,2558,2162,153,1502,1655,507,2500.83,2117.83,155.25,1473.25,1628.5,489.33,30010,25414,1863,17679,19542,5872,2022,'LAGOINHA DO PIAUI',Lagoinha do Piauí,'PI',2205540,785.0,785,78.5,78.5,1,115.0,115.0,Pequeno I
776,779,220555,8433,7793,85,6983,7068,725,7897.08,7360.75,116.0,6516.42,6632.42,728.33,94765,88329,1392,78197,79589,8740,2022,'LAGOA ALEGRE',Lagoa Alegre,'PI',2205557,1357.0,1357,135.7,135.7,1,98.0,98.0,Pequeno I
777,780,220556,3922,3486,182,2374,2556,930,3780.33,3438.75,176.33,2435.25,2611.58,827.17,45364,41265,2116,29223,31339,9926,2022,'LAGOA DO BARRO DO PIAUI',Lagoa do Barro do Piauí,'PI',2205565,3993.0,3993,332.8,332.8,1,288.0,288.0,Pequeno I
778,781,220557,5458,4696,370,3287,3657,1039,5392.42,4685.67,373.58,3239.92,3613.5,1072.17,64709,56228,4483,38879,43362,12866,2022,'LAGOA DE SAO FRANCISCO',Lagoa de São Francisco,'PI',2205573,3226.0,3226,268.8,268.8,1,199.0,199.0,Pequeno I
779,782,220558,3997,3510,93,2908,3001,509,3909.67,3441.92,94.08,2842.92,2937.0,504.92,46916,41303,1129,34115,35244,6059,2022,'LAGOA DO PIAUI',Lagoa do Piauí,'PI',2205581,1640.0,1640,136.7,136.7,1,41.0,41.0,Pequeno I
780,783,220559,4721,4184,86,3456,3542,642,4653.33,4163.67,89.08,3421.92,3511.0,652.67,55840,49964,1069,41063,42132,7832,2022,'LAGOA DO SITIO',Lagoa do Sítio,'PI',2205599,1096.0,1096,91.3,91.3,1,89.0,89.0,Pequeno I
781,784,220560,4416,3968,35,3688,3723,245,4217.42,3782.75,51.25,3485.08,3536.33,246.42,50609,45393,615,41821,42436,2957,2022,'LANDRI SALES',Landri Sales,'PI',2205607,3788.0,3788,315.7,315.7,1,156.0,156.0,Pequeno I
782,785,220570,24898,23365,1653,18158,19811,3554,23932.58,22626.08,1429.0,18040.83,19469.83,3156.25,287191,271513,17148,216490,233638,37875,2022,'LUIS CORREIA',Luís Correia,'PI',2205706,2280.0,2280,190.0,190.0,2,118.0,118.0,Pequeno II
783,786,220580,19413,18189,279,16074,16353,1836,19254.75,18122.58,304.67,16126.5,16431.17,1691.42,231057,217471,3656,193518,197174,20297,2022,'LUZILANDIA',Luzilândia,'PI',2205805,7182.0,7182,598.5,598.5,1,99.0,99.0,Pequeno II
784,787,220585,6866,6018,155,4831,4986,1032,6740.67,5988.08,162.33,4870.58,5032.92,955.17,80888,71857,1948,58447,60395,11462,2022,'MADEIRO',Madeiro,'PI',2205854,3685.0,3685,335.0,335.0,1,280.0,280.0,Pequeno I
785,788,220590,4187,3716,207,2967,3174,542,4004.83,3579.42,222.0,2764.33,2986.33,593.08,48058,42953,2664,33172,35836,7117,2022,'MANOEL EMIDIO',Manoel Emídio,'PI',2205904,1541.0,1541,128.4,128.4,1,154.0,154.0,Pequeno I
786,789,220595,7840,7331,271,6131,6402,929,7589.25,7173.0,217.0,6155.33,6372.33,800.67,91071,86076,2604,73864,76468,9608,2022,'MARCOLANDIA',Marcolândia,'PI',2205953,2136.0,2136,178.0,178.0,1,122.0,122.0,Pequeno I
787,790,220600,3758,3421,35,3194,3229,192,3598.25,3302.67,44.33,3039.25,3083.58,219.08,43179,39632,532,36471,37003,2629,2022,'MARCOS PARENTE',Marcos Parente,'PI',2206001,1154.0,1154,96.2,96.2,1,303.0,303.0,Pequeno I
788,791,220605,4638,4139,122,3183,3305,834,4673.25,4243.83,123.92,3303.75,3427.67,816.17,56079,50926,1487,39645,41132,9794,2022,'MASSAPE DO PIAUI',Massapê do Piauí,'PI',2206050,1407.0,1407,127.9,127.9,1,66.0,66.0,Pequeno I
789,792,220610,8406,8062,90,7542,7632,430,8231.08,7921.67,102.83,7389.83,7492.67,429.0,98773,95060,1234,88678,89912,5148,2022,'MATIAS OLIMPIO',Matias Olímpio,'PI',2206100,1602.0,1602,133.5,133.5,2,156.0,156.0,Pequeno I
790,793,220620,25861,24551,641,22094,22735,1816,25258.92,24139.67,687.42,21802.33,22489.75,1649.92,303107,289676,8249,261628,269877,19799,2022,'MIGUEL ALVES',Miguel Alves,'PI',2206209,982.0,982,89.3,89.3,2,90.0,90.0,Pequeno II
791,794,220630,1124,951,90,550,640,311,1131.67,971.17,83.33,591.67,675.0,296.17,13580,11654,1000,7100,8100,3554,2022,'MIGUEL LEAO',Miguel Leão,'PI',2206308,1963.0,1963,163.6,163.6,1,226.0,226.0,Pequeno I
792,795,220635,5595,5086,196,3973,4169,917,5593.25,5131.67,212.0,4003.75,4215.75,915.92,67119,61580,2544,48045,50589,10991,2022,'MILTON BRANDAO',Milton Brandão,'PI',2206357,2216.0,2216,184.7,184.7,1,156.0,156.0,Pequeno I
793,796,220640,7038,6370,297,5047,5344,1026,6945.5,6366.67,295.08,5102.25,5397.33,969.33,83346,76400,3541,61227,64768,11632,2022,'MONSENHOR GIL',Monsenhor Gil,'PI',2206407,4472.0,4472,372.7,372.7,1,115.0,115.0,Pequeno I
794,797,220650,6520,5869,164,4883,5047,822,6305.33,5744.5,216.92,4620.83,4837.75,906.75,75664,68934,2603,55450,58053,10881,2022,'MONSENHOR HIPOLITO',Monsenhor Hipólito,'PI',2206506,5454.0,5454,454.5,454.5,1,525.0,525.0,Pequeno I
795,798,220660,8597,7720,351,6173,6524,1196,8427.67,7645.33,354.25,6162.0,6516.25,1129.08,101132,91744,4251,73944,78195,13549,2022,'MONTE ALEGRE DO PIAUI',Monte Alegre do Piauí,'PI',2206605,3241.0,3241,270.1,270.1,1,154.0,154.0,Pequeno I
796,799,220665,4087,3713,141,3104,3245,468,3959.42,3610.58,153.25,2975.5,3128.75,481.83,47513,43327,1839,35706,37545,5782,2022,'MORRO CABECA NO TEMPO',Morro Cabeça no Tempo,'PI',2206654,2818.0,2818,234.8,234.8,1,142.0,142.0,Pequeno I
797,800,220667,5065,4746,266,3780,4046,700,5101.42,4791.08,261.67,3839.08,4100.75,690.33,61217,57493,3140,46069,49209,8284,2022,'MORRO DO CHAPEU DO PIAUI',Morro do Chapéu do Piauí,'PI',2206670,4314.0,11811,359.5,984.2,1,704.0,704.0,Pequeno I
798,801,220669,5104,4950,151,4319,4470,480,5047.58,4915.42,168.83,4304.0,4472.83,442.58,60571,58985,2026,51648,53674,5311,2022,'MURICI DOS PORTELAS',Murici Dos Portelas,'PI',2206696,313.0,313,31.3,31.3,1,42.0,42.0,Pequeno I
799,802,220670,5968,5197,87,4524,4611,586,5872.92,5144.92,96.67,4465.42,4562.08,582.83,70475,61739,1160,53585,54745,6994,2022,'NAZARE DO PIAUI',Nazaré do Piauí,'PI',2206704,2505.0,2505,208.8,208.8,1,217.0,217.0,Pequeno I
800,803,220672,8961,8084,344,6981,7325,759,8612.75,7792.33,324.75,6785.58,7110.33,682.0,103353,93508,3897,81427,85324,8184,2022,'NAZARIA',Nazária,'PI',2206720,2952.0,2952,246.0,246.0,1,260.0,260.0,Pequeno I
801,804,220675,3804,3498,261,2564,2825,673,3738.75,3453.92,194.17,2624.67,2818.83,635.08,44865,41447,2330,31496,33826,7621,2022,'NOSSA SENHORA DE NAZARE',Nossa Senhora de Nazaré,'PI',2206753,821.0,821,164.2,164.2,1,155.0,155.0,Pequeno I
802,805,220680,7826,7579,337,6752,7089,490,7755.58,7545.92,318.08,6836.33,7154.42,391.5,93067,90551,3817,82036,85853,4698,2022,'NOSSA SENHORA DOS REMEDIOS,Nossa Senhora Dos Remédios,'PI',2206803,1202.0,1202,109.3,109.3,1,115.0,115.0,Pequeno I
803,806,220690,4405,3987,298,2928,3226,761,4350.42,3980.5,291.42,2974.08,3265.5,715.0,52205,47766,3497,35689,39186,8580,2022,'NOVO ORIENTE DO PIAUI',Novo Oriente do Piauí,'PI',2206902,1250.0,1250,113.6,113.6,1,78.0,78.0,Pequeno I
804,807,220695,2763,2566,59,2111,2170,396,2699.67,2543.33,56.42,2136.75,2193.17,350.17,32396,30520,677,25641,26318,4202,2022,'NOVO SANTO ANTONIO',Novo Santo Antônio,'PI',2206951,851.0,851,77.4,77.4,1,,,Pequeno I
805,808,220700,28890,25388,992,20225,21217,4171,27753.08,24585.08,1076.17,19200.5,20276.67,4308.42,333037,295021,12914,230406,243320,51701,2022,'OEIRAS',Oeiras,'PI',2207009,15270.0,50848,1272.5,4237.3,2,2653.0,2653.0,Pequeno II
806,809,220710,2525,2029,84,1490,1574,455,2518.33,2050.75,77.92,1513.0,1590.92,459.83,30220,24609,935,18156,19091,5518,2022,'OLHO DAGUA DO PIAUI',Olho D´água do Piauí,'PI',2207108,1314.0,1314,109.5,109.5,1,85.0,85.0,Pequeno I
807,810,220720,5430,5053,75,4425,4500,553,5353.75,5015.33,73.25,4392.58,4465.83,549.5,64245,60184,879,52711,53590,6594,2022,'PADRE MARCOS',Padre Marcos,'PI',2207207,5768.0,5768,480.7,480.7,1,305.0,305.0,Pequeno I
808,811,220730,3899,3528,61,3000,3061,467,3817.83,3479.67,76.17,2920.5,2996.67,483.0,45814,41756,914,35046,35960,5796,2022,'PAES LANDIM',Paes Landim,'PI',2207306,1230.0,1230,102.5,102.5,1,48.0,48.0,Pequeno I
809,812,220735,2469,2035,71,1524,1595,440,2426.0,2026.17,75.58,1565.58,1641.17,385.0,29112,24314,907,18787,19694,4620,2022,'PAJEU DO PIAUI',Pajeú do Piauí,'PI',2207355,1188.0,1188,108.0,108.0,1,,,Pequeno I
810,813,220740,3756,3306,128,2713,2841,465,3697.58,3280.25,124.75,2733.5,2858.25,422.0,44371,39363,1497,32802,34299,5064,2022,'PALMEIRA DO PIAUI',Palmeira do Piauí,'PI',2207405,2212.0,2212,201.1,201.1,1,115.0,115.0,Pequeno I
811,814,220750,10898,10063,428,8983,9411,652,10543.0,9774.67,381.5,8749.5,9131.0,643.67,126516,117296,4578,104994,109572,7724,2022,'PALMEIRAIS',Palmeirais,'PI',2207504,928.0,928,103.1,103.1,1,98.0,98.0,Pequeno I
812,815,220755,3668,3236,85,2652,2737,499,3590.25,3192.17,70.08,2620.67,2690.75,501.42,43083,38306,841,31448,32289,6017,2022,'PAQUETA',Paquetá,'PI',2207553,486.0,486,44.2,44.2,1,,,Pequeno I
813,816,220760,9032,8329,161,7736,7897,432,8875.33,8247.17,164.5,7703.75,7868.25,378.92,106504,98966,1974,92445,94419,4547,2022,'PARNAGUA',Parnaguá,'PI',2207603,4474.0,4474,372.8,372.8,1,600.0,600.0,Pequeno I
814,817,220770,84405,76673,21029,33140,54169,22504,79306.42,72433.67,19369.42,32039.25,51408.67,21025.0,951677,869204,232433,384471,616904,252300,2022,'PARNAIBA',Parnaíba,'PI',2207702,24037.0,24037,2003.1,2003.1,7,1861.0,1861.0,Grande
815,818,220775,3422,3201,23,3097,3120,81,3290.75,3095.5,26.5,2979.5,3006.0,89.5,39489,37146,318,35754,36072,1074,2022,'PASSAGEM FRANCA DO PIAUI',Passagem Franca do Piauí,'PI',2207751,874.0,874,72.8,72.8,1,30.0,30.0,Pequeno I
816,819,220777,4278,3668,97,2690,2787,881,4233.25,3637.17,114.83,2708.83,2823.67,813.5,50799,43646,1378,32506,33884,9762,2022,'PATOS DO PIAUI',Patos do Piauí,'PI',2207777,2493.0,2493,207.8,207.8,1,150.0,150.0,Pequeno I
817,820,220779,3521,3187,122,2579,2701,486,3435.33,3136.92,107.33,2601.92,2709.25,427.67,41224,37643,1288,31223,32511,5132,2022,'PAU DARCO DO PIAUI',Pau D´arco do Piauí,'PI',2207793,973.0,973,81.1,81.1,1,88.0,88.0,Pequeno I
818,821,220780,15261,14185,912,10980,11892,2293,15031.42,13965.5,790.25,10996.83,11787.08,2178.42,180377,167586,9483,131962,141445,26141,2022,'PAULISTANA',Paulistana,'PI',2207801,1480.0,1480,123.3,123.3,2,101.0,101.0,Pequeno I
819,822,220785,3398,3124,39,2919,2958,166,3368.17,3117.08,36.25,2924.83,2961.08,156.0,40418,37405,435,35098,35533,1872,2022,'PAVUSSU',Pavussu,'PI',2207850,917.0,917,76.4,76.4,1,78.0,78.0,Pequeno I
820,823,220790,30584,28670,796,24263,25059,3611,30116.67,28382.83,911.33,23962.75,24874.08,3508.75,361400,340594,10936,287553,298489,42105,2022,'PEDRO II',Pedro ii,'PI',2207900,1525.0,1525,127.1,127.1,2,120.0,120.0,Pequeno II
821,824,220793,2602,2229,35,1866,1901,328,2571.92,2213.5,29.33,1862.0,1891.33,322.17,30863,26562,352,22344,22696,3866,2022,'PEDRO LAURENTINO',Pedro Laurentino,'PI',2207934,1843.0,1843,153.6,153.6,1,120.0,120.0,Pequeno I
822,825,220795,3797,3485,82,3065,3147,338,3730.0,3452.33,82.08,3036.08,3118.17,334.17,44760,41428,985,36433,37418,4010,2022,'NOVA SANTA RITA',Nova Santa Rita,'PI',2207959,502.0,502,45.6,45.6,1,60.0,60.0,Pequeno I
823,826,220800,49170,44409,1857,35577,37434,6975,46758.67,42478.33,1928.42,33580.92,35509.33,6969.0,561104,509740,23141,402971,426112,83628,2022,'PICOS',Picos,'PI',2208007,20391.0,20391,1699.2,1699.2,2,1203.0,1203.0,Médio
824,827,220810,8986,7987,157,6592,6749,1238,8821.92,7916.42,175.33,6483.83,6659.17,1257.25,105863,94997,2104,77806,79910,15087,2022,'PIMENTEIRAS',Pimenteiras,'PI',2208106,1936.0,1936,161.3,161.3,1,220.0,220.0,Pequeno I
825,828,220820,15196,13961,489,11746,12235,1726,14512.17,13395.0,527.08,11078.67,11605.75,1789.25,174146,160740,6325,132944,139269,21471,2022,'PIO IX',Pio ix,'PI',2208205,198.0,198,18.0,18.0,1,18.0,18.0,Pequeno I
826,829,220830,20766,19178,1025,15248,16273,2905,20135.5,18779.67,931.33,15077.92,16009.25,2770.42,241626,225356,11176,180935,192111,33245,2022,'PIRACURUCA',Piracuruca,'PI',2208304,5512.0,5512,459.3,459.3,2,221.0,221.0,Pequeno II
827,830,220840,40842,36346,5021,22488,27509,8837,39503.0,35279.08,5655.75,20612.83,26268.58,9010.5,474036,423349,67869,247354,315223,108126,2022,'PIRIPIRI',Piripiri,'PI',2208403,5646.0,5646,470.5,470.5,2,374.0,374.0,Médio
828,831,220850,9811,9265,252,8226,8478,787,9826.08,9344.08,282.25,8365.33,8647.58,696.5,117913,112129,3387,100384,103771,8358,2022,'PORTO',Porto,'PI',2208502,3339.0,3339,278.2,278.2,1,109.0,109.0,Pequeno I
829,832,220855,1965,1802,56,1623,1679,123,1923.58,1778.42,53.5,1601.0,1654.5,123.92,23083,21341,642,19212,19854,1487,2022,'PORTO ALEGRE DO PIAUI',Porto Alegre do Piauí,'PI',2208551,468.0,468,46.8,46.8,1,45.0,45.0,Pequeno I
830,833,220860,2830,2542,70,2308,2378,164,2744.08,2499.58,68.92,2275.92,2344.83,154.75,32929,29995,827,27311,28138,1857,2022,'PRATA DO PIAUI',Prata do Piauí,'PI',2208601,834.0,834,166.8,166.8,1,66.0,66.0,Pequeno I
831,834,220865,6727,5599,205,3998,4203,1396,6593.42,5543.83,215.67,4031.33,4247.0,1296.83,79121,66526,2588,48376,50964,15562,2022,'QUEIMADA NOVA',Queimada Nova,'PI',2208650,1938.0,1938,161.5,161.5,1,134.0,134.0,Pequeno I
832,835,220870,8821,7919,169,7102,7271,648,8734.67,7929.5,150.67,7197.25,7347.92,581.58,104816,95154,1808,86367,88175,6979,2022,'REDENCAO DO GURGUEIA',Redenção do Gurguéia,'PI',2208700,2307.0,2307,256.3,256.3,1,465.0,465.0,Pequeno I
833,836,220880,14434,13096,288,11921,12209,887,13883.08,12728.67,286.42,11638.92,11925.33,803.33,166597,152744,3437,139667,143104,9640,2022,'REGENERACAO',Regeneração,'PI',2208809,9468.0,9468,789.0,789.0,2,376.0,376.0,Pequeno I
834,837,220885,4388,3942,262,3092,3354,588,4343.75,3917.25,237.75,3082.42,3320.17,597.08,52125,47007,2853,36989,39842,7165,2022,'RIACHO FRIO',Riacho Frio,'PI',2208858,1311.0,1311,109.2,109.2,1,110.0,110.0,Pequeno I
835,838,220887,3625,3218,52,2966,3018,200,3535.25,3155.25,49.67,2901.92,2951.58,203.67,42423,37863,596,34823,35419,2444,2022,'RIBEIRA DO PIAUI',Ribeira do Piauí,'PI',2208874,577.0,577,48.1,48.1,1,30.0,30.0,Pequeno I
836,839,220890,4531,4148,199,3315,3514,634,4417.67,4103.5,194.67,3347.08,3541.75,561.75,53012,49242,2336,40165,42501,6741,2022,'RIBEIRO GONCALVES',Ribeiro Gonçalves,'PI',2208908,3964.0,3964,330.3,330.3,1,162.0,162.0,Pequeno I
837,840,220900,5184,4639,51,4102,4153,486,5082.58,4572.58,63.42,4020.92,4084.33,488.25,60991,54871,761,48251,49012,5859,2022,'RIO GRANDE DO PIAUI',Rio Grande do Piauí,'PI',2209005,943.0,943,85.7,85.7,1,32.0,32.0,Pequeno I
838,841,220910,4632,4167,475,3141,3616,551,4514.25,4091.92,373.08,3207.42,3580.5,511.42,54171,49103,4477,38489,42966,6137,2022,'SANTA CRUZ DO PIAUI',Santa Cruz do Piauí,'PI',2209104,1985.0,1985,165.4,165.4,1,42.0,42.0,Pequeno I
839,842,220915,2699,2273,31,1618,1649,624,2673.0,2286.58,43.58,1621.92,1665.5,621.08,32076,27439,523,19463,19986,7453,2022,'SANTA CRUZ DOS MILAGRES',Santa Cruz Dos Milagres,'PI',2209153,1168.0,1168,97.3,97.3,1,67.0,67.0,Pequeno I
840,843,220920,4882,4524,295,3754,4049,475,4762.5,4450.42,285.67,3715.92,4001.58,448.83,57150,53405,3428,44591,48019,5386,2022,'SANTA FILOMENA',Santa Filomena,'PI',2209203,50.0,50,50.0,50.0,1,50.0,50.0,Pequeno I
841,844,220930,5072,4570,56,4192,4248,322,5008.42,4543.17,60.83,4175.92,4236.75,306.42,60101,54518,730,50111,50841,3677,2022,'SANTA LUZ',Santa Luz,'PI',2209302,1320.0,1320,110.0,110.0,1,110.0,110.0,Pequeno I
842,845,220935,3310,2726,89,1718,1807,919,3272.08,2743.5,86.83,1711.58,1798.42,945.08,39265,32922,1042,20539,21581,11341,2022,'SANTANA DO PIAUI',Santana do Piauí,'PI',2209351,1891.0,1891,157.6,157.6,1,133.0,133.0,Pequeno I
843,846,220937,4089,3642,116,2827,2943,699,4082.75,3668.92,120.83,2859.5,2980.33,688.58,48993,44027,1450,34314,35764,8263,2022,'SANTA ROSA DO PIAUI',Santa Rosa do Piauí,'PI',2209377,1329.0,1329,166.1,166.1,1,,,Pequeno I
844,847,220940,4796,4126,116,3390,3506,620,4679.75,4063.17,119.25,3272.67,3391.92,671.25,56157,48758,1431,39272,40703,8055,2022,'SANTO ANTONIO DE LISBOA',Santo Antônio de Lisboa,'PI',2209401,520.0,520,43.3,43.3,1,200.0,200.0,Pequeno I
845,848,220945,1781,1551,115,1029,1144,407,1743.42,1532.33,118.33,1025.67,1144.0,388.33,20921,18388,1420,12308,13728,4660,2022,'SANTO ANTONIO DOS MILAGRES,Santo Antônio Dos Milagres,'PI',2209450,1258.0,1258,104.8,104.8,1,62.0,62.0,Pequeno I
846,849,220950,3400,2579,26,1993,2019,560,3390.33,2614.58,43.92,2003.33,2047.25,567.33,40684,31375,527,24040,24567,6808,2022,'SANTO INACIO DO PIAUI',Santo Inácio do Piauí,'PI',2209500,1657.0,1657,138.1,138.1,1,146.0,146.0,Pequeno I
847,850,220955,4335,3759,26,3260,3286,473,4248.33,3725.0,52.92,3178.83,3231.75,493.25,50980,44700,635,38146,38781,5919,2022,'SAO BRAZ DO PIAUI',São Braz do Piauí,'PI',2209559,120.0,120,30.0,30.0,1,35.0,35.0,Pequeno I
848,851,220960,2100,1693,128,1052,1180,513,2086.75,1703.58,113.83,1037.5,1151.33,552.25,25041,20443,1366,12450,13816,6627,2022,'SAO FELIX DO PIAUI',São Félix do Piauí,'PI',2209609,659.0,659,54.9,54.9,1,44.0,44.0,Pequeno I
849,852,220965,5012,4598,101,3948,4049,549,4978.33,4602.5,122.0,3901.08,4023.08,579.42,59740,55230,1464,46813,48277,6953,2022,'SAO FRANCISCO DE ASSIS DO,São Francisco de Assis do Piauí,'PI',2209658,1950.0,1950,177.3,177.3,1,,,Pequeno I
850,853,220970,5048,4122,30,3523,3553,569,4980.17,4108.25,42.92,3513.92,3556.83,551.42,59762,49299,515,42167,42682,6617,2022,'SAO FRANCISCO DO PIAUI',São Francisco do Piauí,'PI',2209708,1734.0,1734,144.5,144.5,1,139.0,139.0,Pequeno I
851,854,220975,2097,1907,53,1634,1687,220,2036.33,1884.17,57.42,1628.75,1686.17,198.0,24436,22610,689,19545,20234,2376,2022,'SAO GONCALO DO GURGUEIA',São Gonçalo do Gurguéia,'PI',2209757,1335.0,1335,111.2,111.2,1,100.0,100.0,Pequeno I
852,855,220980,3557,3331,105,2836,2941,390,3443.92,3242.92,96.75,2744.25,2841.0,401.92,41327,38915,1161,32931,34092,4823,2022,'SAO GONCALO DO PIAUI',São Gonçalo do Piauí,'PI',2209807,1192.0,1192,99.3,99.3,1,145.0,145.0,Pequeno I
853,856,220985,3731,3351,161,2583,2744,607,3620.17,3293.0,153.83,2576.42,2730.25,562.75,43442,39516,1846,30917,32763,6753,2022,'SAO JOAO DA CANABRAVA',São João da Canabrava,'PI',2209856,2346.0,2346,195.5,195.5,1,131.0,131.0,Pequeno I
854,857,220987,4622,4276,184,3515,3699,577,4537.92,4207.17,196.25,3433.75,3630.0,577.17,54455,50486,2355,41205,43560,6926,2022,'SAO JOAO DA FRONTEIRA',São João da Fronteira,'PI',2209872,1478.0,1478,123.2,123.2,1,90.0,90.0,Pequeno I
855,858,220990,4882,4485,94,3719,3813,672,4830.83,4467.42,102.67,3710.42,3813.08,654.33,57970,53609,1232,44525,45757,7852,2022,'SAO JOAO DA SERRA',São João da Serra,'PI',2209906,1988.0,1988,180.7,180.7,1,152.0,152.0,Pequeno I
856,859,220995,3794,3295,46,2792,2838,457,3677.83,3224.17,56.75,2620.67,2677.42,546.75,44134,38690,681,31448,32129,6561,2022,'SAO JOAO DA VARJOTA',São João da Varjota,'PI',2209955,1116.0,1116,93.0,93.0,1,34.0,34.0,Pequeno I
857,860,220997,7461,6983,181,6042,6223,760,7414.25,7018.92,206.67,6108.08,6314.75,704.17,88971,84227,2480,73297,75777,8450,2022,'SAO JOAO DO ARRAIAL',São João do Arraial,'PI',2209971,1646.0,1646,137.2,137.2,1,159.0,159.0,Pequeno I
858,861,221000,13431,12328,521,10178,10699,1629,12953.42,12011.17,472.0,10116.58,10588.58,1422.58,155441,144134,5664,121399,127063,17071,2022,'SAO JOAO DO PIAUI',São João do Piauí,'PI',2210003,3312.0,3312,276.0,276.0,1,138.0,138.0,Pequeno I
859,862,221005,4313,4018,95,3326,3421,597,4143.67,3872.0,105.17,3198.33,3303.5,568.5,49724,46464,1262,38380,39642,6822,2022,'SAO JOSE DO DIVINO',São José do Divino,'PI',2210052,1981.0,1981,165.1,165.1,1,80.0,80.0,Pequeno I
860,863,221010,2946,2549,54,2229,2283,266,2914.0,2530.75,54.5,2192.92,2247.42,283.33,34968,30369,654,26315,26969,3400,2022,'SAO JOSE DO PEIXE',São José do Peixe,'PI',2210102,1827.0,1827,152.2,152.2,1,132.0,132.0,Pequeno I
861,864,221020,4959,4636,93,3604,3697,939,4916.17,4627.67,94.5,3590.0,3684.5,943.17,58994,55532,1134,43080,44214,11318,2022,'SAO JOSE DO PIAUI',São José do Piauí,'PI',2210201,1818.0,1818,151.5,151.5,1,75.0,75.0,Pequeno I
862,865,221030,4149,3777,57,3400,3457,320,4114.67,3772.58,68.58,3360.42,3429.0,343.58,49376,45271,823,40325,41148,4123,2022,'SAO JULIAO',São Julião,'PI',2210300,3913.0,3913,326.1,326.1,1,130.0,130.0,Pequeno I
863,866,221035,4171,3748,72,3283,3355,393,4128.33,3768.0,45.92,3365.17,3411.08,356.92,49540,45216,551,40382,40933,4283,2022,'SAO LOURENCO DO PIAUI',São Lourenço do Piauí,'PI',2210359,1164.0,1164,97.0,97.0,1,47.0,47.0,Pequeno I
864,867,221037,2020,1784,42,1259,1301,483,2004.08,1785.58,42.58,1259.33,1301.92,483.67,24049,21427,511,15112,15623,5804,2022,'SAO LUIS DO PIAUI',São Luis do Piauí,'PI',2210375,648.0,648,54.0,54.0,1,67.0,67.0,Pequeno I
865,868,221038,1552,1318,76,908,984,334,1530.42,1306.08,78.75,897.0,975.75,330.33,18365,15673,945,10764,11709,3964,2022,'SAO MIGUEL DA BAIXA GRANDE,São Miguel da Baixa Grande,'PI',2210383,3961.0,3961,330.1,330.1,1,220.0,220.0,Pequeno I
866,869,221039,2455,2166,115,1681,1796,370,2453.5,2180.83,117.5,1696.67,1814.17,366.67,29442,26170,1410,20360,21770,4400,2022,'SAO MIGUEL DO FIDALGO',São Miguel do Fidalgo,'PI',2210391,1076.0,1076,89.7,89.7,1,42.0,42.0,Pequeno I
867,870,221040,13530,12222,640,9676,10316,1906,13195.5,12053.42,594.42,9683.5,10277.92,1775.5,158346,144641,7133,116202,123335,21306,2022,'SAO MIGUEL DO TAPUIO',São Miguel do Tapuio,'PI',2210409,3806.0,3806,317.2,317.2,2,241.0,241.0,Pequeno I
868,871,221050,10989,10264,193,9301,9494,770,10768.58,10100.25,226.83,9129.67,9356.5,743.75,129223,121203,2722,109556,112278,8925,2022,'SAO PEDRO DO PIAUI',São Pedro do Piauí,'PI',2210508,274.0,274,22.8,22.8,1,18.0,18.0,Pequeno I
869,872,221060,27803,24351,1138,19224,20362,3989,26867.67,23810.92,1056.58,18929.75,19986.33,3824.58,322412,285731,12679,227157,239836,45895,2022,'SAO RAIMUNDO NONATO',São Raimundo Nonato,'PI',2210607,18904.0,21354,2363.0,2669.2,2,1633.0,1633.0,Pequeno II
870,873,221062,4015,3656,251,2887,3138,518,3872.33,3565.08,209.42,2841.42,3050.83,514.25,46468,42781,2513,34097,36610,6171,2022,'SEBASTIAO BARROS',Sebastião Barros,'PI',2210623,1041.0,1041,86.8,86.8,1,85.0,85.0,Pequeno I
871,874,221063,3387,3112,161,2501,2662,450,3264.83,3015.58,185.83,2389.08,2574.92,440.67,39178,36187,2230,28669,30899,5288,2022,'SEBASTIAO LEAL',Sebastião Leal,'PI',2210631,1864.0,1864,155.3,155.3,1,351.0,351.0,Pequeno I
872,875,221065,7414,6636,51,5914,5965,671,7216.08,6537.08,55.25,5761.92,5817.17,719.92,86593,78445,663,69143,69806,8639,2022,'SIGEFREDO PACHECO',Sigefredo Pacheco,'PI',2210656,986.0,986,82.2,82.2,1,38.0,38.0,Pequeno I
873,876,221070,11004,9382,1406,5603,7009,2373,10842.17,9343.58,1219.25,5772.17,6991.42,2352.17,130106,112123,14631,69266,83897,28226,2022,'SIMOES',Simões,'PI',2210706,3901.0,3901,354.6,354.6,1,174.0,174.0,Pequeno I
874,877,221080,9396,8208,180,6634,6814,1394,9125.33,8048.33,190.75,6535.58,6726.33,1322.0,109504,96580,2289,78427,80716,15864,2022,'SIMPLICIO MENDES',Simplício Mendes,'PI',2210805,6883.0,6883,573.6,573.6,1,450.0,450.0,Pequeno I
875,878,221090,3688,3245,45,2768,2813,432,3683.67,3263.33,50.75,2767.83,2818.58,444.75,44204,39160,609,33214,33823,5337,2022,'SOCORRO DO PIAUI',Socorro do Piauí,'PI',2210904,1669.0,1669,139.1,139.1,1,78.0,78.0,Pequeno I
876,879,221093,4491,4167,353,2976,3329,838,4380.08,4098.83,335.33,2920.0,3255.33,843.5,52561,49186,4024,35040,39064,10122,2022,'SUSSUAPARA',Sussuapara,'PI',2210938,2024.0,2024,168.7,168.7,1,60.0,60.0,Pequeno I
877,880,221095,2488,2214,93,1757,1850,364,2443.67,2191.75,78.08,1775.67,1853.75,338.0,29324,26301,937,21308,22245,4056,2022,'TAMBORIL DO PIAUI',Tamboril do Piauí,'PI',2210953,928.0,928,77.3,77.3,1,73.0,73.0,Pequeno I
878,881,221097,2249,1826,58,1330,1388,438,2261.67,1866.58,53.08,1348.83,1401.92,464.67,27140,22399,637,16186,16823,5576,2022,'TANQUE DO PIAUI',Tanque do Piauí,'PI',2210979,1060.0,1060,106.0,106.0,1,49.0,49.0,Pequeno I
879,882,221100,396248,353891,27592,247537,275129,78762,362641.25,325142.5,26978.08,223900.17,250878.25,74264.25,4351695,3901710,323737,2686802,3010539,891171,2022,'TERESINA',Teresina,'PI',2211001,322554.0,463724,26879.5,38643.7,19,29682.0,29682.0,Grande
880,883,221110,32738,31171,883,27318,28201,2970,31328.92,29985.17,812.33,26551.33,27363.67,2621.5,375947,359822,9748,318616,328364,31458,2022,'UNIAO',União,'PI',2211100,2492.0,2492,207.7,207.7,2,168.0,168.0,Pequeno II
881,884,221120,15073,14070,611,11922,12533,1537,14475.58,13569.33,500.75,11720.5,12221.25,1348.08,173707,162832,6009,140646,146655,16177,2022,'URUCUI',Uruçuí,'PI',2211209,2774.0,2774,231.2,231.2,1,106.0,106.0,Pequeno II
882,885,221130,15457,12772,1928,7864,9792,2980,15080.42,12518.58,1770.17,7589.0,9359.17,3159.42,180965,150223,21242,91068,112310,37913,2022,'VALENCA DO PIAUI',Valença do Piauí,'PI',2211308,1121.0,1121,93.4,93.4,2,49.0,49.0,Pequeno II
883,886,221135,4995,4573,160,3991,4151,422,4892.0,4527.75,142.5,3975.75,4118.25,409.5,58704,54333,1710,47709,49419,4914,2022,'VARZEA BRANCA',Várzea Branca,'PI',2211357,4691.0,4691,390.9,390.9,1,380.0,380.0,Pequeno I
884,887,221140,3528,3114,88,2709,2797,317,3407.92,3063.83,76.0,2705.17,2781.17,282.67,40895,36766,912,32462,33374,3392,2022,'VARZEA GRANDE',Várzea Grande,'PI',2211407,1262.0,1262,114.7,114.7,1,55.0,55.0,Pequeno I
885,888,221150,2991,2437,108,1826,1934,503,2918.0,2433.17,116.25,1797.25,1913.5,519.67,35016,29198,1395,21567,22962,6236,2022,'VERA MENDES',Vera Mendes,'PI',2211506,1311.0,1311,119.2,119.2,1,146.0,146.0,Pequeno I
886,889,221160,1958,1825,50,1444,1494,331,1934.17,1808.75,60.5,1431.33,1491.83,316.92,23210,21705,726,17176,17902,3803,2022,'VILA NOVA DO PIAUI',Vila Nova do Piauí,'PI',2211605,338.0,338,28.2,28.2,1,20.0,20.0,Pequeno I
887,890,221170,2931,2771,17,2498,2515,256,2931.67,2776.17,25.25,2447.58,2472.83,303.33,35180,33314,303,29371,29674,3640,2022,'WALL FERRAZ',Wall Ferraz,'PI',2211704,1013.0,1013,84.4,84.4,1,150.0,150.0,Pequeno I
888,891,230010,8591,7408,185,5844,6029,1379,8434.5,7384.83,150.67,5901.33,6052.0,1332.83,101214,88618,1808,70816,72624,15994,2022,'ABAIARA',Abaiara,'CE',2300101,1217.0,1217,101.4,101.4,2,111.0,111.0,Pequeno I
889,892,230015,11451,10256,645,7246,7891,2365,10962.83,9965.83,621.83,7044.58,7666.42,2299.42,131554,119590,7462,84535,91997,27593,2022,'ACARAPE',Acarapé,'CE',2300150,5669.0,11108,472.4,925.7,1,498.0,498.0,Pequeno I
890,893,230020,47178,44926,2411,37028,39439,5487,44987.75,43264.08,2013.25,36720.17,38733.42,4530.67,539853,519169,24159,440642,464801,54368,2022,'ACARAU',Acaraú,'CE',2300200,5833.0,5833,486.1,486.1,2,159.0,159.0,Médio
891,894,230030,34446,30909,1149,25281,26430,4479,33467.42,30347.92,959.83,25627.92,26587.75,3760.17,401609,364175,11518,307535,319053,45122,2022,'ACOPIARA',Acopiara,'CE',2300309,11891.0,11891,990.9,990.9,3,1631.0,1631.0,Médio
892,895,230040,12043,10606,184,8816,9000,1606,11874.08,10526.58,213.75,8813.25,9027.0,1499.58,142489,126319,2565,105759,108324,17995,2022,'AIUABA',Aiuaba,'CE',2300408,6915.0,6915,576.2,576.2,1,576.0,576.0,Pequeno I
893,896,230050,8808,7147,1008,3246,4254,2893,8662.25,7143.17,961.5,3253.0,4214.5,2928.67,103947,85718,11538,39036,50574,35144,2022,'ALCANTARAS',Alcântaras,'CE',2300507,2541.0,2541,211.8,211.8,1,64.0,64.0,Pequeno I
894,897,230060,7009,5883,151,4580,4731,1152,6899.0,5887.25,149.08,4596.33,4745.42,1141.83,82788,70647,1789,55156,56945,13702,2022,'ALTANEIRA',Altaneira,'CE',2300606,944.0,944,78.7,78.7,2,74.0,74.0,Pequeno I
895,898,230070,11931,10000,1242,6437,7679,2321,11642.5,9898.75,1147.92,6430.92,7578.83,2319.92,139710,118785,13775,77171,90946,27839,2022,'ALTO SANTO',Alto Santo,'CE',2300705,6877.0,6877,573.1,573.1,1,297.0,297.0,Pequeno I
896,899,230075,31833,29857,1761,23683,25444,4413,30833.83,29153.58,1862.75,23165.08,25027.83,4125.75,370006,349843,22353,277981,300334,49509,2022,'AMONTADA',Amontada,'CE',2300754,4677.0,4677,389.8,389.8,2,251.0,251.0,Pequeno II
897,900,230080,6842,5754,25,5325,5350,404,6771.75,5756.33,22.67,5327.42,5350.08,406.25,81261,69076,272,63929,64201,4875,2022,'ANTONINA DO NORTE',Antonina do Norte,'CE',2300804,530.0,530,44.2,44.2,1,68.0,68.0,Pequeno I
898,901,230090,11715,10248,326,8352,8678,1570,11495.67,10199.67,380.08,8272.67,8652.75,1546.92,137948,122396,4561,99272,103833,18563,2022,'APUIARES',Apuiarés,'CE',2300903,12473.0,12473,1039.4,1039.4,2,616.0,616.0,Pequeno I
899,902,230100,58129,53398,4920,37294,42214,11184,54379.25,50383.25,4180.58,36105.33,40285.92,10097.33,652551,604599,50167,433264,483431,121168,2022,'AQUIRAZ',Aquiraz,'CE',2301000,62578.0,96886,5214.8,8073.8,5,3746.0,6721.0,Médio
900,903,230110,44209,39139,6393,20983,27376,11763,41598.17,36994.0,5637.67,20220.25,25857.92,11136.08,499178,443928,67652,242643,310295,133633,2022,'ARACATI',Aracati,'CE',2301109,8896.0,8896,741.3,741.3,4,381.0,381.0,Médio
901,904,230120,22884,20629,1737,14628,16365,4264,22337.92,20428.17,1433.5,15123.58,16557.08,3871.08,268055,245138,17202,181483,198685,46453,2022,'ARACOIABA',Aracoiaba,'CE',2301208,5622.0,5622,468.5,468.5,2,319.0,319.0,Pequeno II
902,905,230125,8695,7682,242,6065,6307,1375,8652.58,7635.0,281.75,5934.92,6216.67,1418.33,103831,91620,3381,71219,74600,17020,2022,'ARARENDA',Ararendá,'CE',2301257,6002.0,9567,500.2,797.2,1,0.0,1189.0,Pequeno I
903,906,230130,18479,15698,1005,10746,11751,3947,18264.17,15745.17,1121.08,10683.92,11805.0,3940.17,219170,188942,13453,128207,141660,47282,2022,'ARARIPE',Araripe,'CE',2301307,4527.0,4527,377.2,377.2,2,116.0,116.0,Pequeno II
904,907,230140,11228,9788,410,7341,7751,2037,10937.83,9683.92,432.42,7280.5,7712.92,1971.0,131254,116207,5189,87366,92555,23652,2022,'ARATUBA',Aratuba,'CE',2301406,2153.0,2153,179.4,179.4,1,130.0,130.0,Pequeno I
905,908,230150,5130,4407,523,2631,3154,1253,5047.58,4382.0,502.17,2700.25,3202.42,1179.58,60571,52584,6026,32403,38429,14155,2022,'ARNEIROZ',Arneiroz,'CE',2301505,1621.0,1621,135.1,135.1,1,80.0,80.0,Pequeno I
906,909,230160,18047,16269,458,13683,14141,2128,17642.67,16058.67,441.25,13521.5,13962.75,2095.92,211712,192704,5295,162258,167553,25151,2022,'ASSARE',Assaré,'CE',2301604,903.0,903,75.2,75.2,1,25.0,25.0,Pequeno II
907,910,230170,19276,16370,1157,11061,12218,4152,19053.58,16373.17,1152.08,11246.17,12398.25,3974.92,228643,196478,13825,134954,148779,47699,2022,'AURORA',Aurora,'CE',2301703,1938.0,1938,161.5,161.5,1,206.0,206.0,Pequeno II
908,911,230180,4858,4150,62,3237,3299,851,4739.75,4173.17,73.08,3269.83,3342.92,830.25,56877,50078,877,39238,40115,9963,2022,'BAIXIO',Baixio,'CE',2301802,1851.0,1851,154.2,154.2,1,131.0,131.0,Pequeno I
909,912,230185,13342,11749,1164,8321,9485,2264,13130.83,11783.58,1032.33,8567.92,9600.25,2183.33,157570,141403,12388,102815,115203,26200,2022,'BANABUIU',Banabuiú,'CE',2301851,3887.0,3887,323.9,323.9,2,762.0,762.0,Pequeno I
910,913,230190,47523,41360,5636,22484,28120,13240,45394.92,40192.67,4813.5,23276.33,28089.83,12102.83,544739,482312,57762,279316,337078,145234,2022,'BARBALHA',Barbalha,'CE',2301901,3952.0,3952,329.3,329.3,2,213.0,213.0,Médio
911,914,230195,17650,16409,907,12591,13498,2911,17057.5,15978.67,953.83,12242.33,13196.17,2782.5,204690,191744,11446,146908,158354,33390,2022,'BARREIRA',Barreira,'CE',2301950,943.0,943,78.6,78.6,1,104.0,104.0,Pequeno I
912,915,230200,14709,12763,854,9040,9894,2869,14296.17,12565.25,729.58,9180.5,9910.08,2655.17,171554,150783,8755,110166,118921,31862,2022,'BARRO',Barro,'CE',2302008,727.0,727,60.6,60.6,1,52.0,52.0,Pequeno II
913,916,230205,13231,12210,982,9246,10228,1982,12792.33,11905.25,781.33,9232.67,10014.0,1891.25,153508,142863,9376,110792,120168,22695,2022,'BARROQUINHA',Barroquinha,'CE',2302057,2073.0,2073,172.8,172.8,1,351.0,351.0,Pequeno I
914,917,230210,26837,24230,990,19146,20136,4094,26290.0,23858.58,1074.08,18772.08,19846.17,4012.42,315480,286303,12889,225265,238154,48149,2022,'BATURITE',Baturité,'CE',2302107,8628.0,8628,719.0,719.0,3,539.0,539.0,Pequeno II
915,918,230220,40509,37194,2186,29756,31942,5252,38966.17,35991.75,1969.42,29081.17,31050.58,4941.17,467594,431901,23633,348974,372607,59294,2022,'BEBERIBE',Beberibe,'CE',2302206,15539.0,15539,1294.9,1294.9,3,1183.0,1183.0,Pequeno II
916,919,230230,21919,20209,1308,15208,16516,3693,21474.17,19887.67,1194.42,15149.42,16343.83,3543.83,257690,238652,14333,181793,196126,42526,2022,'BELA CRUZ',Bela Cruz,'CE',2302305,1714.0,1714,142.8,142.8,1,19.0,19.0,Pequeno II
917,920,230240,37775,33566,1809,25848,27657,5909,36909.67,33177.75,1533.42,26085.75,27619.17,5558.58,442916,398133,18401,313029,331430,66703,2022,'BOA VIAGEM',Boa Viagem,'CE',2302404,12930.0,12930,1077.5,1077.5,2,1561.0,1561.0,Médio
918,921,230250,27658,26407,1330,19120,20450,5957,26353.58,25187.5,1043.75,19112.67,20156.42,5031.08,316243,302250,12525,229352,241877,60373,2022,'BREJO SANTO',Brejo Santo,'CE',2302503,4562.0,4562,380.2,380.2,2,208.0,208.0,Pequeno II
919,922,230260,46726,42185,5751,25273,31024,11161,45817.0,41781.42,6003.92,24803.5,30807.42,10974.0,549804,501377,72047,297642,369689,131688,2022,'CAMOCIM',Camocim,'CE',2302602,4356.0,4356,363.0,363.0,2,207.0,207.0,Médio
920,923,230270,21250,17504,2126,10400,12526,4978,21141.58,17611.42,2034.42,10745.58,12780.0,4831.42,253699,211337,24413,128947,153360,57977,2022,'CAMPOS SALES',Campos Sales,'CE',2302701,6454.0,6454,537.8,537.8,2,1210.0,1210.0,Pequeno II
921,924,230280,56190,49096,1649,38109,39758,9338,55506.75,48923.92,1789.58,37704.92,39494.5,9429.42,666081,587087,21475,452459,473934,113153,2022,'CANINDE',Canindé,'CE',2302800,13586.0,13586,1132.2,1132.2,4,583.0,583.0,Médio
922,925,230290,14451,12676,524,9876,10400,2276,14275.08,12566.33,521.83,9770.75,10292.58,2273.75,171301,150796,6262,117249,123511,27285,2022,'CAPISTRANO',Capistrano,'CE',2302909,3078.0,3078,256.5,256.5,2,173.0,173.0,Pequeno I
923,926,230300,13891,12943,210,11394,11604,1339,13558.25,12746.08,239.58,11253.17,11492.75,1253.33,162699,152953,2875,135038,137913,15040,2022,'CARIDADE',Caridade,'CE',2303006,3150.0,3150,262.5,262.5,2,366.0,366.0,Pequeno II
924,927,230310,14450,12633,592,8906,9498,3135,14120.75,12580.33,604.42,8804.0,9408.42,3171.92,169449,150964,7253,105648,112901,38063,2022,'CARIRE',Cariré,'CE',2303105,2109.0,2109,175.8,175.8,2,135.0,135.0,Pequeno I
925,928,230320,23763,20972,949,15770,16719,4253,23609.0,21009.75,1018.08,15889.33,16907.42,4102.33,283308,252117,12217,190672,202889,49228,2022,'CARIRIACU',Caririaçu,'CE',2303204,3695.0,3695,307.9,307.9,2,188.0,188.0,Pequeno II
926,929,230330,13964,11545,479,8409,8888,2657,13691.42,11487.92,470.0,8427.92,8897.92,2590.0,164297,137855,5640,101135,106775,31080,2022,'CARIUS',Cariús,'CE',2303303,3488.0,3488,290.7,290.7,2,336.0,336.0,Pequeno I
927,930,230340,12930,11559,818,7904,8722,2837,12555.75,11348.08,761.25,7946.75,8708.0,2640.08,150669,136177,9135,95361,104496,31681,2022,'CARNAUBAL',Carnaubal,'CE',2303402,5997.0,7580,499.8,631.7,4,259.0,259.0,Pequeno I
928,931,230350,54054,49699,2916,35549,38465,11234,52536.83,48684.92,2833.17,34812.83,37646.0,11038.92,630442,584219,33998,417754,451752,132467,2022,'CASCAVEL',Cascavel,'CE',2303501,22026.0,22026,1835.5,1835.5,4,1984.0,1984.0,Médio
929,932,230360,8530,7123,391,5198,5589,1534,8305.58,7049.0,386.58,5082.75,5469.33,1579.67,99667,84588,4639,60993,65632,18956,2022,'CATARINA',Catarina,'CE',2303600,1827.0,13860,152.2,1155.0,1,0.0,1284.0,Pequeno I
930,933,230365,7916,7004,231,6044,6275,729,7830.83,6941.58,251.92,5907.08,6159.0,782.58,93970,83299,3023,70885,73908,9391,2022,'CATUNDA',Catunda,'CE',2303659,1513.0,1513,126.1,126.1,1,49.0,49.0,Pequeno I
931,934,230370,210780,194550,12810,147980,160790,33760,190647.08,176041.17,14089.25,128636.17,142725.42,33315.75,2287765,2112494,169071,1543634,1712705,399789,2022,'CAUCAIA',Caucaia,'CE',2303709,169689.0,328865,14140.8,27405.4,11,11556.0,18645.0,Grande
932,935,230380,18548,15552,495,11259,11754,3798,18300.33,15539.83,527.92,11287.67,11815.58,3724.25,219604,186478,6335,135452,141787,44691,2022,'CEDRO',Cedro,'CE',2303808,9466.0,9466,788.8,788.8,2,512.0,512.0,Pequeno II
933,936,230390,10436,9485,317,7334,7651,1834,10314.83,9440.83,350.67,7305.83,7656.5,1784.33,123778,113290,4208,87670,91878,21412,2022,'CHAVAL',Chaval,'CE',2303907,2963.0,2963,246.9,246.9,1,165.0,165.0,Pequeno I
934,937,230393,10271,8659,412,6588,7000,1659,10197.33,8650.08,465.42,6517.42,6982.83,1667.25,122368,103801,5585,78209,83794,20007,2022,'CHORO',Choró,'CE',2303931,1635.0,1635,136.2,136.2,1,82.0,82.0,Pequeno I
935,938,230395,16834,15005,1395,9766,11161,3844,16560.17,14989.92,1341.25,9994.5,11335.75,3654.17,198722,179879,16095,119934,136029,43850,2022,'CHOROZINHO',Chorozinho,'CE',2303956,5359.0,5359,446.6,446.6,1,473.0,473.0,Pequeno I
936,939,230400,16294,14934,403,11558,11961,2973,15886.83,14661.5,410.17,11379.33,11789.5,2872.0,190642,175938,4922,136552,141474,34464,2022,'COREAU',Coreaú,'CE',2304004,5467.0,5467,455.6,455.6,2,552.0,552.0,Pequeno II
937,940,230410,43157,38185,3170,25822,28992,9193,41557.75,36917.67,2969.5,25509.0,28478.5,8439.17,498693,443012,35634,306108,341742,101270,2022,'CRATEUS',Crateús,'CE',2304103,17900.0,17900,1491.7,1491.7,3,553.0,553.0,Médio
938,941,230420,88568,77377,8086,46786,54872,22505,85743.5,75714.5,7962.17,45636.83,53599.0,22115.5,1028922,908574,95546,547642,643188,265386,2022,'CRATO',Crato,'CE',2304202,31633.0,31633,2636.1,2636.1,6,2636.0,2636.0,Grande
939,942,230423,14564,13262,933,9266,10199,3063,14495.58,13258.75,927.5,9489.58,10417.08,2841.67,173947,159105,11130,113875,125005,34100,2022,'CROATA',Croatá,'CE',2304236,3839.0,3839,319.9,319.9,2,228.0,228.0,Pequeno I
940,943,230425,19707,18508,1879,12776,14655,3853,18881.33,17805.33,1699.83,12543.75,14243.58,3561.75,226576,213664,20398,150525,170923,42741,2022,'CRUZ',Cruz,'CE',2304251,4637.0,4637,386.4,386.4,1,373.0,373.0,Pequeno II
941,944,230426,7554,5883,157,4288,4445,1438,7545.33,5996.08,174.33,4397.83,4572.17,1423.92,90544,71953,2092,52774,54866,17087,2022,'DEPUTADO IRAPUAN PINHEIRO',Deputado Irapuan Pinheiro,'CE',2304269,1336.0,1336,111.3,111.3,1,54.0,54.0,Pequeno I
942,945,230427,5483,4186,456,2129,2585,1601,5427.08,4245.42,424.5,2203.33,2627.83,1617.58,65125,50945,5094,26440,31534,19411,2022,'ERERE',Ererê,'CE',2304277,1896.0,1896,158.0,158.0,1,122.0,122.0,Pequeno I
943,946,230428,29638,27103,3911,15437,19348,7755,28410.33,26081.5,3809.08,15056.25,18865.33,7216.17,340924,312978,45709,180675,226384,86594,2022,'EUSEBIO',Eusébio,'CE',2304285,20378.0,20378,1698.2,1698.2,3,1760.0,1760.0,Pequeno II
944,947,230430,15051,12682,541,9345,9886,2796,14637.17,12586.83,556.5,9309.5,9866.0,2720.83,175646,151042,6678,111714,118392,32650,2022,'FARIAS BRITO',Farias Brito,'CE',2304301,3303.0,3303,275.2,275.2,2,143.0,143.0,Pequeno I
945,948,230435,17489,15026,2055,8674,10729,4297,17028.75,14830.17,1895.83,8827.83,10723.67,4106.5,204345,177962,22750,105934,128684,49278,2022,'FORQUILHA',Forquilha,'CE',2304350,3805.0,3805,317.1,317.1,1,167.0,167.0,Pequeno II
946,949,230440,1244807,1122486,82278,802697,884975,237511,1172268.75,1060926.67,79745.42,751668.08,831413.5,229513.17,14067225,12731120,956945,9020017,9976962,2754158,2022,'FORTALEZA',Fortaleza,'CE',2304400,738816.0,966566,61568.0,80547.2,27,60486.0,66025.0,Metrópole
947,950,230445,12350,10741,675,6966,7641,3100,11984.58,10452.42,670.08,6814.08,7484.17,2968.25,143815,125429,8041,81769,89810,35619,2022,'FORTIM',Fortim,'CE',2304459,3512.0,3512,292.7,292.7,1,285.0,285.0,Pequeno I
948,951,230450,11276,10350,688,7480,8168,2182,10972.92,10180.25,754.17,7391.83,8146.0,2034.25,131675,122163,9050,88702,97752,24411,2022,'FRECHEIRINHA',Frecheirinha,'CE',2304509,2000.0,2000,166.7,166.7,1,80.0,80.0,Pequeno I
949,952,230460,6325,5690,222,4673,4895,795,6163.75,5616.33,234.17,4613.42,4847.58,768.75,73965,67396,2810,55361,58171,9225,2022,'GENERAL SAMPAIO',General Sampaio,'CE',2304608,950.0,950,79.2,79.2,1,40.0,40.0,Pequeno I
950,953,230465,12366,10787,415,8058,8473,2314,12231.5,10792.0,442.33,8008.0,8450.33,2341.67,146778,129504,5308,96096,101404,28100,2022,'GRACA',Graça,'CE',2304657,4879.0,4879,406.6,406.6,2,925.0,925.0,Pequeno I
951,954,230470,39864,37141,2793,26519,29312,7829,38629.33,36254.58,2996.83,25819.5,28816.33,7438.25,463552,435055,35962,309834,345796,89259,2022,'GRANJA',Granja,'CE',2304707,10820.0,10820,901.7,901.7,2,1720.0,1720.0,Médio
952,955,230480,4541,3979,213,2881,3094,885,4448.58,3956.25,265.58,2860.42,3126.0,830.25,53383,47475,3187,34325,37512,9963,2022,'GRANJEIRO',Granjeiro,'CE',2304806,1688.0,1688,140.7,140.7,1,100.0,100.0,Pequeno I
953,956,230490,8208,7105,649,4416,5065,2040,7999.33,7042.0,631.75,4374.83,5006.58,2035.42,95992,84504,7581,52498,60079,24425,2022,'GROAIRAS',Groaíras,'CE',2304905,2409.0,2409,200.8,200.8,1,118.0,118.0,Pequeno I
954,957,230495,18211,16595,2179,10139,12318,4277,17777.75,16346.92,2020.0,10138.5,12158.5,4188.42,213333,196163,24240,121662,145902,50261,2022,'GUAIUBA',Guaiúba,'CE',2304954,4733.0,4733,394.4,394.4,2,122.0,122.0,Pequeno II
955,958,230500,32153,29667,1368,23460,24828,4839,31049.08,28837.17,1284.0,23158.08,24442.08,4395.08,372589,346046,15408,277897,293305,52741,2022,'GUARACIABA DO NORTE',Guaraciaba do Norte,'CE',2305001,2584.0,2584,215.3,215.3,2,156.0,156.0,Pequeno II
956,959,230510,5185,4287,435,2606,3041,1246,5058.5,4239.5,443.5,2464.08,2907.58,1331.92,60702,50874,5322,29569,34891,15983,2022,'GUARAMIRANGA',Guaramiranga,'CE',2305100,1147.0,1147,95.6,95.6,1,29.0,29.0,Pequeno I
957,960,230520,13934,12532,976,8929,9905,2627,13633.67,12372.33,964.58,8793.25,9757.83,2614.5,163604,148468,11575,105519,117094,31374,2022,'HIDROLANDIA',Hidrolândia,'CE',2305209,2984.0,2984,248.7,248.7,2,117.0,117.0,Pequeno I
958,961,230523,53094,44108,9716,12274,21990,22118,50424.17,42802.33,9290.08,12715.08,22005.17,20797.17,605090,513628,111481,152581,264062,249566,2022,'HORIZONTE',Horizonte,'CE',2305233,25341.0,25341,2111.8,2111.8,5,1285.0,1285.0,Médio
959,962,230526,11468,10195,665,7449,8114,2081,11232.42,10113.0,650.58,7417.92,8068.5,2044.5,134789,121356,7807,89015,96822,24534,2022,'IBARETAMA',Ibaretama,'CE',2305266,730.0,730,60.8,60.8,1,79.0,79.0,Pequeno I
960,963,230530,18749,16658,3655,9087,12742,3916,18252.42,16335.42,2904.58,9874.0,12778.58,3556.83,219029,196025,34855,118488,153343,42682,2022,'IBIAPINA',Ibiapina,'CE',2305308,7051.0,7051,587.6,587.6,2,258.0,258.0,Pequeno II
961,964,230533,11521,9723,181,8008,8189,1534,11237.08,9580.33,199.17,7869.83,8069.0,1511.33,134845,114964,2390,94438,96828,18136,2022,'IBICUITINGA',Ibicuitinga,'CE',2305332,2016.0,2016,168.0,168.0,1,680.0,680.0,Pequeno I
962,965,230535,15458,13830,1059,9067,10126,3704,15231.83,13730.75,1089.67,9128.0,10217.67,3513.08,182782,164769,13076,109536,122612,42157,2022,'ICAPUI',Icapuí,'CE',2305357,1675.0,1675,139.6,139.6,1,56.0,56.0,Pequeno I
963,966,230540,45564,41386,994,33652,34646,6740,44885.25,41047.42,1151.58,33470.42,34622.0,6425.42,538623,492569,13819,401645,415464,77105,2022,'ICO',Icó,'CE',2305407,18161.0,23691,1513.4,1974.2,3,944.0,3516.0,Médio
964,967,230550,63372,55342,4727,37014,41741,13601,60964.83,53377.25,4367.33,35820.25,40187.58,13189.67,731578,640527,52408,429843,482251,158276,2022,'IGUATU',Iguatu,'CE',2305506,18895.0,18895,1574.6,1574.6,6,1006.0,1006.0,Médio
965,968,230560,19531,16475,343,14010,14353,2122,19792.42,17134.58,363.83,14560.42,14924.25,2210.33,237509,205615,4366,174725,179091,26524,2022,'INDEPENDENCIA',Independência,'CE',2305605,4060.0,4060,338.3,338.3,1,214.0,214.0,Pequeno II
966,969,230565,9153,7978,290,6180,6470,1508,8960.83,7892.33,352.42,6079.75,6432.17,1460.17,107530,94708,4229,72957,77186,17522,2022,'IPAPORANGA',Ipaporanga,'CE',2305654,3792.0,3792,316.0,316.0,1,707.0,707.0,Pequeno I
967,970,230570,9281,8317,230,6749,6979,1338,9089.33,8263.92,237.92,6737.5,6975.42,1288.5,109072,99167,2855,80850,83705,15462,2022,'IPAUMIRIM',Ipaumirim,'CE',2305704,2680.0,2680,223.3,223.3,2,200.0,200.0,Pequeno I
968,971,230580,32180,29169,1092,24278,25370,3799,31224.0,28520.25,1157.75,23547.67,24705.42,3814.83,374688,342243,13893,282572,296465,45778,2022,'IPU',Ipu,'CE',2305803,4481.0,4481,373.4,373.4,2,136.0,136.0,Pequeno II
969,972,230590,28645,25233,1843,18038,19881,5352,27826.58,24679.0,1692.67,17820.25,19512.92,5166.08,333919,296148,20312,213843,234155,61993,2022,'IPUEIRAS',Ipueiras,'CE',2305902,9489.0,9489,790.8,790.8,2,674.0,674.0,Pequeno II
970,973,230600,10100,8501,351,5914,6265,2236,9973.75,8411.58,327.75,5831.75,6159.5,2252.08,119685,100939,3933,69981,73914,27025,2022,'IRACEMA',Iracema,'CE',2306009,3968.0,7404,330.7,617.0,1,406.0,406.0,Pequeno I
971,974,230610,19459,17825,1221,13854,15075,2750,19187.92,17700.0,1191.92,13912.67,15104.58,2595.42,230255,212400,14303,166952,181255,31145,2022,'IRAUCUBA',Irauçuba,'CE',2306108,6591.0,6591,549.2,549.2,2,1121.0,1121.0,Pequeno II
972,975,230620,5998,4942,292,3069,3361,1581,5920.92,4947.17,314.5,3050.33,3364.83,1582.33,71051,59366,3774,36604,40378,18988,2022,'ITAICABA',Itaiçaba,'CE',2306207,2012.0,2012,167.7,167.7,1,76.0,76.0,Pequeno I
973,976,230625,29335,26362,5440,11973,17413,8949,26948.42,24292.75,5366.75,10798.75,16165.5,8127.25,323381,291513,64401,129585,193986,97527,2022,'ITAITINGA',Itaitinga,'CE',2306256,6705.0,6705,558.8,558.8,2,488.0,488.0,Pequeno II
974,977,230630,35306,32103,3544,20872,24416,7687,34435.0,31491.17,3144.17,21190.67,24334.83,7156.33,413220,377894,37730,254288,292018,85876,2022,'ITAPAJE',Itapagé,'CE',2306306,2198.0,2198,183.2,183.2,2,202.0,202.0,Pequeno II
975,978,230640,88829,83548,4913,65003,69916,13632,87054.08,82216.92,4798.67,64949.08,69747.75,12469.17,1044649,986603,57584,779389,836973,149630,2022,'ITAPIPOCA',Itapipoca,'CE',2306405,13163.0,13163,1096.9,1096.9,5,725.0,725.0,Grande
976,979,230650,14923,13208,642,10316,10958,2250,14844.17,13280.58,569.5,10571.92,11141.42,2139.17,178130,159367,6834,126863,133697,25670,2022,'ITAPIUNA',Itapiúna,'CE',2306504,5733.0,5733,477.8,477.8,2,437.0,437.0,Pequeno I
977,980,230655,33481,32281,2376,26092,28468,3813,32693.0,31612.75,2203.17,25898.42,28101.58,3511.17,392316,379353,26438,310781,337219,42134,2022,'ITAREMA',Itarema,'CE',2306553,6255.0,6255,521.2,521.2,2,222.0,222.0,Pequeno II
978,981,230660,18960,16447,722,12878,13600,2847,18677.5,16378.33,825.92,12832.33,13658.25,2720.08,224130,196540,9911,153988,163899,32641,2022,'ITATIRA',Itatira,'CE',2306603,6824.0,6824,568.7,568.7,2,595.0,595.0,Pequeno I
979,982,230670,15297,12076,419,9377,9796,2280,15176.58,12234.92,418.5,9466.08,9884.58,2350.33,182119,146819,5022,113593,118615,28204,2022,'JAGUARETAMA',Jaguaretama,'CE',2306702,9570.0,9570,797.5,797.5,2,605.0,605.0,Pequeno I
980,983,230680,8030,7006,329,4874,5203,1803,7833.58,6944.92,350.92,4890.25,5241.17,1703.75,94003,83339,4211,58683,62894,20445,2022,'JAGUARIBARA',Jaguaribara,'CE',2306801,2812.0,2812,234.3,234.3,1,239.0,239.0,Pequeno I
981,984,230690,22213,19614,1565,12237,13802,5812,21883.25,19578.0,1439.08,12510.08,13949.17,5628.83,262599,234936,17269,150121,167390,67546,2022,'JAGUARIBE',Jaguaribe,'CE',2306900,7439.0,7439,619.9,619.9,2,371.0,371.0,Pequeno II
982,985,230700,27981,23324,1034,17448,18482,4842,27655.17,23389.08,1123.92,17325.42,18449.33,4939.75,331862,280669,13487,207905,221392,59277,2022,'JAGUARUANA',Jaguaruana,'CE',2307007,1608.0,1608,134.0,134.0,1,282.0,282.0,Pequeno II
983,986,230710,22702,20586,1999,13352,15351,5235,22544.17,20592.42,1898.83,13876.42,15775.25,4817.17,270530,247109,22786,166517,189303,57806,2022,'JARDIM',Jardim,'CE',2307106,2651.0,2651,220.9,220.9,2,244.0,244.0,Pequeno II
984,987,230720,6063,5334,385,3463,3848,1486,5986.0,5296.58,363.33,3557.08,3920.42,1376.17,71832,63559,4360,42685,47045,16514,2022,'JATI',Jati,'CE',2307205,2952.0,2952,246.0,246.0,1,435.0,435.0,Pequeno I
985,988,230725,14697,13675,1156,9008,10164,3511,13923.58,13025.83,1174.25,8588.33,9762.58,3263.25,167083,156310,14091,103060,117151,39159,2022,'JIJOCA DE JERICOACOARA',Jijoca de Jericoacoara,'CE',2307254,9176.0,9176,764.7,764.7,2,381.0,381.0,Pequeno I
986,989,230730,174581,152053,33113,63353,96466,55587,167732.67,146940.08,32375.92,59145.75,91521.67,55418.42,2012792,1763281,388511,709749,1098260,665021,2022,'JUAZEIRO DO NORTE',Juazeiro do Norte,'CE',2307304,48002.0,48002,4000.2,4000.2,10,5662.0,5662.0,Grande
987,990,230740,18084,16172,505,12653,13158,3014,17880.5,16123.33,543.33,12746.08,13289.42,2833.92,214566,193480,6520,152953,159473,34007,2022,'JUCAS',Jucás,'CE',2307403,4026.0,4026,335.5,335.5,2,198.0,198.0,Pequeno II
988,991,230750,23983,20866,480,16320,16800,4066,23565.83,20811.58,565.92,16243.83,16809.75,4001.83,282790,249739,6791,194926,201717,48022,2022,'LAVRAS DA MANGABEIRA',Lavras da Mangabeira,'CE',2307502,5590.0,5590,465.8,465.8,3,458.0,458.0,Pequeno II
989,992,230760,32869,29971,1524,22058,23582,6389,31694.33,29054.08,1482.92,21525.17,23008.08,6046.0,380332,348649,17795,258302,276097,72552,2022,'LIMOEIRO DO NORTE',Limoeiro do Norte,'CE',2307601,10736.0,10736,894.7,894.7,2,861.0,861.0,Médio
990,993,230763,13917,12147,378,9304,9682,2465,13882.08,12221.08,430.75,9446.5,9877.25,2343.83,166585,146653,5169,113358,118527,28126,2022,'MADALENA',Madalena,'CE',2307635,5061.0,11967,421.8,997.2,1,688.0,688.0,Pequeno I
991,994,230765,131093,118146,13127,72239,85366,32780,122114.58,110033.75,13216.58,65017.83,78234.42,31799.33,1465375,1320405,158599,780214,938813,381592,2022,'MARACANAU',Maracanaú,'CE',2307650,83702.0,83702,6975.2,6975.2,11,9350.0,9350.0,Grande
992,995,230770,71479,64782,4396,48800,53196,11586,68932.0,62760.42,4503.25,46765.17,51268.42,11492.0,827184,753125,54039,561182,615221,137904,2022,'MARANGUAPE',Maranguape,'CE',2307700,65505.0,65505,5458.8,5458.8,6,3560.0,3560.0,Grande
993,996,230780,24344,22394,2881,13657,16538,5856,23778.33,22071.67,2797.58,13547.25,16344.83,5726.83,285340,264860,33571,162567,196138,68722,2022,'MARCO',Marco,'CE',2307809,8650.0,8650,720.8,720.8,2,509.0,509.0,Pequeno II
994,997,230790,9323,8652,428,6527,6955,1697,9114.25,8527.83,454.17,6375.42,6829.58,1698.25,109371,102334,5450,76505,81955,20379,2022,'MARTINOPOLE',Martinópole,'CE',2307908,656.0,656,54.7,54.7,1,56.0,56.0,Pequeno I
995,998,230800,29117,26359,3378,15168,18546,7813,28242.08,25806.25,3381.75,14895.75,18277.5,7528.75,338905,309675,40581,178749,219330,90345,2022,'MASSAPE',Massapê,'CE',2308005,11478.0,11478,956.5,956.5,2,768.0,768.0,Pequeno II
996,999,230810,34936,32402,1734,24397,26131,6271,34512.67,32298.5,1685.67,24645.5,26331.17,5967.33,414152,387582,20228,295746,315974,71608,2022,'MAURITI',Mauriti,'CE',2308104,8889.0,8889,740.8,740.8,3,401.0,401.0,Pequeno II
997,1000,230820,12247,10694,1258,6276,7534,3160,11985.92,10549.42,1162.5,6295.67,7458.17,3091.25,143831,126593,13950,75548,89498,37095,2022,'MERUOCA',Meruoca,'CE',2308203,4102.0,4102,341.8,341.8,2,504.0,504.0,Pequeno I
998,1001,230830,22062,19649,734,15292,16026,3623,21711.75,19542.5,655.08,15534.17,16189.25,3353.25,260541,234510,7861,186410,194271,40239,2022,'MILAGRES',Milagres,'CE',2308302,3211.0,3211,267.6,267.6,3,135.0,135.0,Pequeno II
999,1002,230835,10574,8861,281,7107,7388,1473,10429.08,8835.5,298.83,7010.42,7309.25,1526.25,125149,106026,3586,84125,87711,18315,2022,'MILHA',Milhã,'CE',2308351,799.0,799,66.6,66.6,1,24.0,24.0,Pequeno I
1000,1003,230837,10638,9858,288,8301,8589,1269,10197.0,9510.92,341.67,7809.67,8151.33,1359.58,122364,114131,4100,93716,97816,16315,2022,'MIRAIMA',Miraíma,'CE',2308377,3709.0,3709,309.1,309.1,1,461.0,461.0,Pequeno I
1001,1004,230840,30047,27179,2204,19629,21833,5346,29371.67,26787.0,2169.17,19629.0,21798.17,4988.83,352460,321444,26030,235548,261578,59866,2022,'MISSAO VELHA',Missão Velha,'CE',2308401,2965.0,2965,247.1,247.1,3,126.0,126.0,Pequeno II
1002,1005,230850,30197,26706,1444,19605,21049,5657,29669.42,26387.33,1396.08,19481.67,20877.75,5509.58,356033,316648,16753,233780,250533,66115,2022,'MOMBACA',Mombaça,'CE',2308500,6255.0,6255,521.2,521.2,2,874.0,874.0,Pequeno II
1003,1006,230860,14883,13106,368,11462,11830,1276,14536.25,12946.25,245.42,11380.58,11626.0,1320.25,174435,155355,2945,136567,139512,15843,2022,'MONSENHOR TABOSA',Monsenhor Tabosa,'CE',2308609,2225.0,2225,185.4,185.4,1,252.0,252.0,Pequeno I
1004,1007,230870,44382,39362,1479,31573,33052,6310,42796.58,38333.25,1578.17,30672.58,32250.75,6082.5,513559,459999,18938,368071,387009,72990,2022,'MORADA NOVA',Morada Nova,'CE',2308708,7862.0,7862,655.2,655.2,2,331.0,331.0,Médio
1005,1008,230880,6506,6120,309,4589,4898,1222,6477.17,6150.58,288.17,4676.42,4964.58,1186.0,77726,73807,3458,56117,59575,14232,2022,'MORAUJO',Moraújo,'CE',2308807,1819.0,1819,151.6,151.6,1,183.0,183.0,Pequeno I
1006,1009,230890,15305,14312,799,10390,11189,3123,14955.42,14062.58,880.33,10284.5,11164.83,2897.75,179465,168751,10564,123414,133978,34773,2022,'MORRINHOS',Morrinhos,'CE',2308906,3160.0,3160,263.3,263.3,2,182.0,182.0,Pequeno II
1007,1010,230900,9863,8624,454,6015,6469,2155,9573.5,8527.08,485.08,5939.58,6424.67,2102.42,114882,102325,5821,71275,77096,25229,2022,'MUCAMBO',Mucambo,'CE',2309003,3848.0,4869,320.7,405.8,1,630.0,630.0,Pequeno I
1008,1011,230910,9218,7846,256,6417,6673,1173,8998.33,7787.92,258.67,6328.67,6587.33,1200.58,107980,93455,3104,75944,79048,14407,2022,'MULUNGU',Mulungu,'CE',2309102,933.0,933,77.8,77.8,1,29.0,29.0,Pequeno I
1009,1012,230920,14060,12117,417,9028,9445,2672,13891.42,12233.75,434.42,9211.75,9646.17,2587.58,166697,146805,5213,110541,115754,31051,2022,'NOVA OLINDA',Nova Olinda,'CE',2309201,929.0,929,77.4,77.4,1,30.0,30.0,Pequeno I
1010,1013,230930,20777,18126,1044,12288,13332,4794,20278.67,17836.67,927.92,12214.5,13142.42,4694.25,243344,214040,11135,146574,157709,56331,2022,'NOVA RUSSAS',Nova Russas,'CE',2309300,13910.0,13910,1159.2,1159.2,1,1648.0,1648.0,Pequeno II
1011,1014,230940,22027,20007,449,16960,17409,2598,21635.08,19807.92,423.33,16806.83,17230.17,2577.75,259621,237695,5080,201682,206762,30933,2022,'NOVO ORIENTE',Novo Oriente,'CE',2309409,2845.0,2845,237.1,237.1,1,113.0,113.0,Pequeno II
1012,1015,230945,19850,17608,999,12338,13337,4271,19534.5,17514.75,995.33,12331.58,13326.92,4187.83,234414,210177,11944,147979,159923,50254,2022,'OCARA',Ocara,'CE',2309458,10711.0,10711,892.6,892.6,3,503.0,503.0,Pequeno II
1013,1016,230950,16641,15407,334,13098,13432,1975,16332.0,15203.58,321.25,13029.08,13350.33,1853.25,195984,182443,3855,156349,160204,22239,2022,'OROS',Orós,'CE',2309508,2145.0,2145,178.8,178.8,2,124.0,124.0,Pequeno II
1014,1017,230960,40740,36530,5914,18049,23963,12567,40264.33,36589.08,5791.08,18557.92,24349.0,12240.08,483172,439069,69493,222695,292188,146881,2022,'PACAJUS',Pacajus,'CE',2309607,21939.0,21939,1828.2,1828.2,3,1678.0,1678.0,Médio
1015,1018,230970,44681,40151,4094,25710,29804,10347,42389.83,38429.5,3803.42,25066.67,28870.08,9559.42,508678,461154,45641,300800,346441,114713,2022,'PACATUBA',Pacatuba,'CE',2309706,38288.0,38288,3190.7,3190.7,3,3191.0,3191.0,Médio
1016,1019,230980,9131,8188,720,5974,6694,1494,8666.92,7885.17,729.75,5602.42,6332.17,1553.0,104003,94622,8757,67229,75986,18636,2022,'PACOTI',Pacoti,'CE',2309805,1961.0,1961,163.4,163.4,1,197.0,197.0,Pequeno I
1017,1020,230990,5096,4430,243,3075,3318,1112,4966.33,4335.0,263.58,2981.42,3245.0,1090.0,59596,52020,3163,35777,38940,13080,2022,'PACUJA',Pacujá,'CE',2309904,2489.0,2489,207.4,207.4,1,134.0,134.0,Pequeno I
1018,1021,231000,7655,6302,215,4593,4808,1494,7397.58,6211.5,232.25,4490.92,4723.17,1488.33,88771,74538,2787,53891,56678,17860,2022,'PALHANO',Palhano,'CE',2310001,1204.0,1204,100.3,100.3,1,59.0,59.0,Pequeno I
1019,1022,231010,8965,7320,121,6295,6416,904,8908.5,7426.33,104.33,6454.67,6559.0,867.33,106902,89116,1252,77456,78708,10408,2022,'PALMACIA',Palmácia,'CE',2310100,1616.0,1616,134.7,134.7,1,56.0,56.0,Pequeno I
1020,1023,231020,27737,25528,3692,15949,19641,5887,26998.08,24976.25,3266.42,16111.0,19377.42,5598.83,323977,299715,39197,193332,232529,67186,2022,'PARACURU',Paracuru,'CE',2310209,4854.0,4854,404.5,404.5,2,405.0,405.0,Pequeno II
1021,1024,231025,23576,21742,1391,16819,18210,3532,22272.75,20565.92,1368.25,15821.42,17189.67,3376.25,267273,246791,16419,189857,206276,40515,2022,'PARAIPABA',Paraipaba,'CE',2310258,968.0,968,80.7,80.7,1,89.0,89.0,Pequeno II
1022,1025,231030,23382,19121,2441,11062,13503,5618,23023.0,19190.92,2487.92,10976.33,13464.25,5726.67,276276,230291,29855,131716,161571,68720,2022,'PARAMBU',Parambu,'CE',2310308,5464.0,5464,455.3,455.3,2,395.0,395.0,Pequeno II
1023,1026,231040,8852,7877,245,6354,6599,1278,8742.67,7879.25,255.83,6318.25,6574.08,1305.17,104912,94551,3070,75819,78889,15662,2022,'PARAMOTI',Paramoti,'CE',2310407,745.0,745,62.1,62.1,1,21.0,21.0,Pequeno I
1024,1027,231050,32599,27672,1226,21300,22526,5146,31772.5,27535.08,1308.75,20901.33,22210.08,5325.0,381270,330421,15705,250816,266521,63900,2022,'PEDRA BRANCA',Pedra Branca,'CE',2310506,6958.0,9088,579.8,757.3,2,119.0,2249.0,Pequeno II
1025,1028,231060,8539,7913,344,6295,6639,1274,8402.17,7835.08,292.92,6326.5,6619.42,1215.67,100826,94021,3515,75918,79433,14588,2022,'PENAFORTE',Penaforte,'CE',2310605,758.0,1787,63.2,148.9,1,0.0,1029.0,Pequeno I
1026,1029,231070,25125,22703,2029,15175,17204,5499,24484.83,22256.25,1940.83,15075.33,17016.17,5240.08,293818,267075,23290,180904,204194,62881,2022,'PENTECOSTE',Pentecoste,'CE',2310704,11453.0,11453,954.4,954.4,2,1041.0,1041.0,Pequeno II
1027,1030,231080,11709,10322,654,7131,7785,2537,11579.75,10347.67,664.33,7399.42,8063.75,2283.92,138957,124172,7972,88793,96765,27407,2022,'PEREIRO',Pereiro,'CE',2310803,2327.0,2327,193.9,193.9,1,172.0,172.0,Pequeno I
1028,1031,231085,18910,16699,564,12948,13512,3187,18127.5,16199.92,538.08,12880.83,13418.92,2781.0,217530,194399,6457,154570,161027,33372,2022,'PINDORETAMA',Pindoretama,'CE',2310852,0.0,22499,0.0,1874.9,1,0.0,1087.0,Pequeno I
1029,1032,231090,12196,9587,437,6429,6866,2721,12177.58,9702.83,465.33,6498.5,6963.83,2739.0,146131,116434,5584,77982,83566,32868,2022,'PIQUET CARNEIRO',Piquet Carneiro,'CE',2310902,3791.0,3791,315.9,315.9,1,296.0,296.0,Pequeno I
1030,1033,231095,7230,6008,556,3921,4477,1531,7043.08,5975.83,562.58,3923.92,4486.5,1489.33,84517,71710,6751,47087,53838,17872,2022,'PIRES FERREIRA',Pires Ferreira,'CE',2310951,2936.0,2936,244.7,244.7,1,78.0,78.0,Pequeno I
1031,1034,231100,9157,8007,453,5882,6335,1672,9362.67,8234.17,450.67,6080.08,6530.75,1703.42,112352,98810,5408,72961,78369,20441,2022,'PORANGA',Poranga,'CE',2311009,5122.0,5122,426.8,426.8,1,354.0,354.0,Pequeno I
1032,1035,231110,11672,10996,1056,7394,8450,2546,11389.0,10781.58,886.08,7518.58,8404.67,2376.92,136668,129379,10633,90223,100856,28523,2022,'PORTEIRAS',Porteiras,'CE',2311108,8524.0,8524,710.3,710.3,3,1002.0,1002.0,Pequeno I
1033,1036,231120,7293,6500,299,4742,5041,1459,7183.33,6442.5,321.17,4716.58,5037.75,1404.75,86200,77310,3854,56599,60453,16857,2022,'POTENGI',Potengi,'CE',2311207,1411.0,1411,117.6,117.6,1,40.0,40.0,Pequeno I
1034,1037,231123,5440,4494,274,3162,3436,1058,5296.5,4511.0,260.67,3172.08,3432.75,1078.25,63558,54132,3128,38065,41193,12939,2022,'POTIRETAMA',Potiretama,'CE',2311231,7174.0,7174,597.8,597.8,1,125.0,125.0,Pequeno I
1035,1038,231126,16252,13809,759,10087,10846,2963,15939.75,13783.42,751.67,10006.25,10757.92,3025.5,191277,165401,9020,120075,129095,36306,2022,'QUITERIANOPOLIS',Quiterianópolis,'CE',2311264,5217.0,5217,434.8,434.8,1,292.0,292.0,Pequeno I
1036,1039,231130,62304,55997,3538,42028,45566,10431,59713.92,54151.92,3639.33,40439.67,44079.0,10072.92,716567,649823,43672,485276,528948,120875,2022,'QUIXADA',Quixadá,'CE',2311306,37041.0,39905,3086.8,3325.4,4,4224.0,4224.0,Médio
1037,1040,231135,12647,10993,472,7849,8321,2672,12411.75,10863.25,539.75,7667.75,8207.5,2655.75,148941,130359,6477,92013,98490,31869,2022,'QUIXELO',Quixelô,'CE',2311355,1565.0,1565,130.4,130.4,1,108.0,108.0,Pequeno I
1038,1041,231140,51431,44965,2535,32176,34711,10254,49804.92,43794.83,2628.08,31125.25,33753.33,10041.5,597659,525538,31537,373503,405040,120498,2022,'QUIXERAMOBIM',Quixeramobim,'CE',2311405,10839.0,10839,903.2,903.2,3,912.0,912.0,Médio
1039,1042,231150,17384,13379,2258,4939,7197,6182,17149.75,13506.0,2120.83,5403.08,7523.92,5982.08,205797,162072,25450,64837,90287,71785,2022,'QUIXERE',Quixeré,'CE',2311504,2757.0,2757,229.8,229.8,2,160.0,160.0,Pequeno I
1040,1043,231160,21687,19955,1979,13090,15069,4886,21063.17,19504.17,1950.33,12533.25,14483.58,5020.58,252758,234050,23404,150399,173803,60247,2022,'REDENCAO',Redenção,'CE',2311603,8261.0,8261,688.4,688.4,2,733.0,733.0,Pequeno II
1041,1044,231170,14271,12447,852,8571,9423,3024,13963.5,12303.5,835.25,8469.25,9304.5,2999.0,167562,147642,10023,101631,111654,35988,2022,'RERIUTABA',Reriutaba,'CE',2311702,6205.0,6205,517.1,517.1,2,422.0,422.0,Pequeno I
1042,1045,231180,46748,39835,6121,20567,26688,13147,44588.42,38359.5,6389.42,19081.58,25471.0,12888.5,535061,460314,76673,228979,305652,154662,2022,'RUSSAS',Russas,'CE',2311801,34648.0,34648,2887.3,2887.3,3,2574.0,2574.0,Médio
1043,1046,231190,12230,10288,333,7668,8001,2287,11962.5,10225.17,347.67,7679.42,8027.08,2198.08,143550,122702,4172,92153,96325,26377,2022,'SABOEIRO',Saboeiro,'CE',2311900,1437.0,1437,119.8,119.8,1,182.0,182.0,Pequeno I
1044,1047,231195,16157,14022,995,9906,10901,3121,15903.17,13931.17,986.25,10019.17,11005.42,2925.75,190838,167174,11835,120230,132065,35109,2022,'SALITRE',Salitre,'CE',2311959,1264.0,1264,105.3,105.3,2,33.0,33.0,Pequeno I
1045,1048,231200,25183,22543,647,18317,18964,3579,24932.08,22584.08,765.33,18071.25,18836.58,3747.5,299185,271009,9184,216855,226039,44970,2022,'SANTANA DO ACARAU',Santana do Acaraú,'CE',2312007,12067.0,12067,1005.6,1005.6,2,367.0,367.0,Pequeno II
1046,1049,231210,14973,13349,573,10336,10909,2440,14791.75,13332.5,615.0,10221.25,10836.25,2496.25,177501,159990,7380,122655,130035,29955,2022,'SANTANA DO CARIRI',Santana do Cariri,'CE',2312106,1640.0,1640,136.7,136.7,1,113.0,113.0,Pequeno I
1047,1050,231220,35108,29001,1348,20816,22164,6837,34384.0,28821.08,1323.92,20793.5,22117.42,6703.67,412608,345853,15887,249522,265409,80444,2022,'SANTA QUITERIA',Santa Quitéria,'CE',2312205,18126.0,18126,1510.5,1510.5,3,861.0,861.0,Pequeno II
1048,1051,231230,33607,30933,2415,22595,25010,5923,31938.08,29589.17,2380.25,21813.33,24193.58,5395.58,383257,355070,28563,261760,290323,64747,2022,'SAO BENEDITO',São Benedito,'CE',2312304,18720.0,18720,1560.0,1560.0,2,786.0,786.0,Pequeno II
1049,1052,231240,38320,34958,4575,21386,25961,8997,36824.08,33908.0,4444.17,21263.33,25707.5,8200.5,441889,406896,53330,255160,308490,98406,2022,'SAO GONCALO DO AMARANTE',São Gonçalo do Amarante,'CE',2312403,14001.0,14001,1166.8,1166.8,2,1120.0,1120.0,Pequeno II
1050,1053,231250,5508,3795,155,2474,2629,1166,5504.83,3871.25,207.83,2385.5,2593.33,1277.92,66058,46455,2494,28626,31120,15335,2022,'SAO JOAO DO JAGUARIBE',São João do Jaguaribe,'CE',2312502,1344.0,1344,112.0,112.0,1,86.0,86.0,Pequeno I
1051,1054,231260,9588,8599,750,5962,6712,1887,9393.58,8566.33,727.42,6046.0,6773.42,1792.92,112723,102796,8729,72552,81281,21515,2022,'SAO LUIS DO CURU',São Luís do Curu,'CE',2312601,1974.0,1974,164.5,164.5,1,81.0,81.0,Pequeno I
1052,1055,231270,17653,15237,543,11124,11667,3570,17447.67,15211.75,575.42,11191.33,11766.75,3445.0,209372,182541,6905,134296,141201,41340,2022,'SENADOR POMPEU',Senador Pompeu,'CE',2312700,3432.0,3432,286.0,286.0,2,125.0,125.0,Pequeno II
1053,1056,231280,5901,5377,486,3682,4168,1209,5729.08,5309.42,422.5,3717.58,4140.08,1169.33,68749,63713,5070,44611,49681,14032,2022,'SENADOR SA',Senador sá,'CE',2312809,2541.0,3946,211.8,328.8,1,280.0,280.0,Pequeno I
1054,1057,231290,119146,105857,14365,54063,68428,37429,117174.75,104671.25,14498.25,53779.92,68278.17,36393.08,1406097,1256055,173979,645359,819338,436717,2022,'SOBRAL',Sobral,'CE',2312908,47399.0,47399,3949.9,3949.9,6,5700.0,5700.0,Grande
1055,1058,231300,12285,10065,539,6677,7216,2849,12049.92,10063.67,461.08,6771.33,7232.42,2831.25,144599,120764,5533,81256,86789,33975,2022,'SOLONOPOLE',Solonópole,'CE',2313005,2638.0,2638,219.8,219.8,1,111.0,111.0,Pequeno I
1056,1059,231310,21747,18128,1470,12735,14205,3923,20797.92,17591.42,1430.0,12127.58,13557.58,4033.83,249575,211097,17160,145531,162691,48406,2022,'TABULEIRO DO NORTE',Tabuleiro do Norte,'CE',2313104,9294.0,9294,774.5,774.5,2,453.0,453.0,Pequeno II
1057,1060,231320,21226,17708,462,13642,14104,3604,21286.5,17994.75,457.08,13931.83,14388.92,3605.83,255438,215937,5485,167182,172667,43270,2022,'TAMBORIL',Tamboril,'CE',2313203,5961.0,5961,496.8,496.8,2,1032.0,1032.0,Pequeno II
1058,1061,231325,6760,5737,276,4106,4382,1355,6695.58,5831.5,316.83,4219.25,4536.08,1295.42,80347,69978,3802,50631,54433,15545,2022,'TARRAFAS',Tarrafas,'CE',2313252,1657.0,1657,138.1,138.1,1,240.0,240.0,Pequeno I
1059,1062,231330,33596,29329,3630,18863,22493,6836,31806.42,28080.5,3730.5,17605.92,21336.42,6744.08,381677,336966,44766,211271,256037,80929,2022,'TAUA',Tauá,'CE',2313302,11114.0,11114,926.2,926.2,8,1010.0,1010.0,Médio
1060,1063,231335,15807,14057,483,11784,12267,1790,15539.08,13918.67,446.25,11799.67,12245.92,1672.75,186469,167024,5355,141596,146951,20073,2022,'TEJUCUOCA',Tejuçuoca,'CE',2313351,3136.0,3136,261.3,261.3,1,265.0,265.0,Pequeno I
1061,1064,231340,61056,57006,4321,42957,47278,9728,59348.5,55705.33,4047.83,42450.25,46498.08,9207.25,712182,668464,48574,509403,557977,110487,2022,'TIANGUA',Tianguá,'CE',2313401,14681.0,14681,1223.4,1223.4,3,1358.0,1358.0,Médio
1062,1065,231350,46589,43935,942,38848,39790,4145,45559.83,43206.92,965.75,38459.42,39425.17,3781.75,546718,518483,11589,461513,473102,45381,2022,'TRAIRI',Trairi,'CE',2313500,21264.0,21264,1772.0,1772.0,3,1000.0,1000.0,Médio
1063,1066,231355,13750,12596,662,9637,10299,2297,13615.58,12614.17,658.92,9834.25,10493.17,2121.0,163387,151370,7907,118011,125918,25452,2022,'TURURU',Tururu,'CE',2313559,2209.0,2209,184.1,184.1,1,136.0,136.0,Pequeno I
1064,1067,231360,25574,23316,1303,18035,19338,3978,24899.5,22867.92,1184.08,17866.33,19050.42,3817.5,298794,274415,14209,214396,228605,45810,2022,'UBAJARA',Ubajara,'CE',2313609,9065.0,9065,755.4,755.4,2,1334.0,1334.0,Pequeno II
1065,1068,231370,6141,5219,126,3939,4065,1154,6152.17,5306.33,137.33,4011.67,4149.0,1157.33,73826,63676,1648,48140,49788,13888,2022,'UMARI',Umari,'CE',2313708,2686.0,2686,223.8,223.8,1,225.0,225.0,Pequeno I
1066,1069,231375,13421,12471,497,9999,10496,1975,13377.33,12578.33,462.42,10330.5,10792.92,1785.42,160528,150940,5549,123966,129515,21425,2022,'UMIRIM',Umirim,'CE',2313757,1451.0,1451,120.9,120.9,2,56.0,56.0,Pequeno I
1067,1070,231380,16771,15567,421,12891,13312,2255,16593.25,15585.5,472.5,12978.58,13451.08,2134.42,199119,187026,5670,155743,161413,25613,2022,'URUBURETAMA',Uruburetama,'CE',2313807,2209.0,2209,184.1,184.1,1,187.0,187.0,Pequeno I
1068,1071,231390,10643,9860,469,7160,7629,2231,10413.25,9720.33,479.25,7072.83,7552.08,2168.25,124959,116644,5751,84874,90625,26019,2022,'URUOCA',Uruoca,'CE',2313906,5515.0,5515,459.6,459.6,2,398.0,398.0,Pequeno I
1069,1072,231395,13341,11932,835,8176,9011,2921,12878.33,11627.67,821.67,7958.08,8779.75,2847.92,154540,139532,9860,95497,105357,34175,2022,'VARJOTA',Varjota,'CE',2313955,1413.0,1413,117.8,117.8,1,63.0,63.0,Pequeno I
1070,1073,231400,29850,26227,1154,19520,20674,5553,29411.42,26101.0,1258.42,19510.75,20769.17,5331.83,352937,313212,15101,234129,249230,63982,2022,'VARZEA ALEGRE',Várzea Alegre,'CE',2314003,9360.0,9360,780.0,780.0,2,559.0,559.0,Pequeno II
1071,1074,231410,49582,46572,2175,38423,40598,5974,48100.17,45565.17,2320.5,37193.42,39513.92,6051.25,577202,546782,27846,446321,474167,72615,2022,'VICOSA DO CEARA',Viçosa do Ceará,'CE',2314102,6502.0,6502,541.8,541.8,4,222.0,222.0,Médio
1072,1075,240010,7262,6052,931,2907,3838,2214,7141.25,6037.75,856.25,3059.75,3916.0,2121.75,85695,72453,10275,36717,46992,25461,2022,'ACARI',Acari,'RN',2400109,1034.0,1034,86.2,86.2,1,60.0,60.0,Pequeno I
1073,1076,240020,40361,35428,2498,23945,26443,8985,38663.83,34301.42,2483.67,22898.75,25382.42,8919.0,463966,411617,29804,274785,304589,107028,2022,'ASSU',Açu,'RN',2400208,4471.0,4471,372.6,372.6,2,283.0,283.0,Médio
1074,1077,240030,8748,8097,257,7061,7318,779,8293.83,7702.5,277.17,6691.75,6968.92,733.58,99526,92430,3326,80301,83627,8803,2022,'AFONSO BEZERRA',Afonso Bezerra,'RN',2400307,443.0,443,36.9,36.9,1,22.0,22.0,Pequeno I
1075,1078,240040,2454,2158,68,1370,1438,720,2452.33,2178.67,85.75,1398.25,1484.0,694.67,29428,26144,1029,16779,17808,8336,2022,'AGUA NOVA',Água Nova,'RN',2400406,226.0,226,18.8,18.8,1,6.0,6.0,Pequeno I
1076,1079,240050,9889,8272,187,6183,6370,1902,9611.42,8143.75,184.5,6084.92,6269.42,1874.33,115337,97725,2214,73019,75233,22492,2022,'ALEXANDRIA',Alexandria,'RN',2400505,790.0,790,65.8,65.8,1,24.0,24.0,Pequeno I
1077,1080,240060,4151,3459,123,2659,2782,677,4034.83,3434.92,119.58,2645.08,2764.67,670.25,48418,41219,1435,31741,33176,8043,2022,'ALMINO AFONSO',Almino Afonso,'RN',2400604,749.0,749,62.4,62.4,1,46.0,46.0,Pequeno I
1078,1081,240070,7846,7066,614,4751,5365,1701,7499.33,6811.33,557.17,4715.0,5272.17,1539.17,89992,81736,6686,56580,63266,18470,2022,'ALTO DO RODRIGUES',Alto do Rodrigues,'RN',2400703,755.0,755,62.9,62.9,1,25.0,25.0,Pequeno I
1079,1082,240080,8519,7197,372,4909,5281,1916,8327.83,7133.42,343.92,5053.17,5397.08,1736.33,99934,85601,4127,60638,64765,20836,2022,'ANGICOS',Angicos,'RN',2400802,1840.0,1840,153.3,153.3,1,95.0,95.0,Pequeno I
1080,1083,240090,5880,5081,88,4310,4398,683,5788.58,5031.58,67.67,4207.42,4275.08,756.5,69463,60379,812,50489,51301,9078,2022,'ANTONIO MARTINS',Antônio Martins,'RN',2400901,153.0,153,25.5,25.5,1,,,Pequeno I
1081,1084,240100,28079,23633,656,18253,18909,4724,27410.75,23300.25,698.5,17955.67,18654.17,4646.08,328929,279603,8382,215468,223850,55753,2022,'APODI',Apodi,'RN',2401008,1603.0,1603,133.6,133.6,2,93.0,93.0,Pequeno II
1082,1085,240110,14638,12780,581,9333,9914,2866,13962.5,12359.0,614.67,8994.75,9609.42,2749.58,167550,148308,7376,107937,115313,32995,2022,'AREIA BRANCA',Areia Branca,'RN',2401107,423.0,423,35.2,35.2,1,38.0,38.0,Pequeno II
1083,1086,240120,10284,9350,835,6457,7292,2058,10112.58,9268.42,797.75,6583.83,7381.58,1886.83,121351,111221,9573,79006,88579,22642,2022,'ARES',Arês,'RN',2401206,3967.0,3967,330.6,330.6,1,120.0,120.0,Pequeno I
1084,1087,240130,8427,7280,74,6536,6610,670,8238.67,7185.33,83.67,6416.83,6500.5,684.83,98864,86224,1004,77002,78006,8218,2022,'CAMPO GRANDE',Augusto Severo,'RN',2401305,209.0,209,17.4,17.4,1,17.0,17.0,Pequeno I
1085,1088,240140,5920,5258,676,3146,3822,1436,5763.17,5191.17,670.0,3220.58,3890.58,1300.58,69158,62294,8040,38647,46687,15607,2022,'BAIA FORMOSA',Baía Formosa,'RN',2401404,1806.0,6022,150.5,501.8,1,132.0,132.0,Pequeno I
1086,1089,240145,20888,18023,2091,11355,13446,4577,20136.33,17647.5,2112.83,11065.17,13178.0,4469.5,241636,211770,25354,132782,158136,53634,2022,'BARAUNA',Baraúna,'RN',2401453,2489.0,2489,207.4,207.4,1,121.0,121.0,Pequeno II
1087,1090,240150,3004,2609,160,1955,2115,494,2966.5,2639.42,168.67,1981.67,2150.33,489.08,35598,31673,2024,23780,25804,5869,2022,'BARCELONA',Barcelona,'RN',2401503,2533.0,2533,211.1,211.1,1,147.0,147.0,Pequeno I
1088,1091,240160,4547,3959,185,2775,2960,999,4535.08,4001.25,154.75,2907.08,3061.83,939.42,54421,48015,1857,34885,36742,11273,2022,'BENTO FERNANDES',Bento Fernandes,'RN',2401602,561.0,561,46.8,46.8,1,29.0,29.0,Pequeno I
1089,1092,240165,2804,2442,93,1951,2044,398,2756.42,2424.0,95.67,1959.5,2055.17,368.83,33077,29088,1148,23514,24662,4426,2022,'BODO',Bodó,'RN',2401651,715.0,715,59.6,59.6,1,60.0,60.0,Pequeno I
1090,1093,240170,7927,6981,701,4501,5202,1779,7701.25,6837.83,736.67,4429.5,5166.17,1671.67,92415,82054,8840,53154,61994,20060,2022,'BOM JESUS',Bom Jesus,'RN',2401701,717.0,717,59.8,59.8,1,51.0,51.0,Pequeno I
1091,1094,240180,9718,8260,1732,3883,5615,2645,9562.83,8196.58,1731.92,3889.92,5621.83,2574.75,114754,98359,20783,46679,67462,30897,2022,'BREJINHO',Brejinho,'RN',2401800,2517.0,2517,209.8,209.8,2,57.0,57.0,Pequeno I
1092,1095,240185,4449,4141,179,3114,3293,848,4268.67,4017.83,185.17,3116.17,3301.33,716.5,51224,48214,2222,37394,39616,8598,2022,'CAICARA DO NORTE',Caiçara do Norte,'RN',2401859,971.0,971,80.9,80.9,1,69.0,69.0,Pequeno I
1093,1096,240190,3310,2924,106,2292,2398,526,3243.17,2934.08,98.25,2404.17,2502.42,431.67,38918,35209,1179,28850,30029,5180,2022,'CAICARA DO RIO DO VENTO',Caiçara do Rio do Vento,'RN',2401909,2739.0,4937,249.0,448.8,1,293.0,293.0,Pequeno I
1094,1097,240200,33928,28997,3386,17095,20481,8516,32017.75,27641.75,3154.92,16299.83,19454.75,8187.0,384213,331701,37859,195598,233457,98244,2022,'CAICO',Caicó,'RN',2402006,6861.0,6861,571.8,571.8,2,167.0,167.0,Médio
1095,1098,240210,8614,7462,144,6219,6363,1099,8489.33,7388.58,164.25,6142.25,6306.5,1082.08,101872,88663,1971,73707,75678,12985,2022,'CAMPO REDONDO',Campo Redondo,'RN',2402105,534.0,534,59.3,59.3,1,19.0,19.0,Pequeno I
1096,1099,240220,23691,22133,1761,16521,18282,3851,23415.5,22013.5,1667.17,16867.08,18534.25,3479.25,280986,264162,20006,202405,222411,41751,2022,'CANGUARETAMA',Canguaretama,'RN',2402204,4759.0,4759,396.6,396.6,2,396.0,396.0,Pequeno II
1097,1100,240230,15899,13427,619,9938,10557,2870,15635.33,13368.83,594.17,10138.67,10732.83,2636.0,187624,160426,7130,121664,128794,31632,2022,'CARAUBAS',Caraúbas,'RN',2402303,11468.0,17789,955.7,1482.4,2,708.0,708.0,Pequeno I
1098,1101,240240,5604,4149,586,1260,1846,2303,5481.42,4072.67,520.67,1246.83,1767.5,2305.17,65777,48872,6248,14962,21210,27662,2022,'CARNAUBA DOS DANTAS',Carnaúba Dos Dantas,'RN',2402402,418.0,418,38.0,38.0,1,34.0,34.0,Pequeno I
1099,1102,240250,8356,7570,203,6099,6302,1268,8283.08,7590.08,209.25,6313.83,6523.08,1067.0,99397,91081,2511,75766,78277,12804,2022,'CARNAUBAIS',Carnaubais,'RN',2402501,1081.0,1081,90.1,90.1,1,123.0,123.0,Pequeno I
1100,1103,240260,50076,45705,12832,21240,34072,11633,46479.08,42692.08,11362.83,21212.5,32575.33,10116.75,557749,512305,136354,254550,390904,121401,2022,'CEARA-MIRIM',Ceará-mirim,'RN',2402600,3975.0,3975,331.2,331.2,2,126.0,126.0,Médio
1101,1104,240270,7615,6736,328,4754,5082,1654,7430.25,6716.17,347.25,4935.42,5282.67,1433.5,89163,80594,4167,59225,63392,17202,2022,'CERRO CORA',Cerro Corá,'RN',2402709,1194.0,1194,99.5,99.5,1,66.0,66.0,Pequeno I
1102,1105,240280,4542,3995,153,3087,3240,755,4499.75,3984.42,172.33,3089.0,3261.33,723.08,53997,47813,2068,37068,39136,8677,2022,'CORONEL EZEQUIEL',Coronel Ezequiel,'RN',2402808,454.0,454,45.4,45.4,1,,,Pequeno I
1103,1106,240290,3585,3038,131,1883,2014,1024,3554.58,3045.17,143.5,1966.58,2110.08,935.08,42655,36542,1722,23599,25321,11221,2022,'CORONEL JOAO PESSOA',Coronel João Pessoa,'RN',2402907,138.0,138,12.5,12.5,1,14.0,14.0,Pequeno I
1104,1107,240300,6234,4984,262,3015,3277,1707,6164.83,4950.75,266.75,3009.58,3276.33,1674.42,73978,59409,3201,36115,39316,20093,2022,'CRUZETA',Cruzeta,'RN',2403004,298.0,298,24.8,24.8,1,19.0,19.0,Pequeno I
1105,1108,240310,24909,21064,2888,10473,13361,7703,24069.0,20595.0,2647.58,10604.5,13252.08,7342.92,288828,247140,31771,127254,159025,88115,2022,'CURRAIS NOVOS',Currais Novos,'RN',2403103,4333.0,4333,361.1,361.1,2,228.0,228.0,Pequeno II
1106,1109,240320,5686,4282,318,2750,3068,1214,5683.0,4398.67,283.42,2931.67,3215.08,1183.58,68196,52784,3401,35180,38581,14203,2022,'DOUTOR SEVERIANO',Doutor Severiano,'RN',2403202,2741.0,2741,228.4,228.4,1,127.0,127.0,Pequeno I
1107,1110,240325,103844,90736,12021,51993,64014,26722,95917.17,84196.25,11844.83,46255.67,58100.5,26095.75,1151006,1010355,142138,555068,697206,313149,2022,'PARNAMIRIM',Parnamirim,'RN',2403251,36064.0,36064,3005.3,3005.3,9,2980.0,2980.0,Grande
1108,1111,240330,5284,4422,248,2846,3094,1328,5196.92,4354.25,230.92,2885.83,3116.75,1237.5,62363,52251,2771,34630,37401,14850,2022,'ENCANTO',Encanto,'RN',2403301,446.0,446,37.2,37.2,1,26.0,26.0,Pequeno I
1109,1112,240340,4894,4176,145,3315,3460,716,4825.58,4172.42,129.0,3359.67,3488.67,683.75,57907,50069,1548,40316,41864,8205,2022,'EQUADOR',Equador,'RN',2403400,1223.0,1223,101.9,101.9,1,20.0,20.0,Pequeno I
1110,1113,240350,6212,5808,133,5262,5395,413,6116.5,5757.5,118.42,5262.92,5381.33,376.17,73398,69090,1421,63155,64576,4514,2022,'ESPIRITO SANTO',Espírito Santo,'RN',2403509,1167.0,1167,97.2,97.2,1,50.0,50.0,Pequeno I
1111,1114,240360,36011,33413,4985,21237,26222,7191,32319.92,30180.42,4110.08,19808.58,23918.67,6261.75,387839,362165,49321,237703,287024,75141,2022,'EXTREMOZ',Extremoz,'RN',2403608,2128.0,2128,177.3,177.3,1,110.0,110.0,Pequeno II
1112,1115,240370,5695,4613,252,3250,3502,1111,5586.33,4566.5,248.33,3177.83,3426.17,1140.33,67036,54798,2980,38134,41114,13684,2022,'FELIPE GUERRA',Felipe Guerra,'RN',2403707,384.0,384,32.0,32.0,1,50.0,50.0,Pequeno I
1113,1116,240375,2487,2118,135,1359,1494,624,2470.08,2160.92,113.67,1587.58,1701.25,459.67,29641,25931,1364,19051,20415,5516,2022,'FERNANDO PEDROZA',Fernando Pedroza,'RN',2403756,823.0,823,68.6,68.6,1,59.0,59.0,Pequeno I
1114,1117,240380,6929,5639,537,3201,3738,1901,6769.58,5537.5,519.08,3110.5,3629.58,1907.92,81235,66450,6229,37326,43555,22895,2022,'FLORANIA',Florânia,'RN',2403806,361.0,361,30.1,30.1,1,15.0,15.0,Pequeno I
1115,1118,240390,2599,1930,53,1178,1231,699,2591.25,1967.17,62.08,1197.92,1260.0,707.17,31095,23606,745,14375,15120,8486,2022,'FRANCISCO DANTAS',Francisco Dantas,'RN',2403905,309.0,309,25.8,25.8,1,10.0,10.0,Pequeno I
1116,1119,240400,3868,3135,150,2089,2239,896,3826.0,3146.08,145.58,2107.75,2253.33,892.75,45912,37753,1747,25293,27040,10713,2022,'FRUTUOSO GOMES',Frutuoso Gomes,'RN',2404002,284.0,284,23.7,23.7,1,3.0,3.0,Pequeno I
1117,1120,240410,1906,1631,214,844,1058,573,1852.33,1610.25,181.0,917.33,1098.33,511.92,22228,19323,2172,11008,13180,6143,2022,'GALINHOS',Galinhos,'RN',2404101,480.0,480,40.0,40.0,1,15.0,15.0,Pequeno I
1118,1121,240420,18172,16834,1729,11102,12831,4003,17362.42,16147.83,1785.42,10480.67,12266.08,3881.75,208349,193774,21425,125768,147193,46581,2022,'GOIANINHA',Goianinha,'RN',2404200,828.0,828,69.0,69.0,1,65.0,65.0,Pequeno II
1119,1122,240430,9640,8490,345,6318,6663,1827,9459.75,8348.33,389.33,6235.92,6625.25,1723.08,113517,100180,4672,74831,79503,20677,2022,'GOVERNADOR DIX-SEPT ROSADO,Governador Dix-sept Rosado,'RN',2404309,878.0,878,73.2,73.2,1,46.0,46.0,Pequeno I
1120,1123,240440,6747,6018,542,4509,5051,967,6486.92,5847.42,453.42,4467.75,4921.17,926.25,77843,70169,5441,53613,59054,11115,2022,'GROSSOS',Grossos,'RN',2404408,630.0,630,52.5,52.5,1,45.0,45.0,Pequeno I
1121,1124,240450,13010,10918,1021,6306,7327,3591,12846.83,10925.5,1113.92,6270.0,7383.92,3541.58,154162,131106,13367,75240,88607,42499,2022,'GUAMARE',Guamaré,'RN',2404507,10073.0,17792,839.4,1482.7,2,822.0,822.0,Pequeno I
1122,1125,240460,9713,9019,670,7189,7859,1160,9371.33,8737.33,651.75,7089.17,7740.92,996.42,112456,104848,7821,85070,92891,11957,2022,'IELMO MARINHO',Ielmo Marinho,'RN',2404606,1371.0,1371,124.6,124.6,1,180.0,180.0,Pequeno I
1123,1126,240470,11333,9349,1803,4554,6357,2992,11239.5,9330.0,1674.08,4702.67,6376.75,2953.25,134874,111960,20089,56432,76521,35439,2022,'IPANGUACU',Ipanguaçu,'RN',2404705,1447.0,1447,120.6,120.6,1,136.0,136.0,Pequeno I
1124,1127,240480,1699,1135,62,539,601,534,1671.25,1157.0,68.08,550.33,618.42,538.58,20055,13884,817,6604,7421,6463,2022,'IPUEIRA',Ipueira,'RN',2404804,234.0,234,19.5,19.5,1,10.0,10.0,Pequeno I
1125,1128,240485,6416,5501,455,3501,3956,1545,6402.17,5557.67,441.33,3684.83,4126.17,1431.5,76826,66692,5296,44218,49514,17178,2022,'ITAJA',Itajá,'RN',2404853,1150.0,1150,95.8,95.8,1,84.0,84.0,Pequeno I
1126,1129,240490,4313,3517,172,2486,2658,859,4273.0,3542.42,173.75,2525.42,2699.17,843.25,51276,42509,2085,30305,32390,10119,2022,'ITAU',Itaú,'RN',2404903,1133.0,1133,94.4,94.4,1,47.0,47.0,Pequeno I
1127,1130,240500,6243,5617,278,4469,4747,870,6078.08,5516.08,291.08,4384.67,4675.75,840.33,72937,66193,3493,52616,56109,10084,2022,'JACANA',Jaçanã,'RN',2405009,417.0,417,37.9,37.9,1,,,Pequeno I
1128,1131,240510,4813,4383,197,3441,3638,745,4705.92,4304.75,234.58,3366.33,3600.92,703.83,56471,51657,2815,40396,43211,8446,2022,'JANDAIRA',Jandaíra,'RN',2405108,3021.0,3021,251.8,251.8,1,303.0,303.0,Pequeno I
1129,1132,240520,3906,3293,213,2597,2810,483,3856.92,3278.75,203.5,2564.67,2768.17,510.58,46283,39345,2442,30776,33218,6127,2022,'JANDUIS',Janduís,'RN',2405207,1946.0,1946,162.2,162.2,2,155.0,155.0,Pequeno I
1130,1133,240530,6761,6209,288,5010,5298,911,6633.58,6141.92,243.5,5044.75,5288.25,853.67,79603,73703,2922,60537,63459,10244,2022,'BOA SAUDE',Januário Cicco,'RN',2405306,337.0,337,28.1,28.1,1,22.0,22.0,Pequeno I
1131,1134,240540,6050,5588,118,4968,5086,502,5997.08,5557.5,133.92,4908.0,5041.92,515.58,71965,66690,1607,58896,60503,6187,2022,'JAPI',Japi,'RN',2405405,261.0,261,37.3,37.3,1,,,Pequeno I
1132,1135,240550,2308,2106,50,1823,1873,233,2203.83,2027.25,54.5,1747.58,1802.08,225.17,26446,24327,654,20971,21625,2702,2022,'JARDIM DE ANGICOS',Jardim de Angicos,'RN',2405504,1092.0,1092,91.0,91.0,1,136.0,136.0,Pequeno I
1133,1136,240560,9851,8980,284,7519,7803,1177,9310.33,8525.33,362.42,6971.33,7333.75,1191.58,111724,102304,4349,83656,88005,14299,2022,'JARDIM DE PIRANHAS',Jardim de Piranhas,'RN',2405603,322.0,322,26.8,26.8,1,8.0,8.0,Pequeno I
1134,1137,240570,8042,5754,786,1992,2778,2976,7809.5,5686.17,814.25,1937.33,2751.58,2934.58,93714,68234,9771,23248,33019,35215,2022,'JARDIM DO SERIDO',Jardim do Seridó,'RN',2405702,819.0,819,68.2,68.2,1,71.0,71.0,Pequeno I
1135,1138,240580,26426,24286,1523,19354,20877,3409,25682.67,23705.58,1581.58,18991.33,20572.92,3132.67,308192,284467,18979,227896,246875,37592,2022,'JOAO CAMARA',João Câmara,'RN',2405801,3281.0,3281,273.4,273.4,2,63.0,63.0,Pequeno II
1136,1139,240590,2166,1931,33,1557,1590,341,2088.75,1878.83,25.42,1499.17,1524.58,354.25,25065,22546,305,17990,18295,4251,2022,'JOAO DIAS',João Dias,'RN',2405900,1097.0,1097,91.4,91.4,1,108.0,108.0,Pequeno I
1137,1140,240600,5103,3988,164,2639,2803,1185,5082.5,4027.17,163.5,2642.42,2805.92,1221.25,60990,48326,1962,31709,33671,14655,2022,'JOSE DA PENHA',José da Penha,'RN',2406007,239.0,239,19.9,19.9,1,13.0,13.0,Pequeno I
1138,1141,240610,12627,11222,618,7890,8508,2714,12362.33,11066.67,528.5,8089.58,8618.08,2448.58,148348,132800,6342,97075,103417,29383,2022,'JUCURUTU',Jucurutu,'RN',2406106,1931.0,1931,160.9,160.9,2,137.0,137.0,Pequeno I
1139,1142,240615,3521,2996,248,2104,2352,644,3441.33,2964.83,263.42,2056.17,2319.58,645.25,41296,35578,3161,24674,27835,7743,2022,'JUNDIA',Jundiá,'RN',2406155,399.0,399,33.2,33.2,1,22.0,22.0,Pequeno I
1140,1143,240620,5625,5047,208,4041,4249,798,5433.92,4917.33,251.25,3967.92,4219.17,698.17,65207,59008,3015,47615,50630,8378,2022,'LAGOA DANTA',Lagoa D´anta,'RN',2406205,524.0,524,43.7,43.7,1,30.0,30.0,Pequeno I
1141,1144,240630,6196,5750,345,4412,4757,993,6044.75,5640.92,450.08,4213.25,4663.33,977.58,72537,67691,5401,50559,55960,11731,2022,'LAGOA DE PEDRAS',Lagoa de Pedras,'RN',2406304,2667.0,2667,222.2,222.2,1,248.0,248.0,Pequeno I
1142,1145,240640,2624,2211,107,1602,1709,502,2597.08,2218.17,98.58,1629.25,1727.83,490.33,31165,26618,1183,19551,20734,5884,2022,'LAGOA DE VELHOS',Lagoa de Velhos,'RN',2406403,1697.0,1697,188.6,188.6,1,102.0,102.0,Pequeno I
1143,1146,240650,12728,11063,837,7395,8232,2831,12397.92,10949.5,809.0,7605.5,8414.5,2535.0,148775,131394,9708,91266,100974,30420,2022,'LAGOA NOVA',Lagoa Nova,'RN',2406502,1586.0,1586,132.2,132.2,1,79.0,79.0,Pequeno I
1144,1147,240660,9236,8641,127,8034,8161,480,8613.58,8090.0,140.25,7461.33,7601.58,488.42,103363,97080,1683,89536,91219,5861,2022,'LAGOA SALGADA',Lagoa Salgada,'RN',2406601,912.0,912,76.0,76.0,1,91.0,91.0,Pequeno I
1145,1148,240670,7497,6205,589,3884,4473,1732,7322.0,6161.5,510.33,3966.17,4476.5,1685.0,87864,73938,6124,47594,53718,20220,2022,'LAJES',Lajes,'RN',2406700,749.0,749,62.4,62.4,2,31.0,31.0,Pequeno I
1146,1149,240680,4457,3806,158,2839,2997,809,4377.42,3758.67,156.25,2826.0,2982.25,776.42,52529,45104,1875,33912,35787,9317,2022,'LAJES PINTADAS',Lajes Pintadas,'RN',2406809,630.0,630,52.5,52.5,1,37.0,37.0,Pequeno I
1147,1150,240690,3032,2487,71,1987,2058,429,2922.42,2440.08,91.67,1912.0,2003.67,436.42,35069,29281,1100,22944,24044,5237,2022,'LUCRECIA',Lucrécia,'RN',2406908,1072.0,1072,89.3,89.3,1,73.0,73.0,Pequeno I
1148,1151,240700,7537,6513,347,4716,5063,1450,7446.58,6480.75,337.0,4784.5,5121.5,1359.25,89359,77769,4044,57414,61458,16311,2022,'LUIS GOMES',Luís Gomes,'RN',2407005,414.0,414,34.5,34.5,1,21.0,21.0,Pequeno I
1149,1152,240710,50518,45176,3903,32626,36529,8647,47501.67,42652.5,3847.67,30165.17,34012.83,8639.67,570020,511830,46172,361982,408154,103676,2022,'MACAIBA',Macaíba,'RN',2407104,5934.0,5934,494.5,494.5,2,417.0,417.0,Médio
1150,1153,240720,14175,12669,1609,8083,9692,2977,13797.83,12528.17,1386.33,8426.42,9812.75,2715.42,165574,150338,16636,101117,117753,32585,2022,'MACAU',Macau,'RN',2407203,1170.0,1170,97.5,97.5,1,89.0,89.0,Pequeno II
1151,1154,240725,3353,2773,125,1710,1835,938,3356.58,2807.83,131.5,1775.75,1907.25,900.58,40279,33694,1578,21309,22887,10807,2022,'MAJOR SALES',Major Sales,'RN',2407252,688.0,688,57.3,57.3,1,26.0,26.0,Pequeno I
1152,1155,240730,6765,5668,213,4182,4395,1273,6653.83,5631.67,215.92,4194.83,4410.75,1220.92,79846,67580,2591,50338,52929,14651,2022,'MARCELINO VIEIRA',Marcelino Vieira,'RN',2407302,1934.0,1934,161.2,161.2,1,99.0,99.0,Pequeno I
1153,1156,240740,5645,4741,272,3143,3415,1326,5482.58,4639.08,230.67,3107.0,3337.67,1301.42,65791,55669,2768,37284,40052,15617,2022,'MARTINS',Martins,'RN',2407401,792.0,792,66.0,66.0,1,29.0,29.0,Pequeno I
1154,1157,240750,7923,6994,906,3922,4828,2166,7714.33,6861.75,916.0,3957.58,4873.58,1988.17,92572,82341,10992,47491,58483,23858,2022,'MAXARANGUAPE',Maxaranguape,'RN',2407500,1758.0,1758,146.5,146.5,1,268.0,268.0,Pequeno I
1155,1158,240760,4163,3326,162,2575,2737,589,4074.42,3284.5,144.17,2573.67,2717.83,566.67,48893,39414,1730,30884,32614,6800,2022,'MESSIAS TARGINO',Messias Targino,'RN',2407609,757.0,757,63.1,63.1,1,60.0,60.0,Pequeno I
1156,1159,240770,9560,8701,437,7013,7450,1251,9382.08,8567.75,461.17,6925.33,7386.5,1181.25,112585,102813,5534,83104,88638,14175,2022,'MONTANHAS',Montanhas,'RN',2407708,1853.0,1853,154.4,154.4,1,55.0,55.0,Pequeno I
1157,1160,240780,15447,13696,1905,8636,10541,3155,14692.33,13137.75,1765.75,8451.17,10216.92,2920.83,176308,157653,21189,101414,122603,35050,2022,'MONTE ALEGRE',Monte Alegre,'RN',2407807,14481.0,16574,1206.8,1381.2,1,1435.0,1435.0,Pequeno II
1158,1161,240790,2636,2293,119,1565,1684,609,2614.08,2294.83,108.83,1628.83,1737.67,557.17,31369,27538,1306,19546,20852,6686,2022,'MONTE DAS GAMELEIRAS',Monte Das Gameleiras,'RN',2407906,2016.0,2016,168.0,168.0,1,53.0,53.0,Pequeno I
1159,1162,240800,145133,124921,12229,77604,89833,35088,135962.75,117584.75,12321.75,71140.92,83462.67,34122.08,1631553,1411017,147861,853691,1001552,409465,2022,'MOSSORO',Mossoró,'RN',2408003,37378.0,37378,3114.8,3114.8,14,1936.0,1936.0,Grande
1160,1163,240810,287016,261200,24961,181866,206827,54373,265462.92,241446.42,22734.42,167628.0,190362.42,51084.0,3185555,2897357,272813,2011536,2284349,613008,2022,'NATAL',Natal,'RN',2408102,172590.0,185826,14382.5,15485.5,12,10176.0,10176.0,Grande
1161,1164,240820,20107,18363,2747,11127,13874,4489,18889.67,17355.0,2255.75,11079.83,13335.58,4019.42,226676,208260,27069,132958,160027,48233,2022,'NISIA FLORESTA',Nísia Floresta,'RN',2408201,3599.0,3599,299.9,299.9,1,183.0,183.0,Pequeno II
1162,1165,240830,26219,24126,1127,18824,19951,4175,25945.5,24088.75,1172.75,19160.58,20333.33,3755.42,311346,289065,14073,229927,244000,45065,2022,'NOVA CRUZ',Nova Cruz,'RN',2408300,2291.0,2291,190.9,190.9,2,59.0,59.0,Pequeno II
1163,1166,240840,2934,2495,97,1710,1807,688,2882.08,2499.58,95.92,1711.75,1807.67,691.92,34585,29995,1151,20541,21692,8303,2022,'OLHO-DAGUA DO BORGES',Olho-d´água do Borges,'RN',2408409,157.0,157,14.3,14.3,1,,,Pequeno I
1164,1167,240850,4136,3021,221,1671,1892,1129,4100.17,3087.58,253.67,1664.17,1917.83,1169.75,49202,37051,3044,19970,23014,14037,2022,'OURO BRANCO',Ouro Branco,'RN',2408508,1167.0,1167,97.2,97.2,1,160.0,160.0,Pequeno I
1165,1168,240860,3883,3171,122,2488,2610,561,3811.08,3141.17,121.92,2397.42,2519.33,621.83,45733,37694,1463,28769,30232,7462,2022,'PARANA',Paraná,'RN',2408607,1682.0,1682,140.2,140.2,1,170.0,170.0,Pequeno I
1166,1169,240870,2854,2355,386,1209,1595,760,2854.92,2371.0,365.33,1293.25,1658.58,712.42,34259,28452,4384,15519,19903,8549,2022,'PARAU',Paraú,'RN',2408706,827.0,827,68.9,68.9,1,45.0,45.0,Pequeno I
1167,1170,240880,4389,3962,400,2695,3095,867,4298.25,3931.25,412.5,2781.33,3193.83,737.42,51579,47175,4950,33376,38326,8849,2022,'PARAZINHO',Parazinho,'RN',2408805,402.0,402,33.5,33.5,1,12.0,12.0,Pequeno I
1168,1171,240890,14544,12214,1285,7384,8669,3545,13762.17,11615.67,1331.67,6640.83,7972.5,3643.17,165146,139388,15980,79690,95670,43718,2022,'PARELHAS',Parelhas,'RN',2408904,2159.0,2159,179.9,179.9,2,162.0,162.0,Pequeno II
1169,1172,240895,9543,8982,1070,6608,7678,1304,9295.83,8786.67,938.75,6677.83,7616.58,1170.08,111550,105440,11265,80134,91399,14041,2022,'RIO DO FOGO',Rio do Fogo,'RN',2408953,643.0,643,53.6,53.6,1,58.0,58.0,Pequeno I
1170,1173,240910,10087,8804,203,6886,7089,1715,9921.67,8752.25,209.67,6932.25,7141.92,1610.33,119060,105027,2516,83187,85703,19324,2022,'PASSA E FICA',Passa e Fica,'RN',2409100,5051.0,5051,420.9,420.9,1,190.0,190.0,Pequeno I
1171,1174,240920,2800,2440,199,1617,1816,624,2718.5,2381.92,178.08,1532.42,1710.5,671.42,32622,28583,2137,18389,20526,8057,2022,'PASSAGEM',Passagem,'RN',2409209,1042.0,1042,86.8,86.8,1,41.0,41.0,Pequeno I
1172,1175,240930,8902,7840,404,5687,6091,1749,8731.92,7775.67,365.17,5833.5,6198.67,1577.0,104783,93308,4382,70002,74384,18924,2022,'PATU',Patu,'RN',2409308,263.0,263,21.9,21.9,1,35.0,35.0,Pequeno I
1173,1176,240933,4348,3878,163,3116,3279,599,4256.92,3829.42,152.67,3182.83,3335.5,493.92,51083,45953,1832,38194,40026,5927,2022,'SANTA MARIA',Santa Maria,'RN',2409332,601.0,601,54.6,54.6,1,30.0,30.0,Pequeno I
1174,1177,240940,18391,15549,1443,10054,11497,4052,17404.83,14797.25,1475.0,9264.67,10739.67,4057.58,208858,177567,17700,111176,128876,48691,2022,'PAU DOS FERROS',Pau Dos Ferros,'RN',2409407,2846.0,2846,237.2,237.2,3,72.0,72.0,Pequeno II
1175,1178,240950,3512,3103,133,2330,2463,640,3438.75,3098.67,158.33,2370.25,2528.58,570.08,41265,37184,1900,28443,30343,6841,2022,'PEDRA GRANDE',Pedra Grande,'RN',2409506,770.0,770,64.2,64.2,1,16.0,16.0,Pequeno I
1176,1179,240960,2166,1971,53,1475,1528,443,2132.75,1966.67,57.58,1501.58,1559.17,407.5,25593,23600,691,18019,18710,4890,2022,'PEDRA PRETA',Pedra Preta,'RN',2409605,617.0,617,51.4,51.4,1,26.0,26.0,Pequeno I
1177,1180,240970,5135,4408,190,3545,3735,673,5042.5,4368.17,221.17,3505.25,3726.42,641.75,60510,52418,2654,42063,44717,7701,2022,'PEDRO AVELINO',Pedro Avelino,'RN',2409704,4248.0,4248,354.0,354.0,1,206.0,206.0,Pequeno I
1178,1181,240980,10961,10177,275,8661,8936,1241,10641.0,9922.08,330.75,8325.92,8656.67,1265.42,127692,119065,3969,99911,103880,15185,2022,'PEDRO VELHO',Pedro Velho,'RN',2409803,597.0,597,49.8,49.8,1,30.0,30.0,Pequeno I
1179,1182,240990,8196,7435,675,5157,5832,1603,7861.58,7194.75,685.08,5033.75,5718.83,1475.92,94339,86337,8221,60405,68626,17711,2022,'PENDENCIAS',Pendências,'RN',2409902,709.0,709,59.1,59.1,1,44.0,44.0,Pequeno I
1180,1183,241000,2698,2214,49,1706,1755,459,2627.17,2181.92,49.33,1630.5,1679.83,502.08,31526,26183,592,19566,20158,6025,2022,'PILOES',Pilões,'RN',2410009,264.0,264,22.0,22.0,1,120.0,120.0,Pequeno I
1181,1184,241010,9876,9153,464,7168,7632,1521,9613.58,8962.75,533.75,6889.33,7423.08,1539.67,115363,107553,6405,82672,89077,18476,2022,'POCO BRANCO',Poço Branco,'RN',2410108,2148.0,2148,306.9,306.9,1,350.0,350.0,Pequeno I
1182,1185,241020,6043,4846,315,3251,3566,1280,5956.58,4838.5,302.0,3264.33,3566.33,1272.17,71479,58062,3624,39172,42796,15266,2022,'PORTALEGRE',Portalegre,'RN',2410207,905.0,905,75.4,75.4,2,82.0,82.0,Pequeno I
1183,1186,241025,5062,4383,154,3022,3176,1207,5120.5,4478.58,184.42,3143.42,3327.83,1150.75,61446,53743,2213,37721,39934,13809,2022,'PORTO DO MANGUE',Porto do Mangue,'RN',2410256,1302.0,1302,108.5,108.5,1,41.0,41.0,Pequeno I
1184,1187,241030,8321,7108,762,4604,5366,1742,8181.58,7070.42,743.92,4563.42,5307.33,1763.08,98179,84845,8927,54761,63688,21157,2022,'SERRA CAIADA',Presidente Juscelino,'RN',2410306,1170.0,1170,97.5,97.5,1,50.0,50.0,Pequeno I
1185,1188,241040,7197,6550,422,4897,5319,1231,7105.0,6536.75,397.75,4947.83,5345.58,1191.17,85260,78441,4773,59374,64147,14294,2022,'PUREZA',Pureza,'RN',2410405,3332.0,3332,277.7,277.7,1,250.0,250.0,Pequeno I
1186,1189,241050,4272,3626,127,2642,2769,857,4162.67,3585.83,131.33,2572.25,2703.58,882.25,49952,43030,1576,30867,32443,10587,2022,'RAFAEL FERNANDES',Rafael Fernandes,'RN',2410504,470.0,470,39.2,39.2,1,11.0,11.0,Pequeno I
1187,1190,241060,2417,2095,110,1398,1508,587,2350.67,2081.75,109.83,1389.58,1499.42,582.33,28208,24981,1318,16675,17993,6988,2022,'RAFAEL GODEIRO',Rafael Godeiro,'RN',2410603,709.0,709,59.1,59.1,1,50.0,50.0,Pequeno I
1188,1191,241070,2010,1779,39,1317,1356,423,1970.75,1755.25,42.92,1308.17,1351.08,404.17,23649,21063,515,15698,16213,4850,2022,'RIACHO DA CRUZ',Riacho da Cruz,'RN',2410702,2487.0,2487,207.2,207.2,1,734.0,734.0,Pequeno I
1189,1192,241080,3433,2802,114,1903,2017,785,3396.5,2801.0,116.25,1925.0,2041.25,759.75,40758,33612,1395,23100,24495,9117,2022,'RIACHO DE SANTANA',Riacho de Santana,'RN',2410801,278.0,278,23.2,23.2,1,6.0,6.0,Pequeno I
1190,1193,241090,6230,5357,307,3808,4115,1242,6147.67,5357.25,331.0,3887.25,4218.25,1139.0,73772,64287,3972,46647,50619,13668,2022,'RIACHUELO',Riachuelo,'RN',2410900,767.0,767,63.9,63.9,1,10.0,10.0,Pequeno I
1191,1194,241100,3504,2826,117,1829,1946,880,3467.92,2816.75,116.33,1846.25,1962.58,854.17,41615,33801,1396,22155,23551,10250,2022,'RODOLFO FERNANDES',Rodolfo Fernandes,'RN',2411007,487.0,487,40.6,40.6,1,35.0,35.0,Pequeno I
1192,1195,241105,3374,2912,580,1300,1880,1032,3186.83,2782.75,603.75,1217.75,1821.5,961.25,38242,33393,7245,14613,21858,11535,2022,'TIBAU',Tibau,'RN',2411056,1303.0,1303,108.6,108.6,1,42.0,42.0,Pequeno I
1193,1196,241110,2798,2227,145,1333,1478,749,2802.92,2247.58,139.08,1366.25,1505.33,742.25,33635,26971,1669,16395,18064,8907,2022,'RUY BARBOSA',Ruy Barbosa,'RN',2411106,689.0,689,57.4,57.4,1,42.0,42.0,Pequeno I
1194,1197,241120,23245,20908,2235,13533,15768,5140,22489.08,20255.92,2284.5,13025.33,15309.83,4946.08,269869,243071,27414,156304,183718,59353,2022,'SANTA CRUZ',Santa Cruz,'RN',2411205,4326.0,4326,360.5,360.5,2,241.0,241.0,Pequeno II
1195,1198,241140,9573,7689,387,5373,5760,1929,9398.58,7666.75,382.42,5445.58,5828.0,1838.75,112783,92001,4589,65347,69936,22065,2022,'SANTANA DO MATOS',Santana do Matos,'RN',2411403,561.0,561,46.8,46.8,1,37.0,37.0,Pequeno I
1196,1199,241142,2212,1810,143,1013,1156,654,2210.67,1824.92,122.0,1034.25,1156.25,668.67,26528,21899,1464,12411,13875,8024,2022,'SANTANA DO SERIDO',Santana do Seridó,'RN',2411429,979.0,979,81.6,81.6,1,68.0,68.0,Pequeno I
1197,1200,241150,16335,14934,611,11591,12202,2732,16024.75,14769.33,574.83,11513.17,12088.0,2681.33,192297,177232,6898,138158,145056,32176,2022,'SANTO ANTONIO',Santo Antônio,'RN',2411502,2116.0,4472,176.3,372.7,1,40.0,40.0,Pequeno II
1198,1201,241160,3566,2915,493,1445,1938,977,3479.17,2923.67,507.33,1515.42,2022.75,900.92,41750,35084,6088,18185,24273,10811,2022,'SAO BENTO DO NORTE',São Bento do Norte,'RN',2411601,2450.0,2450,350.0,350.0,1,350.0,350.0,Pequeno I
1199,1202,241170,3628,3188,92,2546,2638,550,3621.5,3207.33,104.17,2542.83,2647.0,560.33,43458,38488,1250,30514,31764,6724,2022,'SAO BENTO DO TRAIRI',São Bento do Trairí,'RN',2411700,390.0,390,32.5,32.5,1,14.0,14.0,Pequeno I
1200,1203,241180,2842,2274,231,1210,1441,833,2800.17,2246.75,225.67,1175.25,1400.92,845.83,33602,26961,2708,14103,16811,10150,2022,'SAO FERNANDO',São Fernando,'RN',2411809,383.0,383,42.6,42.6,1,48.0,48.0,Pequeno I
1201,1204,241190,3233,2765,67,1979,2046,719,3198.25,2777.25,61.5,1963.5,2025.0,752.25,38379,33327,738,23562,24300,9027,2022,'SAO FRANCISCO DO OESTE',São Francisco do Oeste,'RN',2411908,286.0,286,23.8,23.8,1,15.0,15.0,Pequeno I
1202,1205,241200,67264,61589,6969,40601,47570,14019,61604.42,56601.5,6513.75,36983.08,43496.83,13104.67,739253,679218,78165,443797,521962,157256,2022,'SAO GONCALO DO AMARANTE',São Gonçalo do Amarante,'RN',2412005,9354.0,9354,779.5,779.5,3,671.0,671.0,Médio
1203,1206,241210,4486,3487,291,2136,2427,1060,4275.83,3404.92,301.42,2014.67,2316.08,1088.83,51310,40859,3617,24176,27793,13066,2022,'SAO JOAO DO SABUGI',São João do Sabugi,'RN',2412104,292.0,292,24.3,24.3,1,25.0,25.0,Pequeno I
1204,1207,241220,30240,27819,6308,13740,20048,7771,28835.58,26684.42,5534.67,13782.58,19317.25,7367.17,346027,320213,66416,165391,231807,88406,2022,'SAO JOSE DE MIPIBU',São José de Mipibu,'RN',2412203,10170.0,10170,847.5,847.5,2,263.0,263.0,Pequeno II
1205,1208,241230,8217,7457,261,6094,6355,1102,8061.25,7417.08,292.67,6070.83,6363.5,1053.58,96735,89005,3512,72850,76362,12643,2022,'SAO JOSE DO CAMPESTRE',São José do Campestre,'RN',2412302,793.0,793,66.1,66.1,1,89.0,89.0,Pequeno I
1206,1209,241240,3720,2469,312,802,1114,1355,3659.83,2525.5,302.0,822.42,1124.42,1401.08,43918,30306,3624,9869,13493,16813,2022,'SAO JOSE DO SERIDO',São José do Seridó,'RN',2412401,446.0,446,40.5,40.5,1,17.0,17.0,Pequeno I
1207,1210,241250,17778,15164,594,11310,11904,3260,17119.67,14797.17,708.0,10889.92,11597.92,3199.25,205436,177566,8496,130679,139175,38391,2022,'SAO MIGUEL',São Miguel,'RN',2412500,1088.0,1088,90.7,90.7,1,100.0,100.0,Pequeno II
1208,1211,241255,8507,7561,504,5331,5835,1726,8097.92,7344.83,498.33,5301.0,5799.33,1545.5,97175,88138,5980,63612,69592,18546,2022,'SAO MIGUEL DO GOSTOSO',São Miguel do Gostoso,'RN',2412559,2486.0,2486,207.2,207.2,1,40.0,40.0,Pequeno I
1209,1212,241260,13741,11772,501,8630,9131,2641,13539.83,11716.67,490.92,8875.17,9366.08,2350.58,162478,140600,5891,106502,112393,28207,2022,'SAO PAULO DO POTENGI',São Paulo do Potengi,'RN',2412609,3031.0,3031,252.6,252.6,1,252.0,252.0,Pequeno I
1210,1213,241270,5064,4428,351,3020,3371,1057,5005.67,4420.58,374.42,3041.83,3416.25,1004.33,60068,53047,4493,36502,40995,12052,2022,'SAO PEDRO',São Pedro,'RN',2412708,536.0,536,44.7,44.7,1,47.0,47.0,Pequeno I
1211,1214,241280,6191,5500,179,4650,4829,671,6013.25,5371.25,183.25,4509.92,4693.17,678.08,72159,64455,2199,54119,56318,8137,2022,'SAO RAFAEL',São Rafael,'RN',2412807,590.0,590,49.2,49.2,1,23.0,23.0,Pequeno I
1212,1215,241290,8487,6843,292,5272,5564,1279,8408.33,6848.33,242.5,5254.67,5497.17,1351.17,100900,82180,2910,63056,65966,16214,2022,'SAO TOME',São Tomé,'RN',2412906,3240.0,6530,270.0,544.2,1,219.0,219.0,Pequeno I
1213,1216,241300,4414,3841,159,2572,2731,1110,4293.58,3744.33,129.42,2462.92,2592.33,1152.0,51523,44932,1553,29555,31108,13824,2022,'SAO VICENTE',São Vicente,'RN',2413003,513.0,513,42.8,42.8,1,56.0,56.0,Pequeno I
1214,1217,241310,5788,5239,109,4481,4590,649,5648.25,5150.83,118.17,4447.58,4565.75,585.08,67779,61810,1418,53371,54789,7021,2022,'SENADOR ELOI DE SOUZA',Senador Elói de Souza,'RN',2413102,3319.0,7710,276.6,642.5,1,207.0,207.0,Pequeno I
1215,1218,241320,3352,3021,343,1768,2111,910,3284.08,2985.92,349.17,1815.33,2164.5,821.42,39409,35831,4190,21784,25974,9857,2022,'SENADOR GEORGINO AVELINO',Senador Georgino Avelino,'RN',2413201,700.0,700,58.3,58.3,1,36.0,36.0,Pequeno I
1216,1219,241330,4719,4149,81,3638,3719,430,4684.42,4134.75,73.92,3621.08,3695.0,439.75,56213,49617,887,43453,44340,5277,2022,'SERRA DE SAO BENTO',Serra de São Bento,'RN',2413300,812.0,812,67.7,67.7,1,66.0,66.0,Pequeno I
1217,1220,241335,10881,9870,431,7784,8215,1655,10474.92,9566.0,401.33,7670.75,8072.08,1493.92,125699,114792,4816,92049,96865,17927,2022,'SERRA DO MEL',Serra do Mel,'RN',2413359,2465.0,2465,224.1,224.1,1,42.0,42.0,Pequeno I
1218,1221,241340,4988,4127,615,2149,2764,1363,4782.83,4030.67,602.33,2062.5,2664.83,1365.83,57394,48368,7228,24750,31978,16390,2022,'SERRA NEGRA DO NORTE',Serra Negra do Norte,'RN',2413409,197.0,197,16.4,16.4,1,7.0,7.0,Pequeno I
1219,1222,241350,6280,5649,271,4245,4516,1133,6191.33,5615.67,307.17,4252.83,4560.0,1055.67,74296,67388,3686,51034,54720,12668,2022,'SERRINHA',Serrinha,'RN',2413508,1091.0,1091,90.9,90.9,1,38.0,38.0,Pequeno I
1220,1223,241355,3925,3293,116,2405,2521,772,3863.0,3293.25,97.83,2421.5,2519.33,773.92,46356,39519,1174,29058,30232,9287,2022,'SERRINHA DOS PINTOS',Serrinha Dos Pintos,'RN',2413557,1398.0,1398,116.5,116.5,1,60.0,60.0,Pequeno I
1221,1224,241360,5659,4346,165,3057,3222,1124,5584.58,4380.5,168.0,3097.58,3265.58,1114.92,67015,52566,2016,37171,39187,13379,2022,'SEVERIANO MELO',Severiano Melo,'RN',2413607,398.0,398,33.2,33.2,1,16.0,16.0,Pequeno I
1222,1225,241370,3878,3143,176,2154,2330,813,3866.42,3177.83,206.0,2143.17,2349.17,828.67,46397,38134,2472,25718,28190,9944,2022,'SITIO NOVO',Sítio Novo,'RN',2413706,283.0,283,23.6,23.6,1,18.0,18.0,Pequeno I
1223,1226,241380,1996,1703,180,975,1155,548,1978.83,1686.92,179.58,930.83,1110.42,576.5,23746,20243,2155,11170,13325,6918,2022,'TABOLEIRO GRANDE',Taboleiro Grande,'RN',2413805,2363.0,2363,196.9,196.9,1,58.0,58.0,Pequeno I
1224,1227,241390,8442,7828,483,5950,6433,1395,8243.17,7698.75,491.08,5956.67,6447.75,1251.0,98918,92385,5893,71480,77373,15012,2022,'TAIPU',Taipu,'RN',2413904,2562.0,2562,213.5,213.5,1,67.0,67.0,Pequeno I
1225,1228,241400,10829,9996,683,7455,8138,1858,10670.25,9909.75,672.42,7549.5,8221.92,1687.83,128043,118917,8069,90594,98663,20254,2022,'TANGARA',Tangará,'RN',2414001,773.0,773,64.4,64.4,1,50.0,50.0,Pequeno I
1226,1229,241410,7950,6766,743,4247,4990,1776,7747.33,6685.42,761.58,4145.83,4907.42,1778.0,92968,80225,9139,49750,58889,21336,2022,'TENENTE ANANIAS',Tenente Ananias,'RN',2414100,1983.0,1983,165.2,165.2,1,95.0,95.0,Pequeno I
1227,1230,241415,5423,4786,169,3761,3930,856,5282.25,4686.5,185.25,3613.33,3798.58,887.92,63387,56238,2223,43360,45583,10655,2022,'TENENTE LAURENTINO CRUZ',Tenente Laurentino Cruz,'RN',2414159,228.0,228,19.0,19.0,1,15.0,15.0,Pequeno I
1228,1231,241420,9672,9036,1666,5423,7089,1947,8839.0,8268.75,1453.0,5175.92,6628.92,1639.83,106068,99225,17436,62111,79547,19678,2022,'TIBAU DO SUL',Tibau do Sul,'RN',2414209,717.0,717,71.7,71.7,1,160.0,160.0,Pequeno I
1229,1232,241430,1903,1346,55,856,911,435,1853.5,1336.33,47.42,836.17,883.58,452.75,22242,16036,569,10034,10603,5433,2022,'TIMBAUBA DOS BATISTAS',Timbaúba Dos Batistas,'RN',2414308,679.0,679,56.6,56.6,1,43.0,43.0,Pequeno I
1230,1233,241440,26994,25191,918,20201,21119,4072,26107.25,24444.58,1037.67,19538.67,20576.33,3868.25,313287,293335,12452,234464,246916,46419,2022,'TOUROS',Touros,'RN',2414407,4692.0,4692,391.0,391.0,2,256.0,256.0,Pequeno II
1231,1234,241445,3379,3078,65,2723,2788,290,3323.67,3058.42,78.25,2717.75,2796.0,262.42,39884,36701,939,32613,33552,3149,2022,'TRIUNFO POTIGUAR',Triunfo Potiguar,'RN',2414456,913.0,913,76.1,76.1,1,93.0,93.0,Pequeno I
1232,1235,241450,7531,6465,444,4962,5406,1059,7332.17,6425.08,510.67,4829.42,5340.08,1085.0,87986,77101,6128,57953,64081,13020,2022,'UMARIZAL',Umarizal,'RN',2414506,1539.0,1539,128.2,128.2,1,13.0,13.0,Pequeno I
1233,1236,241460,11385,9416,895,5908,6803,2613,11134.92,9363.08,722.67,6116.42,6839.08,2524.0,133619,112357,8672,73397,82069,30288,2022,'UPANEMA',Upanema,'RN',2414605,430.0,430,35.8,35.8,1,35.0,35.0,Pequeno I
1234,1237,241470,4063,3545,151,2894,3045,500,3956.0,3499.33,133.42,2860.92,2994.33,505.0,47472,41992,1601,34331,35932,6060,2022,'VARZEA',Várzea,'RN',2414704,1178.0,1178,98.2,98.2,1,71.0,71.0,Pequeno I
1235,1238,241475,3548,2946,74,2083,2157,789,3555.58,3004.42,92.92,2125.42,2218.33,786.08,42667,36053,1115,25505,26620,9433,2022,'VENHA-VER',Venha-ver,'RN',2414753,236.0,236,19.7,19.7,1,12.0,12.0,Pequeno I
1236,1239,241480,10287,8898,2472,3389,5861,3037,9960.75,8672.42,2346.75,3419.25,5766.0,2906.42,119529,104069,28161,41031,69192,34877,2022,'VERA CRUZ',Vera Cruz,'RN',2414803,2600.0,3826,216.7,318.8,1,0.0,1226.0,Pequeno I
1237,1240,241490,1812,1427,42,1127,1169,258,1761.33,1423.83,40.17,1098.33,1138.5,285.33,21136,17086,482,13180,13662,3424,2022,'VICOSA',Viçosa,'RN',2414902,4453.0,4453,371.1,371.1,1,327.0,327.0,Pequeno I
1238,1241,241500,2289,2163,23,1900,1923,240,2270.75,2168.5,16.5,2007.33,2023.83,144.67,27249,26022,198,24088,24286,1736,2022,'VILA FLOR',Vila Flor,'RN',2415008,855.0,2223,71.2,185.2,1,433.0,433.0,Pequeno I
1239,1242,250010,8380,7136,244,5213,5457,1679,8237.67,7173.92,247.58,5195.92,5443.5,1730.42,98852,86087,2971,62351,65322,20765,2022,'AGUA BRANCA',Água Branca,'PB',2500106,1354.0,1354,112.8,112.8,1,30.0,30.0,Pequeno I
1240,1243,250020,4513,3596,154,2686,2840,756,4500.58,3637.42,151.83,2670.58,2822.42,815.0,54007,43649,1822,32047,33869,9780,2022,'AGUIAR',Aguiar,'PB',2500205,1226.0,1226,102.2,102.2,1,158.0,158.0,Pequeno I
1241,1244,250030,20528,18855,2425,12840,15265,3590,20077.92,18576.75,2147.67,13103.67,15251.33,3325.42,240935,222921,25772,157244,183016,39905,2022,'ALAGOA GRANDE',Alagoa Grande,'PB',2500304,1165.0,1165,105.9,105.9,2,,,Pequeno II
1242,1245,250040,14459,13156,1952,7928,9880,3276,13914.92,12767.33,1624.42,8374.75,9999.17,2768.17,166979,153208,19493,100497,119990,33218,2022,'ALAGOA NOVA',Alagoa Nova,'PB',2500403,6357.0,8834,529.8,736.2,1,722.0,722.0,Pequeno I
1243,1246,250050,10377,9732,451,8094,8545,1187,10223.92,9653.17,445.83,8131.75,8577.58,1075.58,122687,115838,5350,97581,102931,12907,2022,'ALAGOINHA',Alagoinha,'PB',2500502,588.0,588,53.5,53.5,1,28.0,28.0,Pequeno I
1244,1247,250053,3902,3677,306,2540,2846,831,3767.17,3566.58,288.33,2545.08,2833.42,733.17,45206,42799,3460,30541,34001,8798,2022,'ALCANTIL',Alcantil,'PB',2500536,2330.0,2330,194.2,194.2,1,163.0,163.0,Pequeno I
1245,1248,250057,2480,2363,43,2145,2188,175,2426.0,2322.33,39.08,2128.67,2167.75,154.58,29112,27868,469,25544,26013,1855,2022,'ALGODAO DE JANDAIRA',Algodão de Jandaíra,'PB',2500577,883.0,883,73.6,73.6,1,100.0,100.0,Pequeno I
1246,1249,250060,16595,15298,1116,11719,12835,2463,15701.08,14704.33,887.17,11844.08,12731.25,1973.08,188413,176452,10646,142129,152775,23677,2022,'ALHANDRA',Alhandra,'PB',2500601,2221.0,2221,185.1,185.1,1,367.0,367.0,Pequeno I
1247,1250,250070,11854,10484,187,8080,8267,2217,11718.33,10453.83,206.67,8143.33,8350.0,2103.83,140620,125446,2480,97720,100200,25246,2022,'SAO JOAO DO RIO DO PEIXE',São João do Rio do Peixe,'PB',2500700,6130.0,6130,510.8,510.8,1,700.0,700.0,Pequeno I
1248,1251,250073,2252,1919,21,1534,1555,364,2207.75,1916.92,26.92,1521.0,1547.92,369.0,26493,23003,323,18252,18575,4428,2022,'AMPARO',Amparo,'PB',2500734,707.0,707,58.9,58.9,1,7.0,7.0,Pequeno I
1249,1252,250077,6832,5704,102,4698,4800,904,6649.17,5613.5,123.58,4557.5,4681.08,932.42,79790,67362,1483,54690,56173,11189,2022,'APARECIDA',Aparecida,'PB',2500775,3379.0,3379,281.6,281.6,1,250.0,250.0,Pequeno I
1250,1253,250080,14073,12619,198,11340,11538,1081,13554.67,12257.5,222.5,10906.83,11129.33,1128.17,162656,147090,2670,130882,133552,13538,2022,'ARACAGI',Araçagi,'PB',2500809,1059.0,1059,88.2,88.2,1,42.0,42.0,Pequeno I
1251,1254,250090,8922,8195,135,7107,7242,953,8724.17,8057.25,166.58,6953.92,7120.5,936.75,104690,96687,1999,83447,85446,11241,2022,'ARARA',Arara,'PB',2500908,2136.0,2136,178.0,178.0,1,195.0,195.0,Pequeno I
1252,1255,250100,11221,10427,694,7670,8364,2063,11106.83,10402.25,562.17,7942.0,8504.17,1898.08,133282,124827,6746,95304,102050,22777,2022,'ARARUNA',Araruna,'PB',2501005,5443.0,5443,453.6,453.6,1,305.0,305.0,Pequeno I
1253,1256,250110,14816,14011,1026,10493,11519,2492,14398.92,13668.58,979.83,10410.83,11390.67,2277.92,172787,164023,11758,124930,136688,27335,2022,'AREIA',Areia,'PB',2501104,1424.0,1424,118.7,118.7,1,159.0,159.0,Pequeno II
1254,1257,250115,1919,1604,42,1238,1280,324,1895.75,1586.67,42.17,1219.25,1261.42,325.25,22749,19040,506,14631,15137,3903,2022,'AREIA DE BARAUNAS',Areia de Baraúnas,'PB',2501153,834.0,834,69.5,69.5,1,34.0,34.0,Pequeno I
1255,1258,250120,5838,5302,122,4099,4221,1081,5739.25,5206.42,139.92,4077.42,4217.33,989.08,68871,62477,1679,48929,50608,11869,2022,'AREIAL',Areial,'PB',2501203,4753.0,5817,396.1,484.8,1,240.0,240.0,Pequeno I
1256,1259,250130,15923,14435,218,12470,12688,1747,15679.17,14301.42,280.83,12267.83,12548.67,1752.75,188150,171617,3370,147214,150584,21033,2022,'AROEIRAS',Aroeiras,'PB',2501302,3770.0,3770,314.2,314.2,1,586.0,586.0,Pequeno I
1257,1260,250135,3834,3453,135,2853,2988,465,3723.67,3383.67,118.25,2844.0,2962.25,421.42,44684,40604,1419,34128,35547,5057,2022,'ASSUNCAO',Assunção,'PB',2501351,860.0,860,71.7,71.7,1,91.0,91.0,Pequeno I
1258,1261,250140,6973,6689,518,5431,5949,740,6837.42,6594.08,416.08,5598.42,6014.5,579.58,82049,79129,4993,67181,72174,6955,2022,'BAIA DA TRAICAO',Baía da Traição,'PB',2501401,2925.0,2925,325.0,325.0,1,325.0,325.0,Pequeno I
1259,1262,250150,15893,14905,700,11554,12254,2651,15487.33,14597.42,687.92,11485.92,12173.83,2423.58,185848,175169,8255,137831,146086,29083,2022,'BANANEIRAS',Bananeiras,'PB',2501500,7048.0,7048,587.3,587.3,1,197.0,197.0,Pequeno II
1260,1263,250153,3971,3512,165,2719,2884,628,3885.58,3463.0,143.17,2706.5,2849.67,613.33,46627,41556,1718,32478,34196,7360,2022,'BARAUNA',Baraúna,'PB',2501534,365.0,365,30.4,30.4,1,16.0,16.0,Pequeno I
1261,1264,250157,6076,5568,161,4534,4695,873,5849.42,5417.75,180.25,4386.92,4567.17,850.58,70193,65013,2163,52643,54806,10207,2022,'BARRA DE SANTANA',Barra de Santana,'PB',2501575,2645.0,2645,220.4,220.4,1,90.0,90.0,Pequeno I
1262,1265,250160,10118,8862,203,7507,7710,1152,10049.42,8867.33,215.33,7561.33,7776.67,1090.67,120593,106408,2584,90736,93320,13088,2022,'BARRA DE SANTA ROSA',Barra de Santa Rosa,'PB',2501609,1415.0,1415,117.9,117.9,1,172.0,172.0,Pequeno I
1263,1266,250170,5256,4878,139,4024,4163,715,5141.92,4821.17,128.08,4046.75,4174.83,646.33,61703,57854,1537,48561,50098,7756,2022,'BARRA DE SAO MIGUEL',Barra de São Miguel,'PB',2501708,277.0,277,23.1,23.1,2,10.0,10.0,Pequeno I
1264,1267,250180,59467,54280,3164,41959,45123,9157,55619.08,51002.08,2520.92,40202.42,42723.33,8278.75,667429,612025,30251,482429,512680,99345,2022,'BAYEUX',Bayeux,'PB',2501807,9986.0,9986,832.2,832.2,4,34.0,34.0,Médio
1265,1268,250190,11895,10708,1016,7291,8307,2401,11731.92,10635.42,915.92,7493.83,8409.75,2225.67,140783,127625,10991,89926,100917,26708,2022,'BELEM',Belém,'PB',2501906,3990.0,3990,332.5,332.5,1,303.0,303.0,Pequeno I
1266,1269,250200,5996,5421,82,4745,4827,594,5851.17,5336.92,116.17,4650.08,4766.25,570.67,70214,64043,1394,55801,57195,6848,2022,'BELEM DO BREJO DO CRUZ',Belém do Brejo do Cruz,'PB',2502003,5022.0,5022,418.5,418.5,1,238.0,238.0,Pequeno I
1267,1270,250205,2802,2548,93,1956,2049,499,2793.25,2562.08,73.58,2007.08,2080.67,481.42,33519,30745,883,24085,24968,5777,2022,'BERNARDINO BATISTA',Bernardino Batista,'PB',2502052,1642.0,1642,136.8,136.8,1,100.0,100.0,Pequeno I
1268,1271,250210,4669,4330,254,3226,3480,850,4672.25,4380.0,243.58,3351.83,3595.42,784.58,56067,52560,2923,40222,43145,9415,2022,'BOA VENTURA',Boa Ventura,'PB',2502102,291.0,291,24.2,24.2,1,8.0,8.0,Pequeno I
1269,1272,250215,4782,4355,287,2523,2810,1545,4690.25,4291.67,302.17,2491.42,2793.58,1498.08,56283,51500,3626,29897,33523,17977,2022,'BOA VISTA',Boa Vista,'PB',2502151,491.0,491,40.9,40.9,1,91.0,91.0,Pequeno I
1270,1273,250220,2029,1743,119,1162,1281,462,1949.92,1698.33,117.33,1131.0,1248.33,450.0,23399,20380,1408,13572,14980,5400,2022,'BOM JESUS',Bom Jesus,'PB',2502201,350.0,350,29.2,29.2,1,25.0,25.0,Pequeno I
1271,1274,250230,4058,3220,56,2440,2496,724,3978.42,3187.25,63.17,2444.42,2507.58,679.67,47741,38247,758,29333,30091,8156,2022,'BOM SUCESSO',Bom Sucesso,'PB',2502300,2295.0,2295,191.2,191.2,1,126.0,126.0,Pequeno I
1272,1275,250240,8132,7463,154,6482,6636,827,7812.5,7218.83,161.75,6243.5,6405.25,813.58,93750,86626,1941,74922,76863,9763,2022,'BONITO DE SANTA FE',Bonito de Santa fé,'PB',2502409,598.0,598,49.8,49.8,1,40.0,40.0,Pequeno I
1273,1276,250250,13805,12840,726,10445,11171,1669,13468.83,12566.75,567.75,10407.08,10974.83,1591.92,161626,150801,6813,124885,131698,19103,2022,'BOQUEIRAO',Boqueirão,'PB',2502508,4321.0,4321,360.1,360.1,1,215.0,215.0,Pequeno I
1274,1277,250260,4848,4293,179,3269,3448,845,4839.08,4318.58,165.83,3352.0,3517.83,800.75,58069,51823,1990,40224,42214,9609,2022,'IGARACY',Igaracy,'PB',2502607,410.0,410,34.2,34.2,1,26.0,26.0,Pequeno I
1275,1278,250270,3865,3707,298,2752,3050,657,3835.25,3688.08,272.67,2794.75,3067.42,620.67,46023,44257,3272,33537,36809,7448,2022,'BORBOREMA',Borborema,'PB',2502706,1769.0,1769,147.4,147.4,1,131.0,131.0,Pequeno I
1276,1279,250280,10440,9706,474,7716,8190,1516,10200.58,9571.0,444.17,7632.92,8077.08,1493.92,122407,114852,5330,91595,96925,17927,2022,'BREJO DO CRUZ',Brejo do Cruz,'PB',2502805,1723.0,1723,143.6,143.6,1,92.0,92.0,Pequeno I
1277,1280,250290,4702,4180,66,3358,3424,756,4512.42,4056.92,63.42,3195.67,3259.08,797.83,54149,48683,761,38348,39109,9574,2022,'BREJO DOS SANTOS',Brejo Dos Santos,'PB',2502904,3804.0,3804,317.0,317.0,1,258.0,258.0,Pequeno I
1278,1281,250300,15924,14995,695,12192,12887,2108,15532.5,14719.33,654.42,12166.92,12821.33,1898.0,186390,176632,7853,146003,153856,22776,2022,'CAAPORA',Caaporã,'PB',2503001,3169.0,3169,264.1,264.1,2,87.0,87.0,Pequeno II
1279,1282,250310,3728,3253,142,2322,2464,789,3565.25,3161.08,136.58,2305.75,2442.33,718.75,42783,37933,1639,27669,29308,8625,2022,'CABACEIRAS',Cabaceiras,'PB',2503100,1631.0,1631,135.9,135.9,1,147.0,147.0,Pequeno I
1280,1283,250320,33289,30830,511,27782,28293,2537,30821.42,28611.83,524.75,25817.17,26341.92,2269.92,369857,343342,6297,309806,316103,27239,2022,'CABEDELO',Cabedelo,'PB',2503209,3080.0,3080,256.7,256.7,1,1000.0,1000.0,Médio
1281,1284,250330,7218,6567,242,5492,5734,833,7113.0,6508.5,272.67,5440.83,5713.5,795.0,85356,78102,3272,65290,68562,9540,2022,'CACHOEIRA DOS INDIOS',Cachoeira Dos Índios,'PB',2503308,1774.0,1774,147.8,147.8,1,15.0,15.0,Pequeno I
1282,1285,250340,3161,2874,45,2563,2608,266,3122.92,2873.75,42.33,2574.0,2616.33,257.42,37475,34485,508,30888,31396,3089,2022,'CACIMBA DE AREIA',Cacimba de Areia,'PB',2503407,5863.0,7053,488.6,587.8,1,665.0,665.0,Pequeno I
1283,1286,250350,11913,10794,693,8321,9014,1780,11831.92,10825.5,663.75,8554.67,9218.42,1607.08,141983,129906,7965,102656,110621,19285,2022,'CACIMBA DE DENTRO',Cacimba de Dentro,'PB',2503506,3364.0,3364,280.3,280.3,1,206.0,206.0,Pequeno I
1284,1287,250355,6422,6028,61,5566,5627,401,6340.08,5987.42,94.0,5499.0,5593.0,394.42,76081,71849,1128,65988,67116,4733,2022,'CACIMBAS',Cacimbas,'PB',2503555,2865.0,2865,238.8,238.8,1,174.0,174.0,Pequeno I
1285,1288,250360,5056,4729,188,3809,3997,732,5057.0,4758.75,170.5,3908.33,4078.83,679.92,60684,57105,2046,46900,48946,8159,2022,'CAICARA',Caiçara,'PB',2503605,756.0,756,63.0,63.0,1,25.0,25.0,Pequeno I
1286,1289,250370,40480,36220,767,30913,31680,4540,38536.17,34554.5,814.25,29238.5,30052.75,4501.75,462434,414654,9771,350862,360633,54021,2022,'CAJAZEIRAS',Cajazeiras,'PB',2503704,17211.0,17211,1434.2,1434.2,2,2278.0,2278.0,Médio
1287,1290,250375,3324,2958,13,2751,2764,194,3281.08,2956.42,17.92,2774.33,2792.25,164.17,39373,35477,215,33292,33507,1970,2022,'CAJAZEIRINHAS',Cajazeirinhas,'PB',2503753,1846.0,1846,153.8,153.8,1,238.0,238.0,Pequeno I
1288,1291,250380,4597,4385,141,3772,3913,472,4476.58,4283.25,129.08,3730.0,3859.08,424.17,53719,51399,1549,44760,46309,5090,2022,'CALDAS BRANDAO',Caldas Brandão,'PB',2503803,1335.0,1335,111.2,111.2,1,38.0,38.0,Pequeno I
1289,1292,250390,5188,4621,316,3550,3866,755,5048.83,4524.58,286.67,3521.5,3808.17,716.42,60586,54295,3440,42258,45698,8597,2022,'CAMALAU',Camalaú,'PB',2503902,1641.0,1641,136.8,136.8,1,158.0,158.0,Pequeno I
1290,1293,250400,203583,171504,52142,52649,104791,66713,192150.83,162420.83,47582.33,52709.58,100291.92,62128.92,2305810,1949050,570988,632515,1203503,745547,2022,'CAMPINA GRANDE',Campina Grande,'PB',2504009,29580.0,29580,2465.0,2465.0,10,2264.0,2264.0,Grande
1291,1294,250403,5913,5541,254,4463,4717,824,5591.0,5280.33,273.83,4200.42,4474.25,806.08,67092,63364,3286,50405,53691,9673,2022,'CAPIM',Capim,'PB',2504033,1775.0,5007,161.4,455.2,1,0.0,2089.0,Pequeno I
1292,1295,250407,3710,2939,245,2009,2254,685,3517.0,2909.42,253.08,1992.67,2245.75,663.67,42204,34913,3037,23912,26949,7964,2022,'CARAUBAS',Caraúbas,'PB',2504074,359.0,359,29.9,29.9,1,15.0,15.0,Pequeno I
1293,1296,250410,1996,1795,57,1427,1484,311,1952.67,1764.67,40.5,1410.33,1450.83,313.83,23432,21176,486,16924,17410,3766,2022,'CARRAPATEIRA',Carrapateira,'PB',2504108,1378.0,1378,153.1,153.1,1,150.0,150.0,Pequeno I
1294,1297,250415,5678,5229,108,4496,4604,625,5556.17,5141.92,137.75,4387.67,4525.42,616.5,66674,61703,1653,52652,54305,7398,2022,'CASSERENGUE',Casserengue,'PB',2504157,1375.0,1375,114.6,114.6,1,68.0,68.0,Pequeno I
1295,1298,250420,3594,3368,29,3095,3124,244,3481.33,3283.5,41.08,3003.5,3044.58,238.92,41776,39402,493,36042,36535,2867,2022,'CATINGUEIRA',Catingueira,'PB',2504207,2248.0,2248,187.3,187.3,1,48.0,48.0,Pequeno I
1296,1299,250430,18396,16700,564,13794,14358,2342,17509.17,15980.58,642.42,12956.5,13598.92,2381.67,210110,191767,7709,155478,163187,28580,2022,'CATOLE DO ROCHA',Catolé do Rocha,'PB',2504306,2538.0,7970,211.5,664.2,1,350.0,350.0,Pequeno II
1297,1300,250435,4894,4151,100,3042,3142,1009,4776.17,4131.92,94.67,3032.17,3126.83,1005.08,57314,49583,1136,36386,37522,12061,2022,'CATURITE',Caturité,'PB',2504355,915.0,915,76.2,76.2,1,71.0,71.0,Pequeno I
1298,1301,250440,12829,11884,254,10169,10423,1461,12759.92,11873.25,241.08,10303.33,10544.42,1328.83,153119,142479,2893,123640,126533,15946,2022,'CONCEICAO',Conceição,'PB',2504405,550.0,550,45.8,45.8,1,45.0,45.0,Pequeno I
1299,1302,250450,5044,4504,174,3583,3757,747,4967.25,4464.83,166.67,3595.42,3762.08,702.75,59607,53578,2000,43145,45145,8433,2022,'CONDADO',Condado,'PB',2504504,2759.0,3888,229.9,324.0,1,522.0,522.0,Pequeno I
1300,1303,250460,22571,20910,1595,15899,17494,3416,21242.25,19807.58,1378.92,15435.5,16814.42,2993.17,254907,237691,16547,185226,201773,35918,2022,'CONDE',Conde,'PB',2504603,13417.0,13417,1118.1,1118.1,3,2454.0,2454.0,Pequeno II
1301,1304,250470,4594,4004,147,3150,3297,707,4419.75,3894.5,131.5,3033.83,3165.33,729.17,53037,46734,1578,36406,37984,8750,2022,'CONGO',Congo,'PB',2504702,1031.0,1031,85.9,85.9,1,23.0,23.0,Pequeno I
1302,1305,250480,11340,10395,185,8838,9023,1372,11255.08,10386.25,167.17,9069.58,9236.75,1149.5,135061,124635,2006,108835,110841,13794,2022,'COREMAS',Coremas,'PB',2504801,459.0,459,38.2,38.2,1,25.0,25.0,Pequeno I
1303,1306,250485,1738,1442,101,942,1043,399,1711.17,1438.0,101.67,955.0,1056.67,381.33,20534,17256,1220,11460,12680,4576,2022,'COXIXOLA',Coxixola,'PB',2504850,263.0,263,21.9,21.9,1,26.0,26.0,Pequeno I
1304,1307,250490,13609,12686,312,11121,11433,1253,13010.83,12209.42,343.67,10756.5,11100.17,1109.25,156130,146513,4124,129078,133202,13311,2022,'CRUZ DO ESPIRITO SANTO',Cruz do Espírito Santo,'PB',2504900,2135.0,2135,177.9,177.9,1,69.0,69.0,Pequeno I
1305,1308,250500,6017,5509,148,4414,4562,947,5884.0,5437.67,168.42,4391.17,4559.58,878.08,70608,65252,2021,52694,54715,10537,2022,'CUBATI',Cubati,'PB',2505006,1713.0,1713,142.8,142.8,1,79.0,79.0,Pequeno I
1306,1309,250510,14729,13371,337,11354,11691,1680,14410.83,13168.25,257.0,11366.5,11623.5,1544.75,172930,158019,3084,136398,139482,18537,2022,'CUITE',Cuité,'PB',2505105,957.0,957,79.8,79.8,4,24.0,24.0,Pequeno I
1307,1310,250520,5352,4923,259,3755,4014,909,5327.17,4915.33,271.67,3741.67,4013.33,902.0,63926,58984,3260,44900,48160,10824,2022,'CUITEGI',Cuitegi,'PB',2505204,7495.0,9786,624.6,815.5,1,0.0,1259.0,Pequeno I
1308,1311,250523,5772,5296,467,3971,4438,858,5692.75,5271.75,441.67,4036.58,4478.25,793.5,68313,63261,5300,48439,53739,9522,2022,'CUITE DE MAMANGUAPE',Cuité de Mamanguape,'PB',2505238,628.0,628,52.3,52.3,1,42.0,42.0,Pequeno I
1309,1312,250527,4450,4225,64,3793,3857,368,4462.5,4248.08,54.33,3831.83,3886.17,361.92,53550,50977,652,45982,46634,4343,2022,'CURRAL DE CIMA',Curral de Cima,'PB',2505279,2475.0,2475,206.2,206.2,1,147.0,147.0,Pequeno I
1310,1313,250530,1839,1669,49,1309,1358,311,1779.5,1621.67,47.42,1310.5,1357.92,263.75,21354,19460,569,15726,16295,3165,2022,'CURRAL VELHO',Curral Velho,'PB',2505303,1095.0,1095,91.2,91.2,1,90.0,90.0,Pequeno I
1311,1314,250535,4214,3876,115,3009,3124,752,4154.58,3857.25,127.67,2986.5,3114.17,743.08,49855,46287,1532,35838,37370,8917,2022,'DAMIAO',Damião,'PB',2505352,889.0,889,74.1,74.1,1,33.0,33.0,Pequeno I
1312,1315,250540,7495,6791,499,5750,6249,542,7391.75,6735.17,399.58,5818.33,6217.92,517.25,88701,80822,4795,69820,74615,6207,2022,'DESTERRO',Desterro,'PB',2505402,3698.0,3698,308.2,308.2,1,305.0,305.0,Pequeno I
1313,1316,250550,2660,2444,168,1653,1821,623,2625.75,2435.5,157.25,1670.75,1828.0,607.5,31509,29226,1887,20049,21936,7290,2022,'VISTA SERRANA',Vista Serrana,'PB',2505501,1393.0,1393,116.1,116.1,1,133.0,133.0,Pequeno I
1314,1317,250560,5038,4603,182,3707,3889,714,5046.42,4664.25,164.08,3777.25,3941.33,722.92,60557,55971,1969,45327,47296,8675,2022,'DIAMANTE',Diamante,'PB',2505600,361.0,361,30.1,30.1,1,9.0,9.0,Pequeno I
1315,1318,250570,8589,7764,487,5733,6220,1544,8421.25,7658.92,422.75,5797.0,6219.75,1439.17,101055,91907,5073,69564,74637,17270,2022,'DONA INES',Dona Inês,'PB',2505709,3490.0,3490,290.8,290.8,1,120.0,120.0,Pequeno I
1316,1319,250580,2948,2742,203,2140,2343,399,2888.58,2699.5,197.17,2170.67,2367.83,331.67,34663,32394,2366,26048,28414,3980,2022,'DUAS ESTRADAS',Duas Estradas,'PB',2505808,2156.0,2156,179.7,179.7,1,195.0,195.0,Pequeno I
1317,1320,250590,2633,2468,71,2147,2218,250,2535.25,2376.67,75.58,2051.75,2127.33,249.33,30423,28520,907,24621,25528,2992,2022,'EMAS',Emas,'PB',2505907,2351.0,2351,195.9,195.9,1,16.0,16.0,Pequeno I
1318,1321,250600,22327,20092,811,15170,15981,4111,22151.25,20075.17,810.42,15500.67,16311.08,3764.08,265815,240902,9725,186008,195733,45169,2022,'ESPERANCA',Esperança,'PB',2506004,4552.0,19243,379.3,1603.6,1,254.0,254.0,Pequeno II
1319,1322,250610,8837,8244,413,6567,6980,1264,8710.58,8183.0,385.83,6667.08,7052.92,1130.08,104527,98196,4630,80005,84635,13561,2022,'FAGUNDES',Fagundes,'PB',2506103,1822.0,1822,151.8,151.8,1,38.0,38.0,Pequeno I
1320,1323,250620,2379,2096,129,1584,1713,383,2311.0,2067.33,119.92,1533.08,1653.0,414.33,27732,24808,1439,18397,19836,4972,2022,'FREI MARTINHO',Frei Martinho,'PB',2506202,429.0,429,35.8,35.8,1,5.0,5.0,Pequeno I
1321,1324,250625,7314,6787,219,5648,5867,920,7224.75,6752.33,222.25,5660.08,5882.33,870.0,86697,81028,2667,67921,70588,10440,2022,'GADO BRAVO',Gado Bravo,'PB',2506251,766.0,766,63.8,63.8,1,35.0,35.0,Pequeno I
1322,1325,250630,33822,29967,2956,20425,23381,6586,31968.08,28460.42,2848.58,19072.92,21921.5,6538.92,383617,341525,34183,228875,263058,78467,2022,'GUARABIRA',Guarabira,'PB',2506301,1252.0,1252,104.3,104.3,2,235.0,235.0,Médio
1323,1326,250640,10416,9746,321,8242,8563,1183,10165.75,9577.17,327.75,8223.58,8551.33,1025.83,121989,114926,3933,98683,102616,12310,2022,'GURINHEM',Gurinhém,'PB',2506400,3425.0,4760,285.4,396.7,1,0.0,1335.0,Pequeno I
1324,1327,250650,2728,2360,51,1973,2024,336,2619.25,2311.42,52.92,1963.58,2016.5,294.92,31431,27737,635,23563,24198,3539,2022,'GURJAO',Gurjão,'PB',2506509,1328.0,2676,110.7,223.0,1,19.0,19.0,Pequeno I
1325,1328,250660,4145,3562,86,2847,2933,629,4126.5,3603.0,104.25,2862.0,2966.25,636.75,49518,43236,1251,34344,35595,7641,2022,'IBIARA',Ibiara,'PB',2506608,897.0,897,74.8,74.8,1,36.0,36.0,Pequeno I
1326,1329,250670,7747,7248,184,6129,6313,935,7608.33,7154.83,210.17,6079.5,6289.67,865.17,91300,85858,2522,72954,75476,10382,2022,'IMACULADA',Imaculada,'PB',2506707,509.0,509,42.4,42.4,1,19.0,19.0,Pequeno I
1327,1330,250680,14497,13643,151,12449,12600,1043,14324.33,13544.17,178.75,12426.5,12605.25,938.92,171892,162530,2145,149118,151263,11267,2022,'INGA',Ingá,'PB',2506806,3667.0,3667,305.6,305.6,1,232.0,232.0,Pequeno I
1328,1331,250690,17154,15426,305,13183,13488,1938,16863.92,15291.92,313.33,13152.42,13465.75,1826.17,202367,183503,3760,157829,161589,21914,2022,'ITABAIANA',Itabaiana,'PB',2506905,1349.0,1349,112.4,112.4,1,96.0,96.0,Pequeno II
1329,1332,250700,14028,12892,1909,8202,10111,2781,13632.75,12613.92,1886.75,8030.58,9917.33,2696.58,163593,151367,22641,96367,119008,32359,2022,'ITAPORANGA',Itaporanga,'PB',2507002,976.0,976,81.3,81.3,1,20.0,20.0,Pequeno II
1330,1333,250710,13545,12551,1119,8938,10057,2494,13289.25,12392.58,974.17,9078.75,10052.92,2339.67,159471,148711,11690,108945,120635,28076,2022,'ITAPOROROCA',Itapororoca,'PB',2507101,1349.0,1349,112.4,112.4,1,63.0,63.0,Pequeno I
1331,1334,250720,8173,7548,252,6417,6669,879,7975.33,7470.33,223.25,6559.5,6782.75,687.58,95704,89644,2679,78714,81393,8251,2022,'ITATUBA',Itatuba,'PB',2507200,3963.0,3963,330.2,330.2,1,223.0,223.0,Pequeno I
1332,1335,250730,12226,11323,590,9293,9883,1440,12000.42,11184.58,533.92,9243.25,9777.17,1407.42,144005,134215,6407,110919,117326,16889,2022,'JACARAU',Jacaraú,'PB',2507309,1082.0,1082,90.2,90.2,1,16.0,16.0,Pequeno I
1333,1336,250740,5463,4859,289,3675,3964,895,5305.17,4760.25,278.17,3647.5,3925.67,834.58,63662,57123,3338,43770,47108,10015,2022,'JERICO',Jericó,'PB',2507408,663.0,663,55.2,55.2,1,20.0,20.0,Pequeno I
1334,1337,250750,327266,297748,22429,218283,240712,57036,301199.25,274858.17,21420.33,200338.83,221759.17,53099.0,3614391,3298298,257044,2404066,2661110,637188,2022,'JOAO PESSOA',João Pessoa,'PB',2507507,87965.0,87965,7330.4,7330.4,13,4977.0,4977.0,Grande
1335,1338,250760,6819,6273,162,5575,5737,536,6641.5,6115.33,156.08,5357.33,5513.42,601.92,79698,73384,1873,64288,66161,7223,2022,'JUAREZ TAVORA',Juarez Távora,'PB',2507606,2841.0,2841,236.8,236.8,1,55.0,55.0,Pequeno I
1336,1339,250770,13219,12453,1669,8469,10138,2315,12790.5,12128.25,1446.67,8638.17,10084.83,2043.42,153486,145539,17360,103658,121018,24521,2022,'JUAZEIRINHO',Juazeirinho,'PB',2507705,1168.0,1168,97.3,97.3,1,35.0,35.0,Pequeno I
1337,1340,250780,5211,4582,174,3647,3821,761,5076.5,4503.5,182.83,3550.92,3733.75,769.75,60918,54042,2194,42611,44805,9237,2022,'JUNCO DO SERIDO',Junco do Seridó,'PB',2507804,3337.0,3337,333.7,333.7,1,342.0,342.0,Pequeno I
1338,1341,250790,8041,7443,386,5735,6121,1322,7885.25,7328.58,384.75,5580.75,5965.5,1363.08,94623,87943,4617,66969,71586,16357,2022,'JURIPIRANGA',Juripiranga,'PB',2507903,2894.0,2894,241.2,241.2,1,236.0,236.0,Pequeno I
1339,1342,250800,6913,6274,214,5020,5234,1040,6800.17,6220.08,217.33,5007.25,5224.58,995.5,81602,74641,2608,60087,62695,11946,2022,'JURU',Juru,'PB',2508000,2075.0,2075,172.9,172.9,1,63.0,63.0,Pequeno I
1340,1343,250810,3843,3413,240,2690,2930,483,3707.67,3336.08,186.58,2714.83,2901.42,434.67,44492,40033,2239,32578,34817,5216,2022,'LAGOA',Lagoa,'PB',2508109,1229.0,1229,102.4,102.4,1,60.0,60.0,Pequeno I
1341,1344,250820,5856,5607,156,4978,5134,473,5726.0,5506.83,145.08,4934.58,5079.67,427.17,68712,66082,1741,59215,60956,5126,2022,'LAGOA DE DENTRO',Lagoa de Dentro,'PB',2508208,1688.0,1688,168.8,168.8,1,81.0,81.0,Pequeno I
1342,1345,250830,19762,17175,827,11818,12645,4530,19316.25,16897.33,839.83,11451.08,12290.92,4606.42,231795,202768,10078,137413,147491,55277,2022,'LAGOA SECA',Lagoa Seca,'PB',2508307,4578.0,4578,381.5,381.5,1,290.0,290.0,Pequeno II
1343,1346,250840,2586,2369,138,1728,1866,503,2543.25,2334.58,130.08,1742.08,1872.17,462.42,30519,28015,1561,20905,22466,5549,2022,'LASTRO',Lastro,'PB',2508406,1180.0,1180,98.3,98.3,1,30.0,30.0,Pequeno I
1344,1347,250850,5587,5099,125,4069,4194,905,5479.25,5076.83,159.25,4102.25,4261.5,815.33,65751,60922,1911,49227,51138,9784,2022,'LIVRAMENTO',Livramento,'PB',2508505,282.0,282,23.5,23.5,1,26.0,26.0,Pequeno I
1345,1348,250855,3277,3055,118,2455,2573,482,3158.42,2939.17,135.67,2348.33,2484.0,455.17,37901,35270,1628,28180,29808,5462,2022,'LOGRADOURO',Logradouro,'PB',2508554,2882.0,2882,240.2,240.2,1,265.0,265.0,Pequeno I
1346,1349,250860,10846,9684,1413,5398,6811,2873,10603.17,9524.08,1370.33,5391.58,6761.92,2762.17,127238,114289,16444,64699,81143,33146,2022,'LUCENA',Lucena,'PB',2508604,175.0,175,14.6,14.6,1,3.0,3.0,Pequeno I
1347,1350,250870,3002,2674,148,2047,2195,479,2968.08,2671.58,128.17,2086.83,2215.0,456.58,35617,32059,1538,25042,26580,5479,2022,'MAE DAGUA',Mãe D´água,'PB',2508703,1733.0,1733,144.4,144.4,1,68.0,68.0,Pequeno I
1348,1351,250880,4461,3934,302,2873,3175,759,4421.25,3937.83,292.33,2905.75,3198.08,739.75,53055,47254,3508,34869,38377,8877,2022,'MALTA',Malta,'PB',2508802,2839.0,2839,236.6,236.6,1,80.0,80.0,Pequeno I
1349,1352,250890,29908,27740,1086,23041,24127,3613,28593.83,26648.33,1252.42,21782.67,23035.08,3613.25,343126,319780,15029,261392,276421,43359,2022,'MAMANGUAPE',Mamanguape,'PB',2508901,11498.0,11498,958.2,958.2,1,1120.0,1120.0,Pequeno II
1350,1353,250900,9051,8209,232,6799,7031,1178,8673.58,7923.08,218.0,6666.42,6884.42,1038.67,104083,95077,2616,79997,82613,12464,2022,'MANAIRA',Manaíra,'PB',2509008,1198.0,1198,108.9,108.9,1,114.0,114.0,Pequeno I
1351,1354,250905,7421,7098,173,6368,6541,557,7253.33,6955.67,156.17,6287.42,6443.58,512.08,87040,83468,1874,75449,77323,6145,2022,'MARCACAO',Marcação,'PB',2509057,595.0,595,49.6,49.6,1,130.0,130.0,Pequeno I
1352,1355,250910,17507,16050,255,14350,14605,1445,16820.75,15461.25,267.58,13786.58,14054.17,1407.08,201849,185535,3211,165439,168650,16885,2022,'MARI',Mari,'PB',2509107,535.0,535,44.6,44.6,1,45.0,45.0,Pequeno II
1353,1356,250915,5286,4502,52,3985,4037,465,5243.33,4495.33,53.25,4013.0,4066.25,429.08,62920,53944,639,48156,48795,5149,2022,'MARIZOPOLIS',Marizópolis,'PB',2509156,978.0,978,81.5,81.5,1,57.0,57.0,Pequeno I
1354,1357,250920,10068,9366,513,7641,8154,1212,9758.33,9089.33,507.17,7397.25,7904.42,1184.92,117100,109072,6086,88767,94853,14219,2022,'MASSARANDUBA',Massaranduba,'PB',2509206,900.0,900,81.8,81.8,1,,,Pequeno I
1355,1358,250930,6791,6380,339,5050,5389,991,6634.67,6274.0,270.33,5121.5,5391.83,882.17,79616,75288,3244,61458,64702,10586,2022,'MATARACA',Mataraca,'PB',2509305,3965.0,3965,330.4,330.4,1,290.0,290.0,Pequeno I
1356,1359,250933,3862,3511,194,2650,2844,667,3819.33,3499.75,175.67,2679.75,2855.42,644.33,45832,41997,2108,32157,34265,7732,2022,'MATINHAS',Matinhas,'PB',2509339,864.0,864,72.0,72.0,1,35.0,35.0,Pequeno I
1357,1360,250937,2299,2043,77,1657,1734,309,2200.75,1972.08,77.08,1597.42,1674.5,297.58,26409,23665,925,19169,20094,3571,2022,'MATO GROSSO',Mato Grosso,'PB',2509370,985.0,985,82.1,82.1,1,4.0,4.0,Pequeno I
1358,1361,250939,5443,5031,119,4129,4248,783,5292.58,4928.92,134.92,4002.5,4137.42,791.5,63511,59147,1619,48030,49649,9498,2022,'MATUREIA',Maturéia,'PB',2509396,1511.0,1511,125.9,125.9,1,34.0,34.0,Pequeno I
1359,1362,250940,11028,10161,171,8805,8976,1185,10973.83,10209.75,129.67,9045.42,9175.08,1034.67,131686,122517,1556,108545,110101,12416,2022,'MOGEIRO',Mogeiro,'PB',2509404,5076.0,5076,423.0,423.0,1,425.0,425.0,Pequeno I
1360,1363,250950,4792,4240,152,3264,3416,824,4728.42,4215.75,144.83,3297.83,3442.67,773.08,56741,50589,1738,39574,41312,9277,2022,'MONTADAS',Montadas,'PB',2509503,947.0,947,78.9,78.9,1,58.0,58.0,Pequeno I
1361,1364,250960,3472,3189,132,2510,2642,547,3454.83,3198.08,137.5,2537.5,2675.0,523.08,41458,38377,1650,30450,32100,6277,2022,'MONTE HOREBE',Monte Horebe,'PB',2509602,442.0,442,36.8,36.8,1,10.0,10.0,Pequeno I
1362,1365,250970,24212,21817,774,17395,18169,3648,23252.0,21248.0,653.42,17152.67,17806.08,3441.92,279024,254976,7841,205832,213673,41303,2022,'MONTEIRO',Monteiro,'PB',2509701,1037.0,1037,86.4,86.4,1,73.0,73.0,Pequeno II
1363,1366,250980,6717,6308,92,5320,5412,896,6665.83,6297.5,96.92,5365.42,5462.33,835.17,79990,75570,1163,64385,65548,10022,2022,'MULUNGU',Mulungu,'PB',2509800,480.0,2548,40.0,212.3,1,0.0,1019.0,Pequeno I
1364,1367,250990,6815,6140,368,4490,4858,1282,6702.42,6079.5,347.33,4496.33,4843.67,1235.83,80429,72954,4168,53956,58124,14830,2022,'NATUBA',Natuba,'PB',2509909,726.0,726,60.5,60.5,1,33.0,33.0,Pequeno I
1365,1368,251000,6044,5259,164,4170,4334,925,5988.0,5242.42,180.92,4194.5,4375.42,867.0,71856,62909,2171,50334,52505,10404,2022,'NAZAREZINHO',Nazarezinho,'PB',2510006,578.0,578,48.2,48.2,1,39.0,39.0,Pequeno I
1366,1369,251010,7415,6863,146,5853,5999,864,7476.75,6996.92,137.0,6081.25,6218.25,778.67,89721,83963,1644,72975,74619,9344,2022,'NOVA FLORESTA',Nova Floresta,'PB',2510105,1746.0,1746,158.7,158.7,1,60.0,60.0,Pequeno I
1367,1370,251020,4671,4366,141,3690,3831,535,4613.33,4332.83,143.42,3669.0,3812.42,520.42,55360,51994,1721,44028,45749,6245,2022,'NOVA OLINDA',Nova Olinda,'PB',2510204,211.0,211,19.2,19.2,1,21.0,21.0,Pequeno I
1368,1371,251030,2962,2565,162,1708,1870,695,2911.08,2535.5,154.33,1685.08,1839.42,696.08,34933,30426,1852,20221,22073,8353,2022,'NOVA PALMEIRA',Nova Palmeira,'PB',2510303,818.0,818,74.4,74.4,1,70.0,70.0,Pequeno I
1369,1372,251040,5451,4902,107,4121,4228,674,5376.33,4859.75,125.33,4061.25,4186.58,673.17,64516,58317,1504,48735,50239,8078,2022,'OLHO DAGUA',Olho D´água,'PB',2510402,567.0,567,47.2,47.2,1,6.0,6.0,Pequeno I
1370,1373,251050,3105,2705,158,1813,1971,734,3050.83,2684.75,172.17,1837.83,2010.0,674.75,36610,32217,2066,22054,24120,8097,2022,'OLIVEDOS',Olivedos,'PB',2510501,276.0,276,23.0,23.0,1,26.0,26.0,Pequeno I
1371,1374,251060,2642,2173,82,1602,1684,489,2503.0,2114.33,68.0,1583.42,1651.42,462.92,30036,25372,816,19001,19817,5555,2022,'OURO VELHO',Ouro Velho,'PB',2510600,2740.0,2740,228.3,228.3,1,843.0,843.0,Pequeno I
1372,1375,251065,1412,1120,38,752,790,330,1392.0,1121.5,38.25,761.17,799.42,322.08,16704,13458,459,9134,9593,3865,2022,'PARARI',Parari,'PB',2510659,1752.0,1752,146.0,146.0,1,148.0,148.0,Pequeno I
1373,1376,251070,2034,1815,43,1462,1505,310,2004.0,1801.25,50.17,1484.33,1534.5,266.75,24048,21615,602,17812,18414,3201,2022,'PASSAGEM',Passagem,'PB',2510709,1517.0,1517,126.4,126.4,1,66.0,66.0,Pequeno I
1374,1377,251080,56778,49926,8337,28796,37133,12793,54094.75,47881.33,7625.0,28318.67,35943.67,11937.67,649137,574576,91500,339824,431324,143252,2022,'PATOS',Patos,'PB',2510808,12186.0,12186,1015.5,1015.5,4,585.0,585.0,Grande
1375,1378,251090,8788,7840,201,6281,6482,1358,8619.83,7748.17,207.58,6199.83,6407.42,1340.75,103438,92978,2491,74398,76889,16089,2022,'PAULISTA',Paulista,'PB',2510907,423.0,423,42.3,42.3,1,42.0,42.0,Pequeno I
1376,1379,251100,2730,2450,104,1715,1819,631,2719.75,2477.5,103.67,1805.33,1909.0,568.5,32637,29730,1244,21664,22908,6822,2022,'PEDRA BRANCA',Pedra Branca,'PB',2511004,667.0,667,55.6,55.6,1,44.0,44.0,Pequeno I
1377,1380,251110,5149,4443,281,3239,3520,923,5035.83,4403.67,250.67,3205.25,3455.92,947.75,60430,52844,3008,38463,41471,11373,2022,'PEDRA LAVRADA',Pedra Lavrada,'PB',2511103,1408.0,1408,117.3,117.3,1,30.0,30.0,Pequeno I
1378,1381,251120,22558,20646,1524,15063,16587,4059,22081.0,20358.42,1445.0,15198.67,16643.67,3714.75,264972,244301,17340,182384,199724,44577,2022,'PEDRAS DE FOGO',Pedras de Fogo,'PB',2511202,5303.0,5303,441.9,441.9,1,257.0,257.0,Pequeno II
1379,1382,251130,10069,9282,123,8571,8694,588,9684.67,8940.83,123.25,8208.75,8332.0,608.83,116216,107290,1479,98505,99984,7306,2022,'PIANCO',Piancó,'PB',2511301,247.0,247,20.6,20.6,1,21.0,21.0,Pequeno I
1380,1383,251140,12475,11620,399,9131,9530,2090,12367.92,11596.33,326.92,9311.0,9637.92,1958.42,148415,139156,3923,111732,115655,23501,2022,'PICUI',Picuí,'PB',2511400,1776.0,1776,161.5,161.5,1,63.0,63.0,Pequeno I
1381,1384,251150,8553,8071,281,6736,7017,1054,8326.17,7891.17,319.17,6600.58,6919.75,971.42,99914,94694,3830,79207,83037,11657,2022,'PILAR',Pilar,'PB',2511509,2165.0,2165,180.4,180.4,1,203.0,203.0,Pequeno I
1382,1385,251160,6904,6322,132,5551,5683,639,6751.42,6227.75,152.58,5412.0,5564.58,663.17,81017,74733,1831,64944,66775,7958,2022,'PILOES',Pilões,'PB',2511608,707.0,707,64.3,64.3,1,73.0,73.0,Pequeno I
1383,1386,251170,4862,4536,106,3978,4084,452,4726.92,4421.17,95.75,3907.67,4003.42,417.75,56723,53054,1149,46892,48041,5013,2022,'PILOEZINHOS',Pilõezinhos,'PB',2511707,2571.0,2571,214.2,214.2,1,199.0,199.0,Pequeno I
1384,1387,251180,7658,6852,560,4823,5383,1469,7485.33,6734.75,476.5,4834.0,5310.5,1424.25,89824,80817,5718,58008,63726,17091,2022,'PIRPIRITUBA',Pirpirituba,'PB',2511806,1500.0,1500,136.4,136.4,1,487.0,487.0,Pequeno I
1385,1388,251190,13371,12606,257,10850,11107,1499,12579.67,11948.83,259.25,10475.75,10735.0,1213.83,150956,143386,3111,125709,128820,14566,2022,'PITIMBU',Pitimbu,'PB',2511905,2336.0,2336,194.7,194.7,2,70.0,70.0,Pequeno I
1386,1389,251200,13635,12733,354,10774,11128,1605,13350.08,12550.58,322.42,10849.25,11171.67,1378.92,160201,150607,3869,130191,134060,16547,2022,'POCINHOS',Pocinhos,'PB',2512002,6292.0,6292,524.3,524.3,1,298.0,298.0,Pequeno I
1387,1390,251203,3401,3095,160,1955,2115,980,3346.83,3096.33,157.33,2115.67,2273.0,823.33,40162,37156,1888,25388,27276,9880,2022,'POCO DANTAS',Poço Dantas,'PB',2512036,164.0,164,13.7,13.7,1,19.0,19.0,Pequeno I
1388,1391,251207,3226,2677,91,1762,1853,824,3212.58,2686.0,95.5,1796.25,1891.75,794.25,38551,32232,1146,21555,22701,9531,2022,'POCO DE JOSE DE MOURA',Poço de José de Moura,'PB',2512077,1995.0,1995,166.2,166.2,1,98.0,98.0,Pequeno I
1389,1392,251210,21737,19167,1213,13977,15190,3977,21180.42,18846.08,1048.17,14030.83,15079.0,3767.08,254165,226153,12578,168370,180948,45205,2022,'POMBAL',Pombal,'PB',2512101,8845.0,8845,737.1,737.1,2,143.0,143.0,Pequeno II
1390,1393,251220,3323,2763,207,2106,2313,450,3215.75,2729.67,191.25,2084.58,2275.83,453.83,38589,32756,2295,25015,27310,5446,2022,'PRATA',Prata,'PB',2512200,811.0,811,67.6,67.6,1,61.0,61.0,Pequeno I
1391,1394,251230,14204,12784,415,9778,10193,2591,13869.17,12561.42,413.5,9701.83,10115.33,2446.08,166430,150737,4962,116422,121384,29353,2022,'PRINCESA ISABEL',Princesa Isabel,'PB',2512309,2222.0,2222,185.2,185.2,1,147.0,147.0,Pequeno II
1392,1395,251240,11402,10155,763,6744,7507,2648,11045.75,9905.25,639.33,6873.75,7513.08,2392.17,132549,118863,7672,82485,90157,28706,2022,'PUXINANA',Puxinanã,'PB',2512408,2978.0,4510,248.2,375.8,1,802.0,802.0,Pequeno I
1393,1396,251250,33596,30527,1971,22648,24619,5908,31979.58,29296.33,1758.33,21904.5,23662.83,5633.5,383755,351556,21100,262854,283954,67602,2022,'QUEIMADAS',Queimadas,'PB',2512507,2000.0,2000,166.7,166.7,1,140.0,140.0,Pequeno II
1394,1397,251260,1550,1422,63,1080,1143,279,1475.0,1375.08,72.33,1055.17,1127.5,247.58,17700,16501,868,12662,13530,2971,2022,'QUIXABA',Quixabá,'PB',2512606,1195.0,1195,99.6,99.6,1,336.0,336.0,Pequeno I
1395,1398,251270,14344,13488,689,10851,11540,1948,14078.0,13307.08,682.67,10763.58,11446.25,1860.83,168936,159685,8192,129163,137355,22330,2022,'REMIGIO',Remígio,'PB',2512705,2187.0,2187,182.2,182.2,1,473.0,473.0,Pequeno I
1396,1399,251272,3910,3733,178,3163,3341,392,3809.25,3649.92,200.75,3041.58,3242.33,407.58,45711,43799,2409,36499,38908,4891,2022,'PEDRO REGIS',Pedro Régis,'PB',2512721,3723.0,3723,310.2,310.2,1,665.0,665.0,Pequeno I
1397,1400,251274,2596,2220,179,1337,1516,704,2593.0,2243.67,184.75,1392.25,1577.0,666.67,31116,26924,2217,16707,18924,8000,2022,'RIACHAO',Riachão,'PB',2512747,3233.0,3233,269.4,269.4,1,174.0,174.0,Pequeno I
1398,1401,251275,3987,3521,176,2795,2971,550,3842.25,3425.33,181.67,2650.83,2832.5,592.83,46107,41104,2180,31810,33990,7114,2022,'RIACHAO DO BACAMARTE',Riachão do Bacamarte,'PB',2512754,1626.0,1626,135.5,135.5,1,826.0,826.0,Pequeno I
1399,1402,251276,3945,3622,145,2802,2947,675,3867.0,3584.0,152.58,2779.08,2931.67,652.33,46404,43008,1831,33349,35180,7828,2022,'RIACHAO DO POCO',Riachão do Poço,'PB',2512762,1203.0,1203,100.2,100.2,1,73.0,73.0,Pequeno I
1400,1403,251278,1864,1710,84,1328,1412,298,1790.58,1663.25,103.83,1303.0,1406.83,256.42,21487,19959,1246,15636,16882,3077,2022,'RIACHO DE SANTO ANTONIO',Riacho de Santo Antônio,'PB',2512788,511.0,511,42.6,42.6,1,20.0,20.0,Pequeno I
1401,1404,251280,6989,6556,165,5707,5872,684,6776.75,6400.83,177.83,5518.67,5696.5,704.33,81321,76810,2134,66224,68358,8452,2022,'RIACHO DOS CAVALOS',Riacho Dos Cavalos,'PB',2512804,655.0,655,54.6,54.6,1,71.0,71.0,Pequeno I
1402,1405,251290,17735,16734,586,14574,15160,1574,16410.92,15563.5,545.58,13568.67,14114.25,1449.25,196931,186762,6547,162824,169371,17391,2022,'RIO TINTO',Rio Tinto,'PB',2512903,981.0,981,89.2,89.2,1,46.0,46.0,Pequeno II
1403,1406,251300,2697,2484,63,2054,2117,367,2683.92,2510.67,65.75,2110.0,2175.75,334.92,32207,30128,789,25320,26109,4019,2022,'SALGADINHO',Salgadinho,'PB',2513000,518.0,518,43.2,43.2,1,12.0,12.0,Pequeno I
1404,1407,251310,8531,7755,224,6320,6544,1211,8307.58,7615.17,266.75,6189.67,6456.42,1158.75,99691,91382,3201,74276,77477,13905,2022,'SALGADO DE SAO FELIX',Salgado de São Félix,'PB',2513109,2168.0,2168,180.7,180.7,1,152.0,152.0,Pequeno I
1405,1408,251315,6110,5666,279,4353,4632,1034,5962.0,5557.67,322.92,4289.42,4612.33,945.33,71544,66692,3875,51473,55348,11344,2022,'SANTA CECILIA',Santa Cecília,'PB',2513158,1825.0,1825,152.1,152.1,1,250.0,250.0,Pequeno I
1406,1409,251320,4729,3881,144,2849,2993,888,4619.0,3808.67,138.5,2812.75,2951.25,857.42,55428,45704,1662,33753,35415,10289,2022,'SANTA CRUZ',Santa Cruz,'PB',2513208,434.0,434,36.2,36.2,1,16.0,16.0,Pequeno I
1407,1410,251330,5232,4606,82,3986,4068,538,5190.5,4632.42,84.17,4051.75,4135.92,496.5,62286,55589,1010,48621,49631,5958,2022,'SANTA HELENA',Santa Helena,'PB',2513307,498.0,498,41.5,41.5,1,20.0,20.0,Pequeno I
1408,1411,251335,3302,3080,97,2683,2780,300,3222.25,3032.75,104.17,2660.83,2765.0,267.75,38667,36393,1250,31930,33180,3213,2022,'SANTA INES',Santa Inês,'PB',2513356,740.0,740,67.3,67.3,1,,,Pequeno I
1409,1412,251340,9704,8459,326,6611,6937,1522,9494.75,8336.17,350.42,6507.42,6857.83,1478.33,113937,100034,4205,78089,82294,17740,2022,'SANTA LUZIA',Santa Luzia,'PB',2513406,1470.0,1470,122.5,122.5,1,153.0,153.0,Pequeno I
1410,1413,251350,3248,3050,98,2487,2585,465,3202.83,3028.75,106.92,2471.42,2578.33,450.42,38434,36345,1283,29657,30940,5405,2022,'SANTANA DE MANGUEIRA',Santana de Mangueira,'PB',2513505,237.0,237,19.8,19.8,1,6.0,6.0,Pequeno I
1411,1414,251360,5395,4680,82,3620,3702,978,5347.75,4709.17,88.83,3722.08,3810.92,898.25,64173,56510,1066,44665,45731,10779,2022,'SANTANA DOS GARROTES',Santana Dos Garrotes,'PB',2513604,360.0,360,30.0,30.0,1,10.0,10.0,Pequeno I
1412,1415,251365,2247,1750,56,1346,1402,348,2182.17,1755.83,46.08,1359.58,1405.67,350.17,26186,21070,553,16315,16868,4202,2022,'JOCA CLAUDINO',Santarém,'PB',2513653,1222.0,1222,101.8,101.8,1,275.0,275.0,Pequeno I
1413,1416,251370,77470,70871,10144,43585,53729,17142,71609.42,65819.5,8763.08,41747.08,50510.17,15309.33,859313,789834,105157,500965,606122,183712,2022,'SANTA RITA',Santa Rita,'PB',2513703,4957.0,4957,413.1,413.1,7,760.0,760.0,Grande
1414,1417,251380,4022,3635,128,3063,3191,444,3888.5,3536.25,112.83,2987.5,3100.33,435.92,46662,42435,1354,35850,37204,5231,2022,'SANTA TERESINHA',Santa Teresinha,'PB',2513802,1027.0,1027,85.6,85.6,1,29.0,29.0,Pequeno I
1415,1418,251385,2217,1818,81,1207,1288,530,2138.58,1787.33,71.92,1202.25,1274.17,513.17,25663,21448,863,14427,15290,6158,2022,'SANTO ANDRE',Santo André,'PB',2513851,980.0,980,81.7,81.7,1,68.0,68.0,Pequeno I
1416,1419,251390,22029,20407,1709,14684,16393,4014,20721.08,19298.17,1662.25,13685.17,15347.42,3950.75,248653,231578,19947,164222,184169,47409,2022,'SAO BENTO',São Bento,'PB',2513901,1885.0,1885,157.1,157.1,1,119.0,119.0,Pequeno II
1417,1420,251392,3026,2686,109,2063,2172,514,2952.92,2661.42,111.08,2068.25,2179.33,482.08,35435,31937,1333,24819,26152,5785,2022,'SAO BENTINHO',São Bentinho,'PB',2513927,2129.0,2129,177.4,177.4,1,131.0,131.0,Pequeno I
1418,1421,251394,2052,1785,180,1153,1333,452,2007.5,1749.08,170.83,1143.5,1314.33,434.75,24090,20989,2050,13722,15772,5217,2022,'SAO DOMINGOS DO CARIRI',São Domingos do Cariri,'PB',2513943,911.0,911,75.9,75.9,1,61.0,61.0,Pequeno I
1419,1422,251396,2115,1866,74,1223,1297,569,2005.08,1789.67,78.08,1175.58,1253.67,536.0,24061,21476,937,14107,15044,6432,2022,'SAO DOMINGOS',São Domingos de Pombal,'PB',2513968,498.0,498,41.5,41.5,1,27.0,27.0,Pequeno I
1420,1423,251398,2856,2194,81,1514,1595,599,2800.83,2198.0,80.17,1547.25,1627.42,570.58,33610,26376,962,18567,19529,6847,2022,'SAO FRANCISCO',São Francisco,'PB',2513984,720.0,720,60.0,60.0,1,15.0,15.0,Pequeno I
1421,1424,251400,3436,2972,107,2326,2433,539,3347.25,2914.33,98.92,2304.0,2402.92,511.42,40167,34972,1187,27648,28835,6137,2022,'SAO JOAO DO CARIRI',São João do Cariri,'PB',2514008,456.0,456,38.0,38.0,1,46.0,46.0,Pequeno I
1422,1425,251410,3892,3299,51,2662,2713,586,3842.58,3318.58,50.5,2716.33,2766.83,551.75,46111,39823,606,32596,33202,6621,2022,'SAO JOAO DO TIGRE',São João do Tigre,'PB',2514107,371.0,371,30.9,30.9,1,48.0,48.0,Pequeno I
1423,1426,251420,5700,5119,173,3995,4168,951,5512.75,5024.83,161.25,3927.67,4088.92,935.92,66153,60298,1935,47132,49067,11231,2022,'SAO JOSE DA LAGOA TAPADA',São José da Lagoa Tapada,'PB',2514206,1507.0,1507,125.6,125.6,1,68.0,68.0,Pequeno I
1424,1427,251430,4856,4531,197,3704,3901,630,4831.17,4533.83,181.75,3817.5,3999.25,534.58,57974,54406,2181,45810,47991,6415,2022,'SAO JOSE DE CAIANA',São José de Caiana,'PB',2514305,2120.0,2120,176.7,176.7,1,127.0,127.0,Pequeno I
1425,1428,251440,3197,2762,157,2055,2212,550,3157.83,2742.58,140.17,2090.0,2230.17,512.42,37894,32911,1682,25080,26762,6149,2022,'SAO JOSE DE ESPINHARAS',São José de Espinharas,'PB',2514404,2125.0,2125,177.1,177.1,1,74.0,74.0,Pequeno I
1426,1429,251445,4836,4581,97,3855,3952,629,4699.08,4490.5,114.25,3794.75,3909.0,581.5,56389,53886,1371,45537,46908,6978,2022,'SAO JOSE DOS RAMOS',São José Dos Ramos,'PB',2514453,3002.0,3002,250.2,250.2,1,327.0,327.0,Pequeno I
1427,1430,251450,14027,13076,226,11133,11359,1717,13723.25,12864.08,312.58,10878.0,11190.58,1673.5,164679,154369,3751,130536,134287,20082,2022,'SAO JOSE DE PIRANHAS',São José de Piranhas,'PB',2514503,609.0,609,76.1,76.1,1,35.0,35.0,Pequeno I
1428,1431,251455,2788,2595,100,1994,2094,501,2765.75,2597.83,92.83,2036.92,2129.75,468.08,33189,31174,1114,24443,25557,5617,2022,'SAO JOSE DE PRINCESA',São José de Princesa,'PB',2514552,1356.0,1356,113.0,113.0,1,18.0,18.0,Pequeno I
1429,1432,251460,2879,2497,202,1786,1988,509,2812.08,2492.42,180.92,1854.67,2035.58,456.83,33745,29909,2171,22256,24427,5482,2022,'SAO JOSE DO BONFIM',São José do Bonfim,'PB',2514602,3226.0,3226,268.8,268.8,1,663.0,663.0,Pequeno I
1430,1433,251465,1501,1320,62,948,1010,310,1429.5,1276.08,55.17,927.83,983.0,293.08,17154,15313,662,11134,11796,3517,2022,'SAO JOSE DO BREJO DO CRUZ',São José do Brejo do Cruz,'PB',2514651,532.0,532,44.3,44.3,1,14.0,14.0,Pequeno I
1431,1434,251470,3537,2817,387,1341,1728,1089,3488.92,2804.33,375.33,1366.0,1741.33,1063.0,41867,33652,4504,16392,20896,12756,2022,'SAO JOSE DO SABUGI',São José do Sabugi,'PB',2514701,413.0,413,34.4,34.4,1,11.0,11.0,Pequeno I
1432,1435,251480,2866,2372,61,1666,1727,645,2817.67,2385.83,74.58,1710.5,1785.08,600.75,33812,28630,895,20526,21421,7209,2022,'SAO JOSE DOS CORDEIROS',São José Dos Cordeiros,'PB',2514800,730.0,730,73.0,73.0,1,,,Pequeno I
1433,1436,251490,5658,5004,269,3755,4024,980,5473.25,4883.67,252.25,3675.42,3927.67,956.0,65679,58604,3027,44105,47132,11472,2022,'SAO MAMEDE',São Mamede,'PB',2514909,3398.0,3398,283.2,283.2,1,143.0,143.0,Pequeno I
1434,1437,251500,6006,5670,188,4727,4915,755,5885.33,5604.92,159.25,4784.25,4943.5,661.42,70624,67259,1911,57411,59322,7937,2022,'SAO MIGUEL DE TAIPU',São Miguel de Taipu,'PB',2515005,493.0,493,41.1,41.1,1,28.0,28.0,Pequeno I
1435,1438,251510,8624,7537,409,4973,5382,2155,8435.5,7426.08,384.25,4977.08,5361.33,2064.75,101226,89113,4611,59725,64336,24777,2022,'SAO SEBASTIAO DE LAGOA DE,São Sebastião de Lagoa de Roça,'PB',2515104,668.0,668,55.7,55.7,1,47.0,47.0,Pequeno I
1436,1439,251520,2862,2320,166,1442,1608,712,2856.83,2355.75,178.25,1469.83,1648.08,707.67,34282,28269,2139,17638,19777,8492,2022,'SAO SEBASTIAO DO UMBUZEIRO,São Sebastião do Umbuzeiro,'PB',2515203,1121.0,1121,93.4,93.4,1,98.0,98.0,Pequeno I
1437,1440,251530,38782,34578,718,29971,30689,3889,37241.08,33303.5,710.75,28967.0,29677.75,3625.75,446893,399642,8529,347604,356133,43509,2022,'SAPE',Sapé,'PB',2515302,3915.0,3915,326.2,326.2,2,85.0,85.0,Médio
1438,1441,251540,9223,8507,329,6732,7061,1446,9087.83,8443.58,271.33,6842.58,7113.92,1329.67,109054,101323,3256,82111,85367,15956,2022,'SAO VICENTE DO SERIDO',Seridó,'PB',2515401,5590.0,5590,465.8,465.8,1,447.0,447.0,Pequeno I
1439,1442,251550,10086,8891,214,7516,7730,1161,9781.42,8688.58,229.33,7261.0,7490.33,1198.25,117377,104263,2752,87132,89884,14379,2022,'SERRA BRANCA',Serra Branca,'PB',2515500,1615.0,1615,134.6,134.6,1,122.0,122.0,Pequeno I
1440,1443,251560,1823,1716,162,1186,1348,368,1814.58,1716.75,163.67,1190.83,1354.5,362.25,21775,20601,1964,14290,16254,4347,2022,'SERRA DA RAIZ',Serra da Raiz,'PB',2515609,895.0,895,74.6,74.6,1,350.0,350.0,Pequeno I
1441,1444,251570,2857,2464,104,1853,1957,507,2832.25,2460.67,102.75,1883.75,1986.5,474.17,33987,29528,1233,22605,23838,5690,2022,'SERRA GRANDE',Serra Grande,'PB',2515708,594.0,594,49.5,49.5,1,60.0,60.0,Pequeno I
1442,1445,251580,5354,4923,96,4076,4172,751,5166.58,4783.25,116.33,3960.67,4077.0,706.25,61999,57399,1396,47528,48924,8475,2022,'SERRA REDONDA',Serra Redonda,'PB',2515807,2789.0,6031,232.4,502.6,1,0.0,2129.0,Pequeno I
1443,1446,251590,4231,3856,137,3208,3345,511,4158.0,3815.92,133.33,3189.67,3323.0,492.92,49896,45791,1600,38276,39876,5915,2022,'SERRARIA',Serraria,'PB',2515906,2727.0,2727,227.2,227.2,1,118.0,118.0,Pequeno I
1444,1447,251593,3101,2876,305,1886,2191,685,2995.25,2787.42,284.83,1843.0,2127.83,659.58,35943,33449,3418,22116,25534,7915,2022,'SERTAOZINHO',Sertãozinho,'PB',2515930,1481.0,1481,123.4,123.4,1,14.0,14.0,Pequeno I
1445,1448,251597,6266,5913,68,5350,5418,495,6134.75,5803.08,70.58,5235.5,5306.08,497.0,73617,69637,847,62826,63673,5964,2022,'SOBRADO',Sobrado,'PB',2515971,102.0,102,8.5,8.5,1,3.0,3.0,Pequeno I
1446,1449,251600,18809,17228,788,13767,14555,2673,18231.17,16782.0,739.0,13532.33,14271.33,2510.67,218774,201384,8868,162388,171256,30128,2022,'SOLANEA',Solânea,'PB',2516003,2719.0,2719,226.6,226.6,1,169.0,169.0,Pequeno II
1447,1450,251610,9861,8920,713,6480,7193,1727,9533.33,8716.33,668.67,6284.42,6953.08,1763.25,114400,104596,8024,75413,83437,21159,2022,'SOLEDADE',Soledade,'PB',2516102,4026.0,4026,335.5,335.5,1,128.0,128.0,Pequeno I
1448,1451,251615,3496,2998,62,2448,2510,488,3431.33,2966.92,65.42,2381.58,2447.0,519.92,41176,35603,785,28579,29364,6239,2022,'SOSSEGO',Sossêgo,'PB',2516151,2201.0,2201,183.4,183.4,1,152.0,152.0,Pequeno I
1449,1452,251620,48005,41494,463,36050,36513,4981,46887.33,40740.17,440.75,35596.17,36036.92,4703.25,562648,488882,5289,427154,432443,56439,2022,'SOUSA',Sousa,'PB',2516201,7745.0,13822,645.4,1151.8,2,69.0,69.0,Médio
1450,1453,251630,12694,10977,627,8284,8911,2066,12327.25,10755.67,557.58,8102.92,8660.5,2095.17,147927,129068,6691,97235,103926,25142,2022,'SUME',Sumé,'PB',2516300,702.0,702,58.5,58.5,1,26.0,26.0,Pequeno I
1451,1454,251640,6327,5879,90,5185,5275,604,6254.5,5838.92,105.17,5168.67,5273.83,565.08,75054,70067,1262,62024,63286,6781,2022,'TACIMA',Campo de Santana,'PB',2516409,850.0,850,85.0,85.0,1,78.0,78.0,Pequeno I
1452,1455,251650,11390,10432,327,8700,9027,1405,11328.75,10474.83,354.92,8886.33,9241.25,1233.58,135945,125698,4259,106636,110895,14803,2022,'TAPEROA',Taperoá,'PB',2516508,1608.0,2851,134.0,237.6,1,0.0,1243.0,Pequeno I
1453,1456,251660,11242,10325,251,8334,8585,1740,11115.5,10275.75,291.17,8400.67,8691.83,1583.92,133386,123309,3494,100808,104302,19007,2022,'TAVARES',Tavares,'PB',2516607,577.0,1589,48.1,132.4,1,32.0,32.0,Pequeno I
1454,1457,251670,12556,11723,223,10485,10708,1015,12259.67,11492.25,240.17,10263.92,10504.08,988.17,147116,137907,2882,123167,126049,11858,2022,'TEIXEIRA',Teixeira,'PB',2516706,1562.0,2643,130.2,220.2,1,100.0,100.0,Pequeno I
1455,1458,251675,2249,2110,117,1799,1916,194,2164.83,2047.42,133.83,1687.0,1820.83,226.58,25978,24569,1606,20244,21850,2719,2022,'TENORIO',Tenório,'PB',2516755,727.0,727,60.6,60.6,1,13.0,13.0,Pequeno I
1456,1459,251680,7250,6586,197,5374,5571,1015,7164.75,6539.42,177.58,5432.17,5609.75,929.67,85977,78473,2131,65186,67317,11156,2022,'TRIUNFO',Triunfo,'PB',2516805,2745.0,2745,228.8,228.8,1,201.0,201.0,Pequeno I
1457,1460,251690,9881,8839,362,6621,6983,1856,9563.0,8638.25,334.83,6519.08,6853.92,1784.33,114756,103659,4018,78229,82247,21412,2022,'UIRAUNA',Uiraúna,'PB',2516904,1670.0,4264,139.2,355.3,1,0.0,1396.0,Pequeno I
1458,1461,251700,6734,6072,174,4863,5037,1035,6545.42,5937.08,178.0,4788.17,4966.17,970.92,78545,71245,2136,57458,59594,11651,2022,'UMBUZEIRO',Umbuzeiro,'PB',2517001,3529.0,3529,294.1,294.1,1,137.0,137.0,Pequeno I
1459,1462,251710,2222,1707,115,993,1108,599,2182.33,1696.42,129.08,948.42,1077.5,618.92,26188,20357,1549,11381,12930,7427,2022,'VARZEA',Várzea,'PB',2517100,1305.0,1305,108.8,108.8,1,18.0,18.0,Pequeno I
1460,1463,251720,3990,3423,97,2539,2636,787,3939.92,3421.58,97.0,2564.75,2661.75,759.83,47279,41059,1164,30777,31941,9118,2022,'VIEIROPOLIS',Vieirópolis,'PB',2517209,3190.0,4214,265.8,351.2,1,252.0,252.0,Pequeno I
1461,1464,251740,1966,1692,103,1212,1315,377,1881.25,1626.0,106.83,1146.5,1253.33,372.67,22575,19512,1282,13758,15040,4472,2022,'ZABELE',Zabelê,'PB',2517407,961.0,961,80.1,80.1,1,23.0,23.0,Pequeno I
1462,1465,260005,72718,64772,3801,50455,54256,10516,69321.67,62072.92,3737.92,47984.42,51722.33,10350.58,831860,744875,44855,575813,620668,124207,2022,'ABREU E LIMA',Abreu e Lima,'PE',2600054,7291.0,7291,662.8,662.8,1,565.0,565.0,Médio
1463,1466,260010,29560,26042,1732,16052,17784,8258,28797.92,25510.33,1738.33,15541.92,17280.25,8230.08,345575,306124,20860,186503,207363,98761,2022,'AFOGADOS DA INGAZEIRA',Afogados da Ingazeira,'PE',2600104,1804.0,1804,150.3,150.3,1,121.0,121.0,Pequeno II
1464,1467,260020,16806,14722,282,12232,12514,2208,16628.58,14708.75,335.67,12306.17,12641.83,2066.92,199543,176505,4028,147674,151702,24803,2022,'AFRANIO',Afrânio,'PE',2600203,676.0,676,56.3,56.3,1,80.0,80.0,Pequeno I
1465,1468,260030,19577,17545,291,14962,15253,2292,18807.83,16992.08,364.0,14171.58,14535.58,2456.5,225694,203905,4368,170059,174427,29478,2022,'AGRESTINA',Agrestina,'PE',2600302,3979.0,3979,331.6,331.6,1,221.0,221.0,Pequeno II
1466,1469,260040,20302,18326,1189,13521,14710,3616,20120.58,18285.25,1252.17,13576.25,14828.42,3456.83,241447,219423,15026,162915,177941,41482,2022,'AGUA PRETA',Água Preta,'PE',2600401,7505.0,7505,625.4,625.4,1,605.0,605.0,Pequeno II
1467,1470,260050,38087,35248,672,32635,33307,1941,37444.92,34693.17,700.58,32143.92,32844.5,1848.67,449339,416318,8407,385727,394134,22184,2022,'AGUAS BELAS',Águas Belas,'PE',2600500,1780.0,1780,178.0,178.0,1,45.0,45.0,Pequeno II
1468,1471,260060,10988,9797,660,7537,8197,1600,10792.08,9713.25,659.0,7505.67,8164.67,1548.58,129505,116559,7908,90068,97976,18583,2022,'ALAGOINHA',Alagoinha,'PE',2600609,1054.0,1054,87.8,87.8,1,226.0,226.0,Pequeno I
1469,1472,260070,29331,26630,682,22197,22879,3751,28752.17,26273.42,880.33,21554.83,22435.17,3838.25,345026,315281,10564,258658,269222,46059,2022,'ALIANCA',Aliança,'PE',2600708,5450.0,5450,454.2,454.2,2,264.0,264.0,Pequeno II
1470,1473,260080,16156,14762,312,12449,12761,2001,15774.67,14480.42,337.08,12156.33,12493.42,1987.0,189296,173765,4045,145876,149921,23844,2022,'ALTINHO',Altinho,'PE',2600807,1839.0,1839,153.2,153.2,1,150.0,150.0,Pequeno II
1471,1474,260090,14459,13456,858,10711,11569,1887,13746.0,12837.08,769.25,10258.42,11027.67,1809.42,164952,154045,9231,123101,132332,21713,2022,'AMARAJI',Amaraji,'PE',2600906,1029.0,1029,85.8,85.8,1,80.0,80.0,Pequeno II
1472,1475,260100,8634,7838,154,6801,6955,883,8434.5,7676.25,212.67,6518.58,6731.25,945.0,101214,92115,2552,78223,80775,11340,2022,'ANGELIM',Angelim,'PE',2601003,4093.0,4093,341.1,341.1,1,298.0,298.0,Pequeno I
1473,1476,260105,14487,13621,383,11263,11646,1975,14272.58,13488.08,449.92,11240.75,11690.67,1797.42,171271,161857,5399,134889,140288,21569,2022,'ARACOIABA',Araçoiaba,'PE',2601052,3365.0,3365,280.4,280.4,1,120.0,120.0,Pequeno I
1474,1477,260110,66788,62173,3466,49073,52539,9634,65426.25,61296.67,3208.08,49491.75,52699.83,8596.83,785115,735560,38497,593901,632398,103162,2022,'ARARIPINA',Araripina,'PE',2601102,37369.0,37369,3114.1,3114.1,3,1366.0,1366.0,Médio
1475,1478,260120,42967,38780,3962,26942,30904,7876,41286.25,37554.33,3781.5,26060.67,29842.17,7712.17,495435,450652,45378,312728,358106,92546,2022,'ARCOVERDE',Arcoverde,'PE',2601201,29782.0,29782,2481.8,2481.8,3,1841.0,1841.0,Médio
1476,1479,260130,8716,7949,197,6267,6464,1485,8523.33,7831.42,273.42,6127.33,6400.75,1430.67,102280,93977,3281,73528,76809,17168,2022,'BARRA DE GUABIRABA',Barra de Guabiraba,'PE',2601300,5182.0,5182,431.8,431.8,1,600.0,600.0,Pequeno I
1477,1480,260140,32103,29385,903,24945,25848,3537,30782.92,28400.08,947.75,24339.92,25287.67,3112.42,369395,340801,11373,292079,303452,37349,2022,'BARREIROS',Barreiros,'PE',2601409,3472.0,3472,289.3,289.3,1,328.0,328.0,Pequeno II
1478,1481,260150,8947,8233,221,7336,7557,676,8792.0,8128.92,223.0,7249.58,7472.58,656.33,105504,97547,2676,86995,89671,7876,2022,'BELEM DE MARIA',Belém de Maria,'PE',2601508,307.0,307,25.6,25.6,1,40.0,40.0,Pequeno I
1479,1482,260160,17972,16474,270,15128,15398,1076,17664.08,16277.75,275.83,14983.67,15259.5,1018.25,211969,195333,3310,179804,183114,12219,2022,'BELEM DE SAO FRANCISCO',Belém de São Francisco,'PE',2601607,3104.0,3104,258.7,258.7,1,44.0,44.0,Pequeno II
1480,1483,260170,55365,49994,2510,39755,42265,7729,53311.42,48596.5,2410.92,39053.92,41464.83,7131.67,639737,583158,28931,468647,497578,85580,2022,'BELO JARDIM',Belo Jardim,'PE',2601706,18610.0,18610,1550.8,1550.8,3,2490.0,2490.0,Médio
1481,1484,260180,9958,9002,295,7500,7795,1207,9751.42,8925.0,295.25,7513.67,7808.92,1116.08,117017,107100,3543,90164,93707,13393,2022,'BETANIA',Betânia,'PE',2601805,2068.0,15143,172.3,1261.9,1,0.0,1100.0,Pequeno I
1482,1485,260190,43732,39374,358,35392,35750,3624,41566.17,37630.25,426.17,33658.0,34084.17,3546.08,498794,451563,5114,403896,409010,42553,2022,'BEZERROS',Bezerros,'PE',2601904,18261.0,18261,1521.8,1521.8,4,825.0,825.0,Médio
1483,1486,260200,28879,26475,955,23053,24008,2467,28130.5,25899.58,1003.0,22525.17,23528.17,2371.42,337566,310795,12036,270302,282338,28457,2022,'BODOCO',Bodocó,'PE',2602001,6188.0,6188,515.7,515.7,3,390.0,390.0,Pequeno II
1484,1487,260210,34153,30660,1221,24149,25370,5290,33580.58,30334.17,1232.5,24115.67,25348.17,4986.0,402967,364010,14790,289388,304178,59832,2022,'BOM CONSELHO',Bom Conselho,'PE',2602100,15459.0,17719,1288.2,1476.6,3,2190.0,2190.0,Pequeno II
1485,1488,260220,28500,27129,594,23840,24434,2695,27711.08,26481.92,687.33,23332.0,24019.33,2462.58,332533,317783,8248,279984,288232,29551,2022,'BOM JARDIM',Bom Jardim,'PE',2602209,18737.0,21681,1561.4,1806.8,2,1178.0,1178.0,Pequeno II
1486,1489,260230,30526,27987,625,23670,24295,3692,29144.83,26855.25,673.92,22609.08,23283.0,3572.25,349738,322263,8087,271309,279396,42867,2022,'BONITO',Bonito,'PE',2602308,15164.0,15164,1263.7,1263.7,3,793.0,793.0,Pequeno II
1487,1490,260240,8802,7922,280,6149,6429,1493,8691.67,7889.83,322.83,6086.0,6408.83,1481.0,104300,94678,3874,73032,76906,17772,2022,'BREJAO',Brejão,'PE',2602407,1975.0,1975,164.6,164.6,1,270.0,270.0,Pequeno I
1488,1491,260250,6392,5713,237,4444,4681,1032,6205.67,5634.67,245.58,4470.75,4716.33,918.33,74468,67616,2947,53649,56596,11020,2022,'BREJINHO',Brejinho,'PE',2602506,1599.0,1599,133.2,133.2,1,118.0,118.0,Pequeno I
1489,1492,260260,38497,35717,2421,27620,30041,5676,36459.25,33962.58,2078.0,26560.75,28638.75,5323.83,437511,407551,24936,318729,343665,63886,2022,'BREJO DA MADRE DE DEUS',Brejo da Madre de Deus,'PE',2602605,5911.0,5911,492.6,492.6,4,264.0,264.0,Pequeno II
1490,1493,260270,11659,10885,239,9616,9855,1030,11315.83,10597.17,288.17,9225.42,9513.58,1083.58,135790,127166,3458,110705,114163,13003,2022,'BUENOS AIRES',Buenos Aires,'PE',2602704,3101.0,4601,310.1,460.1,1,950.0,950.0,Pequeno I
1491,1494,260280,39358,37222,1277,32126,33403,3819,38839.58,36878.92,1518.83,31598.0,33116.83,3762.08,466075,442547,18226,379176,397402,45145,2022,'BUIQUE',Buíque,'PE',2602803,6273.0,6273,522.8,522.8,2,371.0,371.0,Médio
1492,1495,260290,119596,109342,10020,76821,86841,22501,112992.83,103805.33,9599.42,73336.42,82935.83,20869.5,1355914,1245664,115193,880037,995230,250434,2022,'CABO DE SANTO AGOSTINHO',Cabo de Santo Agostinho,'PE',2602902,45869.0,45869,3822.4,3822.4,11,4003.0,4003.0,Grande
1493,1496,260300,28337,25736,806,21584,22390,3346,27700.0,25426.33,852.17,21377.25,22229.42,3196.92,332400,305116,10226,256527,266753,38363,2022,'CABROBO',Cabrobó,'PE',2603009,7594.0,7594,632.8,632.8,3,605.0,605.0,Pequeno II
1494,1497,260310,16222,15234,667,12866,13533,1701,15500.25,14579.0,699.5,12069.17,12768.67,1810.33,186003,174948,8394,144830,153224,21724,2022,'CACHOEIRINHA',Cachoeirinha,'PE',2603108,7702.0,7702,641.8,641.8,1,459.0,459.0,Pequeno I
1495,1498,260320,23487,21068,560,17159,17719,3349,23250.75,21054.75,630.58,17293.92,17924.5,3130.25,279009,252657,7567,207527,215094,37563,2022,'CAETES',Caetés,'PE',2603207,4054.0,4054,337.8,337.8,1,258.0,258.0,Pequeno II
1496,1499,260330,8066,7141,226,5515,5741,1400,8052.5,7252.25,243.58,5646.0,5889.58,1362.67,96630,87027,2923,67752,70675,16352,2022,'CALCADO',Calçado,'PE',2603306,4759.0,4759,396.6,396.6,1,304.0,304.0,Pequeno I
1497,1500,260340,6103,5598,122,4780,4902,696,5917.25,5448.25,120.75,4679.0,4799.75,648.5,71007,65379,1449,56148,57597,7782,2022,'CALUMBI',Calumbi,'PE',2603405,1047.0,1047,87.2,87.2,1,68.0,68.0,Pequeno I
1498,1501,260345,80643,73031,7466,46897,54363,18668,74957.0,68136.67,7948.25,41761.25,49709.5,18427.17,899484,817640,95379,501135,596514,221126,2022,'CAMARAGIBE',Camaragibe,'PE',2603454,17468.0,17468,1455.7,1455.7,5,1024.0,1024.0,Grande
1499,1502,260350,14196,13084,93,11921,12014,1070,13940.33,12919.5,114.5,11758.33,11872.83,1046.67,167284,155034,1374,141100,142474,12560,2022,'CAMOCIM DE SAO FELIX',Camocim de São Félix,'PE',2603504,0.0,26386,0.0,2198.8,1,0.0,1730.0,Pequeno I
1500,1503,260360,6832,6135,284,4196,4480,1655,6801.83,6205.92,261.83,4315.75,4577.58,1628.33,81622,74471,3142,51789,54931,19540,2022,'CAMUTANGA',Camutanga,'PE',2603603,1847.0,1847,153.9,153.9,1,271.0,271.0,Pequeno I
1501,1504,260370,16541,14822,578,11394,11972,2850,16371.67,14827.92,642.75,11407.08,12049.83,2778.08,196460,177935,7713,136885,144598,33337,2022,'CANHOTINHO',Canhotinho,'PE',2603702,2312.0,2312,192.7,192.7,1,45.0,45.0,Pequeno II
1502,1505,260380,15656,14156,573,10721,11294,2862,15396.67,14030.08,606.67,10728.25,11334.92,2695.17,184760,168361,7280,128739,136019,32342,2022,'CAPOEIRAS',Capoeiras,'PE',2603801,7838.0,7838,653.2,653.2,1,488.0,488.0,Pequeno I
1503,1506,260390,15058,12806,600,8351,8951,3855,14794.0,12828.17,634.42,8425.25,9059.67,3768.5,177528,153938,7613,101103,108716,45222,2022,'CARNAIBA',Carnaíba,'PE',2603900,1159.0,1159,96.6,96.6,1,63.0,63.0,Pequeno I
1504,1507,260392,11980,11376,317,9879,10196,1180,11614.67,11089.75,413.42,9503.5,9916.92,1172.83,139376,133077,4961,114042,119003,14074,2022,'CARNAUBEIRA DA PENHA',Carnaubeira da Penha,'PE',2603926,8572.0,8572,714.3,714.3,1,597.0,597.0,Pequeno I
1505,1508,260400,51900,47432,998,38594,39592,7840,49075.17,45033.58,1118.08,36074.67,37192.75,7840.83,588902,540403,13417,432896,446313,94090,2022,'CARPINA',Carpina,'PE',2604007,13512.0,13512,1126.0,1126.0,2,1031.0,1031.0,Médio
1506,1509,260410,217507,189801,35856,95139,130995,58806,203945.33,179202.17,33712.92,89188.25,122901.17,56301.0,2447344,2150426,404555,1070259,1474814,675612,2022,'CARUARU',Caruaru,'PE',2604106,140322.0,143530,11693.5,11960.8,10,10521.0,10521.0,Grande
1507,1510,260415,12488,11320,134,9680,9814,1506,12216.92,11139.17,191.83,9380.92,9572.75,1566.42,146603,133670,2302,112571,114873,18797,2022,'CASINHAS',Casinhas,'PE',2604155,7284.0,7284,662.2,662.2,3,1165.0,1165.0,Pequeno I
1508,1511,260420,28666,26074,240,24525,24765,1309,27870.0,25508.25,238.0,23913.75,24151.75,1356.5,334440,306099,2856,286965,289821,16278,2022,'CATENDE',Catende,'PE',2604205,2367.0,5372,197.2,447.7,1,0.0,3005.0,Pequeno II
1509,1512,260430,9180,8147,596,5331,5927,2220,9059.58,8115.25,587.83,5384.0,5971.83,2143.42,108715,97383,7054,64608,71662,25721,2022,'CEDRO',Cedro,'PE',2604304,629.0,629,52.4,52.4,1,10.0,10.0,Pequeno I
1510,1513,260440,10687,9912,118,8973,9091,821,10450.83,9738.25,150.92,8658.25,8809.17,929.08,125410,116859,1811,103899,105710,11149,2022,'CHA DE ALEGRIA',Chã de Alegria,'PE',2604403,1371.0,1371,124.6,124.6,1,580.0,580.0,Pequeno I
1511,1514,260450,15407,14393,681,12104,12785,1608,14989.42,14077.0,602.75,11999.33,12602.08,1474.92,179873,168924,7233,143992,151225,17699,2022,'CHA GRANDE',Chã Grande,'PE',2604502,687.0,687,57.2,57.2,2,37.0,37.0,Pequeno II
1512,1515,260460,17022,15329,1338,10190,11528,3801,16528.33,14985.67,1410.92,9721.17,11132.08,3853.58,198340,179828,16931,116654,133585,46243,2022,'CONDADO',Condado,'PE',2604601,1583.0,1583,131.9,131.9,1,121.0,121.0,Pequeno II
1513,1516,260470,13152,12010,288,10820,11108,902,13067.58,12054.33,240.92,11045.5,11286.42,767.92,156811,144652,2891,132546,135437,9215,2022,'CORRENTES',Correntes,'PE',2604700,5039.0,5039,419.9,419.9,3,220.0,220.0,Pequeno I
1514,1517,260480,10686,9648,850,6828,7678,1970,10737.92,9769.92,839.0,6977.17,7816.17,1953.75,128855,117239,10068,83726,93794,23445,2022,'CORTES',Cortês,'PE',2604809,1010.0,1010,84.2,84.2,1,36.0,36.0,Pequeno I
1515,1518,260490,13187,12062,115,10953,11068,994,12964.17,11924.67,124.5,10780.33,10904.83,1019.83,155570,143096,1494,129364,130858,12238,2022,'CUMARU',Cumaru,'PE',2604908,3482.0,3482,290.2,290.2,1,273.0,273.0,Pequeno I
1516,1519,260500,16506,14977,1110,10562,11672,3305,16044.0,14650.83,1020.0,10577.33,11597.33,3053.5,192528,175810,12240,126928,139168,36642,2022,'CUPIRA',Cupira,'PE',2605004,15412.0,15412,1284.3,1284.3,2,775.0,775.0,Pequeno II
1517,1520,260510,27627,24847,440,21824,22264,2583,26456.42,23891.25,419.33,21004.0,21423.33,2467.92,317477,286695,5032,252048,257080,29615,2022,'CUSTODIA',Custódia,'PE',2605103,3735.0,3735,311.2,311.2,2,227.0,227.0,Pequeno II
1518,1521,260515,12915,10716,296,7528,7824,2892,12514.75,10563.92,402.83,7302.08,7704.92,2859.0,150177,126767,4834,87625,92459,34308,2022,'DORMENTES',Dormentes,'PE',2605152,927.0,927,77.2,77.2,1,53.0,53.0,Pequeno I
1519,1522,260520,41477,38219,2242,30616,32858,5361,40361.17,37311.67,1892.17,30350.83,32243.0,5068.67,484334,447740,22706,364210,386916,60824,2022,'ESCADA',Escada,'PE',2605202,17023.0,17023,1418.6,1418.6,3,626.0,626.0,Médio
1520,1523,260530,29624,26992,468,23620,24088,2904,29102.08,26624.92,581.42,23034.75,23616.17,3008.75,349225,319499,6977,276417,283394,36105,2022,'EXU',Exu,'PE',2605301,4293.0,4293,357.8,357.8,2,138.0,138.0,Pequeno II
1521,1524,260540,17386,16134,255,14767,15022,1112,16880.08,15708.33,253.0,14324.92,14577.92,1130.42,202561,188500,3036,171899,174935,13565,2022,'FEIRA NOVA',Feira Nova,'PE',2605400,7718.0,7718,643.2,643.2,1,335.0,335.0,Pequeno II
1522,1525,260545,408,297,63,83,146,151,325.25,239.17,44.67,72.33,117.0,122.17,3903,2870,536,868,1404,1466,2022,'FERNANDO DE NORONHA',Fernando de Noronha,'PE',2605459,226.0,226,18.8,18.8,1,27.0,27.0,Pequeno I
1523,1526,260550,9242,7983,650,4965,5615,2368,9091.42,7943.83,583.25,5175.33,5758.58,2185.25,109097,95326,6999,62104,69103,26223,2022,'FERREIROS',Ferreiros,'PE',2605509,1832.0,1832,152.7,152.7,1,288.0,288.0,Pequeno I
1524,1527,260560,15763,13984,459,11494,11953,2031,15712.75,14101.58,470.83,11722.58,12193.42,1908.17,188553,169219,5650,140671,146321,22898,2022,'FLORES',Flores,'PE',2605608,1957.0,1957,163.1,163.1,1,113.0,113.0,Pequeno II
1525,1528,260570,23474,21612,582,18774,19356,2256,22461.0,20943.75,690.67,17930.0,18620.67,2323.08,269532,251325,8288,215160,223448,27877,2022,'FLORESTA',Floresta,'PE',2605707,4649.0,4649,387.4,387.4,1,336.0,336.0,Pequeno II
1526,1529,260580,11912,11155,64,10271,10335,820,11533.25,10835.58,81.33,9968.25,10049.58,786.0,138399,130027,976,119619,120595,9432,2022,'FREI MIGUELINHO',Frei Miguelinho,'PE',2605806,1263.0,1263,105.2,105.2,1,68.0,68.0,Pequeno I
1527,1530,260590,17327,15813,235,14214,14449,1364,16752.08,15375.0,280.5,13768.25,14048.75,1326.25,201025,184500,3366,165219,168585,15915,2022,'GAMELEIRA',Gameleira,'PE',2605905,842.0,842,70.2,70.2,1,45.0,45.0,Pequeno II
1528,1531,260600,94355,83965,3406,64897,68303,15662,89927.08,80287.92,3298.42,61819.5,65117.92,15170.0,1079125,963455,39581,741834,781415,182040,2022,'GARANHUNS',Garanhuns,'PE',2606002,57958.0,76394,4829.8,6366.2,9,4432.0,7906.0,Grande
1529,1532,260610,21878,20231,1040,15276,16316,3915,20893.0,19497.58,1089.67,14666.25,15755.92,3741.67,250716,233971,13076,175995,189071,44900,2022,'GLORIA DO GOITA',Glória do Goitá,'PE',2606101,3657.0,3657,304.8,304.8,1,74.0,74.0,Pequeno II
1530,1533,260620,54629,50744,3179,39579,42758,7986,50602.92,47170.17,3303.5,36127.33,39430.83,7739.33,607235,566042,39642,433528,473170,92872,2022,'GOIANA',Goiana,'PE',2606200,18368.0,18368,1530.7,1530.7,2,1007.0,1007.0,Médio
1531,1534,260630,6828,6013,151,4850,5001,1012,6751.5,5985.08,173.33,4824.33,4997.67,987.42,81018,71821,2080,57892,59972,11849,2022,'GRANITO',Granito,'PE',2606309,1816.0,1816,151.3,151.3,1,100.0,100.0,Pequeno I
1532,1535,260640,59692,54491,1909,46064,47973,6518,56187.92,51451.08,1742.83,43398.75,45141.58,6309.5,674255,617413,20914,520785,541699,75714,2022,'GRAVATA',Gravatá,'PE',2606408,51929.0,74409,4327.4,6200.8,4,3616.0,6175.0,Médio
1533,1536,260650,17299,15415,902,12787,13689,1726,16866.25,15105.25,916.25,12558.83,13475.08,1630.17,202395,181263,10995,150706,161701,19562,2022,'IATI',Iati,'PE',2606507,3265.0,3265,272.1,272.1,1,324.0,324.0,Pequeno I
1534,1537,260660,19885,18443,749,16285,17034,1409,19287.5,17962.67,819.0,15623.75,16442.75,1519.92,231450,215552,9828,187485,197313,18239,2022,'IBIMIRIM',Ibimirim,'PE',2606606,4889.0,4889,407.4,407.4,1,394.0,394.0,Pequeno II
1535,1538,260670,6384,5547,210,4100,4310,1237,6285.75,5518.08,189.92,4019.92,4209.83,1308.25,75429,66217,2279,48239,50518,15699,2022,'IBIRAJUBA',Ibirajuba,'PE',2606705,2082.0,2082,173.5,173.5,1,582.0,582.0,Pequeno I
1536,1539,260680,80349,72204,4869,52531,57400,14804,76323.83,69044.67,4907.08,49447.25,54354.33,14690.33,915886,828536,58885,593367,652252,176284,2022,'IGARASSU',Igarassu,'PE',2606804,39959.0,39959,3329.9,3329.9,3,2409.0,2409.0,Grande
1537,1540,260690,9564,8441,311,6477,6788,1653,9501.5,8466.0,288.67,6560.0,6848.67,1617.33,114018,101592,3464,78720,82184,19408,2022,'IGUARACI',Iguaraci,'PE',2606903,3711.0,3711,309.2,309.2,1,200.0,200.0,Pequeno I
1538,1541,260700,18766,18112,193,17533,17726,386,18368.25,17748.25,157.33,17204.67,17362.0,386.25,220419,212979,1888,206456,208344,4635,2022,'INAJA',Inajá,'PE',2607000,3189.0,6919,265.8,576.6,1,371.0,371.0,Pequeno I
1539,1542,260710,3808,3384,184,2644,2828,556,3760.58,3400.17,193.42,2660.5,2853.92,546.25,45127,40802,2321,31926,34247,6555,2022,'INGAZEIRA',Ingazeira,'PE',2607109,1078.0,1078,89.8,89.8,1,120.0,120.0,Pequeno I
1540,1543,260720,75350,69354,4132,55557,59689,9665,69959.42,64463.42,4367.25,50426.0,54793.25,9670.17,839513,773561,52407,605112,657519,116042,2022,'IPOJUCA',Ipojuca,'PE',2607208,26110.0,26110,2175.8,2175.8,3,1715.0,1715.0,Médio
1541,1544,260730,25001,23046,723,19634,20357,2689,24066.08,22350.25,767.17,18974.67,19741.83,2608.42,288793,268203,9206,227696,236902,31301,2022,'IPUBI',Ipubi,'PE',2607307,4320.0,4320,360.0,360.0,1,350.0,350.0,Pequeno II
1542,1545,260740,3973,3454,101,2792,2893,561,3928.17,3501.08,85.08,2822.75,2907.83,593.25,47138,42013,1021,33873,34894,7119,2022,'ITACURUBA',Itacuruba,'PE',2607406,105.0,105,8.8,8.8,1,2.0,2.0,Pequeno I
1543,1546,260750,21136,18622,387,16747,17134,1488,20804.25,18489.33,383.83,16634.92,17018.75,1470.58,249651,221872,4606,199619,204225,17647,2022,'ITAIBA',Itaíba,'PE',2607505,13027.0,13027,1085.6,1085.6,2,1208.0,1208.0,Pequeno II
1544,1547,260760,16408,15186,340,13416,13756,1430,15375.25,14276.75,324.33,12557.0,12881.33,1395.42,184503,171321,3892,150684,154576,16745,2022,'ILHA DE ITAMARACA',Ilha de Itamaracá,'PE',2607604,6144.0,6144,512.0,512.0,1,192.0,192.0,Pequeno II
1545,1548,260765,25879,24097,1891,17032,18923,5174,25308.67,23677.92,1801.25,16878.75,18680.0,4997.92,303704,284135,21615,202545,224160,59975,2022,'ITAMBE',Itambé,'PE',2607653,235.0,235,19.6,19.6,1,18.0,18.0,Pequeno II
1546,1549,260770,10523,9112,282,7170,7452,1660,10393.92,9107.0,312.0,7194.25,7506.25,1600.75,124727,109284,3744,86331,90075,19209,2022,'ITAPETIM',Itapetim,'PE',2607703,3599.0,3599,299.9,299.9,1,91.0,91.0,Pequeno I
1547,1550,260775,16546,15158,525,11760,12285,2873,15593.67,14420.42,557.67,11256.0,11813.67,2606.75,187124,173045,6692,135072,141764,31281,2022,'ITAPISSUMA',Itapissuma,'PE',2607752,2998.0,2998,249.8,249.8,1,252.0,252.0,Pequeno II
1548,1551,260780,11833,10919,1171,6594,7765,3154,11602.0,10834.33,1223.08,6695.25,7918.33,2916.0,139224,130012,14677,80343,95020,34992,2022,'ITAQUITINGA',Itaquitinga,'PE',2607802,1404.0,1404,117.0,117.0,1,165.0,165.0,Pequeno I
1549,1552,260790,353109,317303,39490,215791,255281,62022,319361.17,288364.0,35346.83,195692.42,231039.25,57324.75,3832334,3460368,424162,2348309,2772471,687897,2022,'JABOATAO DOS GUARARAPES',Jaboatão Dos Guararapes,'PE',2607901,121858.0,125415,10154.8,10451.2,12,8810.0,8810.0,Grande
1550,1553,260795,8790,7990,317,6752,7069,921,8350.17,7674.5,297.17,6465.83,6763.0,911.5,100202,92094,3566,77590,81156,10938,2022,'JAQUEIRA',Jaqueira,'PE',2607950,5925.0,5925,493.8,493.8,1,465.0,465.0,Pequeno I
1551,1554,260800,14300,13238,431,11522,11953,1285,13792.5,12905.42,420.0,11177.08,11597.08,1308.33,165510,154865,5040,134125,139165,15700,2022,'JATAUBA',Jataúba,'PE',2608008,2730.0,2730,227.5,227.5,1,133.0,133.0,Pequeno I
1552,1555,260805,10879,9806,446,7636,8082,1724,10726.33,9705.33,528.58,7366.67,7895.25,1810.08,128716,116464,6343,88400,94743,21721,2022,'JATOBA',Jatobá,'PE',2608057,1939.0,1939,161.6,161.6,1,81.0,81.0,Pequeno I
1553,1556,260810,19169,17272,798,13243,14041,3231,18831.5,17106.5,836.75,13128.67,13965.42,3141.08,225978,205278,10041,157544,167585,37693,2022,'JOAO ALFREDO',João Alfredo,'PE',2608107,2134.0,2134,177.8,177.8,1,97.0,97.0,Pequeno II
1554,1557,260820,11421,10681,216,9335,9551,1130,11024.08,10341.0,245.58,8828.42,9074.0,1267.0,132289,124092,2947,105941,108888,15204,2022,'JOAQUIM NABUCO',Joaquim Nabuco,'PE',2608206,681.0,681,68.1,68.1,1,,,Pequeno I
1555,1558,260825,9389,8608,378,6585,6963,1645,9241.25,8532.0,369.5,6523.08,6892.58,1639.42,110895,102384,4434,78277,82711,19673,2022,'JUCATI',Jucati,'PE',2608255,4081.0,4081,371.0,371.0,1,163.0,163.0,Pequeno I
1556,1559,260830,13464,11965,1172,8207,9379,2586,13192.33,11789.75,1115.75,8116.67,9232.42,2557.33,158308,141477,13389,97400,110789,30688,2022,'JUPI',Jupi,'PE',2608305,2164.0,2164,180.3,180.3,1,140.0,140.0,Pequeno I
1557,1560,260840,11929,11072,468,9552,10020,1052,11686.42,10953.67,502.08,9398.92,9901.0,1052.67,140237,131444,6025,112787,118812,12632,2022,'JUREMA',Jurema,'PE',2608404,1783.0,1783,148.6,148.6,1,200.0,200.0,Pequeno I
1558,1561,260845,12861,11787,571,8993,9564,2223,12506.83,11538.0,605.83,8721.17,9327.0,2211.0,150082,138456,7270,104654,111924,26532,2022,'LAGOA DO CARRO',Lagoa do Carro,'PE',2608453,6393.0,11793,532.8,982.8,1,0.0,1931.0,Pequeno I
1559,1562,260850,14528,12700,1012,8207,9219,3481,14403.25,12704.83,1019.0,8170.42,9189.42,3515.42,172839,152458,12228,98045,110273,42185,2022,'LAGOA DO ITAENGA',Lagoa do Itaenga,'PE',2608503,4333.0,4333,361.1,361.1,1,57.0,57.0,Pequeno II
1560,1563,260860,10488,9394,442,7304,7746,1648,10287.83,9310.58,371.58,7335.33,7706.92,1603.67,123454,111727,4459,88024,92483,19244,2022,'LAGOA DO OURO',Lagoa do Ouro,'PE',2608602,1704.0,1704,142.0,142.0,1,140.0,140.0,Pequeno I
1561,1564,260870,11211,10271,256,9018,9274,997,11102.17,10202.25,284.83,9009.17,9294.0,908.25,133226,122427,3418,108110,111528,10899,2022,'LAGOA DOS GATOS',Lagoa Dos Gatos,'PE',2608701,841.0,841,70.1,70.1,1,48.0,48.0,Pequeno I
1562,1565,260875,20747,18170,1405,13138,14543,3627,20038.67,17675.92,1356.58,12797.17,14153.75,3522.17,240464,212111,16279,153566,169845,42266,2022,'LAGOA GRANDE',Lagoa Grande,'PE',2608750,6381.0,6381,531.8,531.8,2,509.0,509.0,Pequeno II
1563,1566,260880,31555,28805,786,24201,24987,3818,29656.08,27261.25,875.33,22601.67,23477.0,3784.25,355873,327135,10504,271220,281724,45411,2022,'LAJEDO',Lajedo,'PE',2608800,2122.0,2122,176.8,176.8,1,148.0,148.0,Pequeno II
1564,1567,260890,36641,33195,2704,22313,25017,8178,35699.92,32603.58,2325.08,22662.75,24987.83,7615.75,428399,391243,27901,271953,299854,91389,2022,'LIMOEIRO',Limoeiro,'PE',2608909,6001.0,6001,500.1,500.1,2,331.0,331.0,Médio
1565,1568,260900,17161,15448,1474,9767,11241,4207,16557.08,15004.17,1239.33,9980.08,11219.42,3784.75,198685,180050,14872,119761,134633,45417,2022,'MACAPARANA',Macaparana,'PE',2609006,1543.0,1543,128.6,128.6,1,101.0,101.0,Pequeno II
1566,1569,260910,9582,8791,352,6897,7249,1542,9331.67,8621.5,340.67,6783.42,7124.08,1497.42,111980,103458,4088,81401,85489,17969,2022,'MACHADOS',Machados,'PE',2609105,725.0,725,60.4,60.4,1,48.0,48.0,Pequeno I
1567,1570,260915,15342,14486,111,13599,13710,776,15109.17,14324.33,189.75,13334.5,13524.25,800.08,181310,171892,2277,160014,162291,9601,2022,'MANARI',Manari,'PE',2609154,378.0,378,31.5,31.5,1,15.0,15.0,Pequeno I
1568,1571,260920,8382,7704,193,6756,6949,755,8388.17,7768.75,175.75,6871.67,7047.42,721.33,100658,93225,2109,82460,84569,8656,2022,'MARAIAL',Maraial,'PE',2609204,3159.0,3159,394.9,394.9,1,,,Pequeno I
1569,1572,260930,12769,11519,562,8817,9379,2140,12645.5,11501.42,624.5,8781.17,9405.67,2095.75,151746,138017,7494,105374,112868,25149,2022,'MIRANDIBA',Mirandiba,'PE',2609303,2842.0,2842,236.8,236.8,1,150.0,150.0,Pequeno I
1570,1573,260940,39449,35860,2583,26995,29578,6282,37892.42,34757.25,2518.92,26161.0,28679.92,6077.33,454709,417087,30227,313932,344159,72928,2022,'MORENO',Moreno,'PE',2609402,16668.0,16668,1389.0,1389.0,2,854.0,854.0,Médio
1571,1574,260950,21404,18500,1051,12154,13205,5295,20635.08,17998.58,1109.83,11687.5,12797.33,5201.25,247621,215983,13318,140250,153568,62415,2022,'NAZARE DA MATA',Nazaré da Mata,'PE',2609501,2112.0,2112,176.0,176.0,2,130.0,130.0,Pequeno II
1572,1575,260960,210466,188577,15140,137022,152162,36415,189734.17,170027.33,14780.75,120152.08,134932.83,35094.5,2276810,2040328,177369,1441825,1619194,421134,2022,'OLINDA',Olinda,'PE',2609600,92371.0,95469,7697.6,7955.8,10,9624.0,9624.0,Grande
1573,1576,260970,15834,14609,722,11176,11898,2711,15598.25,14542.83,764.83,11165.33,11930.17,2612.67,187179,174514,9178,133984,143162,31352,2022,'OROBO',Orobó,'PE',2609709,1279.0,1279,106.6,106.6,1,14.0,14.0,Pequeno II
1574,1577,260980,14210,13245,192,12067,12259,986,13966.67,13101.08,184.67,11997.75,12182.42,918.67,167600,157213,2216,143973,146189,11024,2022,'OROCO',Orocó,'PE',2609808,4519.0,4519,376.6,376.6,1,377.0,377.0,Pequeno I
1575,1578,260990,51189,46563,2271,36127,38398,8165,50859.5,46543.92,2332.25,36387.25,38719.5,7824.42,610314,558527,27987,436647,464634,93893,2022,'OURICURI',Ouricuri,'PE',2609907,3131.0,3131,260.9,260.9,3,157.0,157.0,Médio
1576,1579,261000,42185,37901,1366,30732,32098,5803,41180.42,37338.58,1360.08,30124.25,31484.33,5854.25,494165,448063,16321,361491,377812,70251,2022,'PALMARES',Palmares,'PE',2610004,25100.0,25100,2091.7,2091.7,5,1633.0,1633.0,Médio
1577,1580,261010,6098,5559,241,4719,4960,599,6144.0,5670.08,249.83,4819.5,5069.33,600.75,73728,68041,2998,57834,60832,7209,2022,'PALMEIRINA',Palmeirina,'PE',2610103,3025.0,3025,252.1,252.1,1,178.0,178.0,Pequeno I
1578,1581,261020,18819,17100,807,13492,14299,2801,18344.92,16757.0,832.92,13372.33,14205.25,2551.75,220139,201084,9995,160468,170463,30621,2022,'PANELAS',Panelas,'PE',2610202,4417.0,4417,368.1,368.1,2,268.0,268.0,Pequeno II
1579,1582,261030,12747,11687,405,9103,9508,2179,12464.25,11504.67,459.92,8936.5,9396.42,2108.25,149571,138056,5519,107238,112757,25299,2022,'PARANATAMA',Paranatama,'PE',2610301,2264.0,3304,188.7,275.3,1,38.0,38.0,Pequeno I
1580,1583,261040,16439,14305,588,10794,11382,2923,16200.17,14211.25,616.5,10763.08,11379.58,2831.67,194402,170535,7398,129157,136555,33980,2022,'PARNAMIRIM',Parnamirim,'PE',2610400,1034.0,1034,86.2,86.2,1,30.0,30.0,Pequeno II
1581,1584,261050,21649,20256,449,16889,17338,2918,21287.08,20031.92,503.33,16659.33,17162.67,2869.25,255445,240383,6040,199912,205952,34431,2022,'PASSIRA',Passira,'PE',2610509,9100.0,9100,758.3,758.3,1,1321.0,1321.0,Pequeno II
1582,1585,261060,39724,36871,998,30630,31628,5243,38361.25,35754.58,969.5,29759.25,30728.75,5025.83,460335,429055,11634,357111,368745,60310,2022,'PAUDALHO',Paudalho,'PE',2610608,1547.0,1547,128.9,128.9,1,144.0,144.0,Médio
1583,1586,261070,179141,159873,14977,113517,128494,31379,165648.58,148518.5,12043.42,107369.83,119413.25,29105.25,1987783,1782222,144521,1288438,1432959,349263,2022,'PAULISTA',Paulista,'PE',2610707,96527.0,99605,8043.9,8300.4,6,8293.0,8293.0,Grande
1584,1587,261080,17644,16585,202,15492,15694,891,17197.75,16263.25,231.58,15158.42,15390.0,873.25,206373,195159,2779,181901,184680,10479,2022,'PEDRA',Pedra,'PE',2610806,2415.0,2415,201.2,201.2,1,70.0,70.0,Pequeno II
1585,1588,261090,50070,46395,1401,39836,41237,5158,49031.17,45697.67,1297.33,39455.17,40752.5,4945.17,588374,548372,15568,473462,489030,59342,2022,'PESQUEIRA',Pesqueira,'PE',2610905,6455.0,6455,537.9,537.9,2,456.0,456.0,Médio
1586,1589,261100,25556,23506,1493,17592,19085,4421,24683.58,22838.58,1561.17,17159.5,18720.67,4117.92,296203,274063,18734,205914,224648,49415,2022,'PETROLANDIA',Petrolândia,'PE',2611002,7123.0,7123,593.6,593.6,1,454.0,454.0,Pequeno II
1587,1590,261110,227750,202028,26711,122038,148749,53279,212853.67,190154.17,24876.0,116185.25,141061.25,49092.92,2554244,2281850,298512,1394223,1692735,589115,2022,'PETROLINA',Petrolina,'PE',2611101,91876.0,152004,7656.3,12667.0,10,6609.0,6609.0,Grande
1588,1591,261120,9968,9095,253,7752,8005,1090,9731.0,8948.75,236.25,7648.33,7884.58,1064.17,116772,107385,2835,91780,94615,12770,2022,'POCAO',Poção,'PE',2611200,9758.0,17766,813.2,1480.5,1,900.0,900.0,Pequeno I
1589,1592,261130,19587,17986,347,15614,15961,2025,18905.17,17513.0,349.33,15276.33,15625.67,1887.33,226862,210156,4192,183316,187508,22648,2022,'POMBOS',Pombos,'PE',2611309,1968.0,1968,164.0,164.0,1,60.0,60.0,Pequeno II
1590,1593,261140,9565,8794,565,6801,7366,1428,9209.17,8553.5,536.17,6636.5,7172.67,1380.83,110510,102642,6434,79638,86072,16570,2022,'PRIMAVERA',Primavera,'PE',2611408,671.0,671,55.9,55.9,1,27.0,27.0,Pequeno I
1591,1594,261150,14986,13780,451,11586,12037,1743,14731.58,13644.0,430.33,11559.08,11989.42,1654.58,176779,163728,5164,138709,143873,19855,2022,'QUIPAPA',Quipapá,'PE',2611507,2440.0,2440,203.3,203.3,1,68.0,68.0,Pequeno II
1592,1595,261153,6190,5398,248,3737,3985,1413,6084.42,5375.17,235.83,3705.5,3941.33,1433.83,73013,64502,2830,44466,47296,17206,2022,'QUIXABA',Quixaba,'PE',2611533,633.0,633,52.8,52.8,1,78.0,78.0,Pequeno I
1593,1596,261160,629139,558312,137371,251215,388586,169726,582019.17,519440.25,119673.17,248725.75,368398.92,151041.33,6984230,6233283,1436078,2984709,4420787,1812496,2022,'RECIFE',Recife,'PE',2611606,245133.0,261250,20427.8,21770.8,14,16919.0,16919.0,Metrópole
1594,1597,261170,18556,16921,499,14462,14961,1960,17713.42,16320.08,493.33,13902.0,14395.33,1924.75,212561,195841,5920,166824,172744,23097,2022,'RIACHO DAS ALMAS',Riacho Das Almas,'PE',2611705,2990.0,26340,249.2,2195.0,2,952.0,952.0,Pequeno I
1595,1598,261180,25454,23623,1020,18294,19314,4309,24837.83,23109.42,1088.67,17674.0,18762.67,4346.75,298054,277313,13064,212088,225152,52161,2022,'RIBEIRAO',Ribeirão,'PE',2611804,1302.0,1302,108.5,108.5,1,88.0,88.0,Pequeno II
1596,1599,261190,14925,13903,566,11279,11845,2058,14253.83,13365.25,648.5,10736.08,11384.58,1980.67,171046,160383,7782,128833,136615,23768,2022,'RIO FORMOSO',Rio Formoso,'PE',2611903,9201.0,9201,766.8,766.8,1,443.0,443.0,Pequeno II
1597,1600,261200,8497,7713,281,6360,6641,1072,8274.58,7618.0,305.75,6314.67,6620.42,997.58,99295,91416,3669,75776,79445,11971,2022,'SAIRE',Sairé,'PE',2612000,4721.0,4721,393.4,393.4,2,160.0,160.0,Pequeno I
1598,1601,261210,4904,4452,196,3645,3841,611,4871.67,4433.33,179.67,3661.67,3841.33,592.0,58460,53200,2156,43940,46096,7104,2022,'SALGADINHO',Salgadinho,'PE',2612109,1542.0,1542,128.5,128.5,1,61.0,61.0,Pequeno I
1599,1602,261220,43481,38914,3697,25847,29544,9370,42121.0,37909.0,3814.67,24869.33,28684.0,9225.0,505452,454908,45776,298432,344208,110700,2022,'SALGUEIRO',Salgueiro,'PE',2612208,4834.0,4834,402.8,402.8,2,266.0,266.0,Médio
1600,1603,261230,11740,10659,159,8962,9121,1538,11774.58,10762.0,189.0,9093.0,9282.0,1480.0,141295,129144,2268,109116,111384,17760,2022,'SALOA',Saloá,'PE',2612307,5211.0,5211,434.2,434.2,2,344.0,344.0,Pequeno I
1601,1604,261240,15300,14053,424,12114,12538,1515,14720.58,13569.67,556.0,11399.0,11955.0,1614.67,176647,162836,6672,136788,143460,19376,2022,'SANHARO',Sanharó,'PE',2612406,6601.0,6601,550.1,550.1,2,511.0,511.0,Pequeno II
1602,1605,261245,11163,9686,285,7593,7878,1808,10981.5,9640.83,323.75,7535.92,7859.67,1781.17,131778,115690,3885,90431,94316,21374,2022,'SANTA CRUZ',Santa Cruz,'PE',2612455,1528.0,1528,138.9,138.9,1,140.0,140.0,Pequeno I
1603,1606,261247,9814,8666,937,5595,6532,2134,9602.42,8520.58,830.67,5615.75,6446.42,2074.17,115229,102247,9968,67389,77357,24890,2022,'SANTA CRUZ DA BAIXA VERDE',Santa Cruz da Baixa Verde,'PE',2612471,682.0,682,56.8,56.8,1,30.0,30.0,Pequeno I
1604,1607,261250,69541,64685,6643,50793,57436,7249,63483.5,59258.5,7359.5,44494.67,51854.17,7404.33,761802,711102,88314,533936,622250,88852,2022,'SANTA CRUZ DO CAPIBARIBE',Santa Cruz do Capibaribe,'PE',2612505,25860.0,25860,2155.0,2155.0,3,1842.0,1842.0,Médio
1605,1608,261255,12692,10895,573,7986,8559,2336,12562.08,10910.75,598.75,8096.5,8695.25,2215.5,150745,130929,7185,97158,104343,26586,2022,'SANTA FILOMENA',Santa Filomena,'PE',2612554,164.0,164,13.7,13.7,1,8.0,8.0,Pequeno I
1606,1609,261260,39488,36606,822,33420,34242,2364,37812.33,35276.0,968.33,31821.67,32790.0,2486.0,453748,423312,11620,381860,393480,29832,2022,'SANTA MARIA DA BOA VISTA',Santa Maria da Boa Vista,'PE',2612604,3466.0,3466,288.8,288.8,1,150.0,150.0,Pequeno II
1607,1610,261270,12340,11439,398,10045,10443,996,11906.42,11090.25,373.92,9621.5,9995.42,1094.83,142877,133083,4487,115458,119945,13138,2022,'SANTA MARIA DO CAMBUCA',Santa Maria do Cambucá,'PE',2612703,815.0,25340,67.9,2111.7,1,815.0,815.0,Pequeno I
1608,1611,261280,7663,6973,333,5339,5672,1301,7418.0,6806.17,310.92,5249.25,5560.17,1246.0,89016,81674,3731,62991,66722,14952,2022,'SANTA TEREZINHA',Santa Terezinha,'PE',2612802,1652.0,1652,137.7,137.7,1,156.0,156.0,Pequeno I
1609,1612,261290,7960,7303,264,5981,6245,1058,7846.58,7216.92,281.83,5961.58,6243.42,973.5,94159,86603,3382,71539,74921,11682,2022,'SAO BENEDITO DO SUL',São Benedito do Sul,'PE',2612901,2901.0,2901,241.8,241.8,1,192.0,192.0,Pequeno I
1610,1613,261300,38331,34701,1259,26922,28181,6520,37630.75,34155.25,1415.83,26477.25,27893.08,6262.17,451569,409863,16990,317727,334717,75146,2022,'SAO BENTO DO UNA',São Bento do Una,'PE',2613008,15020.0,15020,1251.7,1251.7,2,789.0,789.0,Médio
1611,1614,261310,26316,24003,2014,17467,19481,4522,25368.25,23307.67,1825.25,17255.33,19080.58,4227.08,304419,279692,21903,207064,228967,50725,2022,'SAO CAITANO',São Caitano,'PE',2613107,17200.0,26591,1433.3,2215.9,2,1116.0,1116.0,Pequeno II
1612,1615,261320,18232,16665,300,13956,14256,2409,17971.33,16469.33,307.5,13836.75,14144.25,2325.08,215656,197632,3690,166041,169731,27901,2022,'SAO JOAO',São João,'PE',2613206,2881.0,2881,240.1,240.1,1,20.0,20.0,Pequeno II
1613,1616,261330,15765,14787,447,12970,13417,1370,15241.67,14372.5,444.75,12508.5,12953.25,1419.25,182900,172470,5337,150102,155439,17031,2022,'SAO JOAQUIM DO MONTE',São Joaquim do Monte,'PE',2613305,6650.0,6650,554.2,554.2,1,228.0,228.0,Pequeno II
1614,1617,261340,14991,14060,303,12607,12910,1150,13642.33,12805.25,375.83,11242.33,11618.17,1187.08,163708,153663,4510,134908,139418,14245,2022,'SAO JOSE DA COROA GRANDE',São José da Coroa Grande,'PE',2613404,1138.0,1138,94.8,94.8,1,95.0,95.0,Pequeno I
1615,1618,261350,27178,24852,821,19233,20054,4798,26795.83,24703.83,703.5,19518.25,20221.75,4482.08,321550,296446,8442,234219,242661,53785,2022,'SAO JOSE DO BELMONTE',São José do Belmonte,'PE',2613503,2566.0,2566,213.8,213.8,1,246.0,246.0,Pequeno II
1616,1619,261360,21864,19533,870,15451,16321,3212,21186.75,19064.08,799.5,15103.25,15902.75,3161.33,254241,228769,9594,181239,190833,37936,2022,'SAO JOSE DO EGITO',São José do Egito,'PE',2613602,2456.0,2456,204.7,204.7,2,122.0,122.0,Pequeno II
1617,1620,261370,66995,60810,5338,42658,47996,12814,64747.17,59091.33,5338.75,40968.75,46307.5,12783.83,776966,709096,64065,491625,555690,153406,2022,'SAO LOURENCO DA MATA',São Lourenço da Mata,'PE',2613701,17900.0,17900,1491.7,1491.7,3,1078.0,1078.0,Grande
1618,1621,261380,13158,11921,1187,8329,9516,2405,12851.42,11702.75,1213.92,8092.5,9306.42,2396.33,154217,140433,14567,97110,111677,28756,2022,'SAO VICENTE FERRER',São Vicente Ferrer,'PE',2613800,877.0,877,73.1,73.1,1,79.0,79.0,Pequeno I
1619,1622,261390,53140,47610,3668,32018,35686,11924,51253.83,46396.17,3716.08,31413.08,35129.17,11267.0,615046,556754,44593,376957,421550,135204,2022,'SERRA TALHADA',Serra Talhada,'PE',2613909,20398.0,20398,1699.8,1699.8,4,1686.0,1686.0,Médio
1620,1623,261400,15308,13786,734,10439,11173,2613,15195.83,13824.42,835.58,10299.25,11134.83,2689.58,182350,165893,10027,123591,133618,32275,2022,'SERRITA',Serrita,'PE',2614006,1861.0,1861,155.1,155.1,1,105.0,105.0,Pequeno I
1621,1624,261410,26084,22948,863,18616,19479,3469,25498.67,22591.0,953.25,18189.58,19142.83,3448.17,305984,271092,11439,218275,229714,41378,2022,'SERTANIA',Sertânia,'PE',2614105,3758.0,3758,313.2,313.2,1,117.0,117.0,Pequeno II
1622,1625,261420,25378,24148,1840,18853,20693,3455,23810.5,22756.42,1949.67,17541.5,19491.17,3265.25,285726,273077,23396,210498,233894,39183,2022,'SIRINHAEM',Sirinhaém,'PE',2614204,4876.0,4876,406.3,406.3,1,331.0,331.0,Pequeno II
1623,1626,261430,11044,9975,137,8732,8869,1106,10656.42,9712.83,225.67,8353.67,8579.33,1133.5,127877,116554,2708,100244,102952,13602,2022,'MOREILANDIA',Moreilândia,'PE',2614303,551.0,551,45.9,45.9,1,45.0,45.0,Pequeno I
1624,1627,261440,4518,3928,217,2735,2952,976,4487.67,3941.58,239.58,2720.42,2960.0,981.58,53852,47299,2875,32645,35520,11779,2022,'SOLIDAO',Solidão,'PE',2614402,468.0,468,39.0,39.0,1,23.0,23.0,Pequeno I
1625,1628,261450,42519,39230,1478,31393,32871,6359,41386.08,38408.17,1360.17,30880.75,32240.92,6167.25,496633,460898,16322,370569,386891,74007,2022,'SURUBIM',Surubim,'PE',2614501,20280.0,20280,1690.0,1690.0,2,1689.0,1689.0,Médio
1626,1629,261460,22380,20203,698,16259,16957,3246,22037.25,20138.33,710.17,16377.08,17087.25,3051.08,264447,241660,8522,196525,205047,36613,2022,'TABIRA',Tabira,'PE',2614600,2895.0,2895,241.2,241.2,2,191.0,191.0,Pequeno II
1627,1630,261470,10486,9526,216,7902,8118,1408,10475.5,9591.75,192.17,8083.92,8276.08,1315.67,125706,115101,2306,97007,99313,15788,2022,'TACAIMBO',Tacaimbó,'PE',2614709,3817.0,5431,318.1,452.6,1,112.0,112.0,Pequeno I
1628,1631,261480,17486,15788,878,11933,12811,2977,17051.33,15549.75,919.83,11943.67,12863.5,2686.25,204616,186597,11038,143324,154362,32235,2022,'TACARATU',Tacaratu,'PE',2614808,2048.0,2048,170.7,170.7,1,122.0,122.0,Pequeno II
1629,1632,261485,16778,15442,1248,11282,12530,2912,15659.33,14538.0,1216.75,10707.42,11924.17,2613.83,187912,174456,14601,128489,143090,31366,2022,'TAMANDARE',Tamandaré,'PE',2614857,1917.0,1917,159.8,159.8,1,50.0,50.0,Pequeno II
1630,1633,261500,18390,16905,1189,12272,13461,3444,17456.92,16132.25,1197.0,11710.42,12907.42,3224.83,209483,193587,14364,140525,154889,38698,2022,'TAQUARITINGA DO NORTE',Taquaritinga do Norte,'PE',2615003,6132.0,6132,511.0,511.0,3,234.0,234.0,Pequeno II
1631,1634,261510,5775,5289,246,4047,4293,996,5730.67,5271.42,272.58,4052.17,4324.75,946.67,68768,63257,3271,48626,51897,11360,2022,'TEREZINHA',Terezinha,'PE',2615102,1161.0,1161,96.8,96.8,1,26.0,26.0,Pequeno I
1632,1635,261520,7549,6911,377,4960,5337,1574,7445.33,6890.92,337.75,5045.25,5383.0,1507.92,89344,82691,4053,60543,64596,18095,2022,'TERRA NOVA',Terra Nova,'PE',2615201,731.0,731,60.9,60.9,1,60.0,60.0,Pequeno I
1633,1636,261530,38261,33565,2588,19611,22199,11366,37414.08,33028.0,2809.42,18723.83,21533.25,11494.75,448969,396336,33713,224686,258399,137937,2022,'TIMBAUBA',Timbaúba,'PE',2615300,3973.0,3973,331.1,331.1,1,268.0,268.0,Médio
1634,1637,261540,29587,28183,6372,15528,21900,6283,27850.0,26552.5,5465.67,15189.25,20654.92,5897.58,334200,318630,65588,182271,247859,70771,2022,'TORITAMA',Toritama,'PE',2615409,12084.0,12084,1007.0,1007.0,1,869.0,869.0,Pequeno II
1635,1638,261550,10683,9722,619,7023,7642,2080,10397.92,9558.5,633.0,6958.42,7591.42,1967.08,124775,114702,7596,83501,91097,23605,2022,'TRACUNHAEM',Tracunhaém,'PE',2615508,1861.0,1861,155.1,155.1,1,338.0,338.0,Pequeno I
1636,1639,261560,26509,24519,973,20051,21024,3495,25600.67,23764.67,1085.58,19248.58,20334.17,3430.5,307208,285176,13027,230983,244010,41166,2022,'TRINDADE',Trindade,'PE',2615607,2090.0,2090,174.2,174.2,1,85.0,85.0,Pequeno II
1637,1640,261570,10574,8989,758,5955,6713,2276,10180.92,8753.67,674.17,5873.75,6547.92,2205.75,122171,105044,8090,70485,78575,26469,2022,'TRIUNFO',Triunfo,'PE',2615706,1758.0,1758,146.5,146.5,1,82.0,82.0,Pequeno I
1638,1641,261580,19301,17835,282,16331,16613,1222,18856.83,17457.67,365.58,15804.67,16170.25,1287.42,226282,209492,4387,189656,194043,15449,2022,'TUPANATINGA',Tupanatinga,'PE',2615805,3853.0,3853,321.1,321.1,1,310.0,310.0,Pequeno II
1639,1642,261590,7452,6509,225,5099,5324,1185,7301.83,6454.42,269.67,4962.25,5231.92,1222.5,87622,77453,3236,59547,62783,14670,2022,'TUPARETAMA',Tuparetama,'PE',2615904,3511.0,3511,292.6,292.6,1,169.0,169.0,Pequeno I
1640,1643,261600,14798,13353,358,10933,11291,2062,14317.5,12974.17,473.25,10317.0,10790.25,2183.92,171810,155690,5679,123804,129483,26207,2022,'VENTUROSA',Venturosa,'PE',2616001,2781.0,9189,231.8,765.8,1,159.0,159.0,Pequeno I
1641,1644,261610,7005,6007,644,3544,4188,1819,6753.58,5853.42,569.17,3686.08,4255.25,1598.17,81043,70241,6830,44233,51063,19178,2022,'VERDEJANTE',Verdejante,'PE',2616100,323.0,323,26.9,26.9,1,29.0,29.0,Pequeno I
1642,1645,261618,6805,6250,208,5285,5493,757,6658.5,6146.67,276.0,5073.58,5349.58,797.08,79902,73760,3312,60883,64195,9565,2022,'VERTENTE DO LERIO',Vertente do Lério,'PE',2616183,1830.0,1830,152.5,152.5,1,100.0,100.0,Pequeno I
1643,1646,261620,13856,13174,1280,10034,11314,1860,13209.33,12574.42,1499.58,9304.33,10803.92,1770.5,158512,150893,17995,111652,129647,21246,2022,'VERTENTES',Vertentes,'PE',2616209,331.0,331,27.6,27.6,1,32.0,32.0,Pequeno I
1644,1647,261630,18817,16681,1436,10270,11706,4975,18281.42,16345.25,1424.42,10235.67,11660.08,4685.17,219377,196143,17093,122828,139921,56222,2022,'VICENCIA',Vicência,'PE',2616308,1439.0,1439,119.9,119.9,1,41.0,41.0,Pequeno II
1645,1648,261640,93936,85325,3613,68329,71942,13383,90727.42,82948.92,3567.17,66748.83,70316.0,12632.92,1088729,995387,42806,800986,843792,151595,2022,'VITORIA DE SANTO ANTAO',Vitória de Santo Antão,'PE',2616407,52267.0,52267,4355.6,4355.6,5,2668.0,2668.0,Grande
1646,1649,261650,11009,10011,443,8137,8580,1431,10862.17,9936.42,510.25,7855.58,8365.83,1570.58,130346,119237,6123,94267,100390,18847,2022,'XEXEU',Xexéu,'PE',2616506,1070.0,1070,89.2,89.2,1,96.0,96.0,Pequeno I
1647,1650,270010,15240,14034,763,10822,11585,2449,15157.0,14009.75,821.08,10943.58,11764.67,2245.08,181884,168117,9853,131323,141176,26941,2022,'AGUA BRANCA',Água Branca,'AL',2700102,4058.0,4058,338.2,338.2,1,380.0,380.0,Pequeno I
1648,1651,270020,10565,9775,440,8199,8639,1136,10376.33,9644.67,443.92,8118.42,8562.33,1082.33,124516,115736,5327,97421,102748,12988,2022,'ANADIA',Anadia,'AL',2700201,2424.0,2424,202.0,202.0,1,300.0,300.0,Pequeno I
1649,1652,270030,104117,93862,6868,70036,76904,16958,98701.5,89170.75,7118.5,65449.58,72568.08,16602.67,1184418,1070049,85422,785395,870817,199232,2022,'ARAPIRACA',Arapiraca,'AL',2700300,40082.0,40082,3340.2,3340.2,9,2263.0,2263.0,Grande
1650,1653,270040,29375,27014,1798,21421,23219,3795,29336.92,27231.42,1677.25,22144.67,23821.92,3409.5,352043,326777,20127,265736,285863,40914,2022,'ATALAIA',Atalaia,'AL',2700409,670.0,670,55.8,55.8,1,56.0,56.0,Pequeno II
1651,1654,270050,13626,12528,358,11446,11804,724,13253.25,12221.92,431.17,10998.25,11429.42,792.5,159039,146663,5174,131979,137153,9510,2022,'BARRA DE SANTO ANTONIO',Barra de Santo Antônio,'AL',2700508,1165.0,1165,97.1,97.1,1,56.0,56.0,Pequeno I
1652,1655,270060,6250,5754,390,4571,4961,793,6082.33,5622.58,378.5,4449.92,4828.42,794.17,72988,67471,4542,53399,57941,9530,2022,'BARRA DE SAO MIGUEL',Barra de São Miguel,'AL',2700607,329.0,329,29.9,29.9,1,42.0,42.0,Pequeno I
1653,1656,270070,14227,13150,356,11269,11625,1525,13861.75,12868.17,423.83,10898.0,11321.83,1546.33,166341,154418,5086,130776,135862,18556,2022,'BATALHA',Batalha,'AL',2700706,1136.0,1136,94.7,94.7,1,41.0,41.0,Pequeno I
1654,1657,270080,4106,3648,213,2694,2907,741,4143.25,3719.17,191.0,2793.33,2984.33,734.83,49719,44630,2292,33520,35812,8818,2022,'BELEM',Belém,'AL',2700805,1469.0,1469,122.4,122.4,1,22.0,22.0,Pequeno I
1655,1658,270090,5735,5375,138,4630,4768,607,5631.67,5289.5,179.83,4461.83,4641.67,647.83,67580,63474,2158,53542,55700,7774,2022,'BELO MONTE',Belo Monte,'AL',2700904,600.0,600,50.0,50.0,1,50.0,50.0,Pequeno I
1656,1659,270100,16355,14923,380,13038,13418,1505,15720.42,14429.92,436.75,12466.42,12903.17,1526.75,188645,173159,5241,149597,154838,18321,2022,'BOCA DA MATA',Boca da Mata,'AL',2701001,898.0,898,74.8,74.8,1,76.0,76.0,Pequeno II
1657,1660,270110,8509,7631,346,6339,6685,946,8176.75,7355.58,339.5,6140.33,6479.83,875.75,98121,88267,4074,73684,77758,10509,2022,'BRANQUINHA',Branquinha,'AL',2701100,1335.0,1335,111.2,111.2,1,43.0,43.0,Pequeno I
1658,1661,270120,7554,7032,266,5683,5949,1083,7411.92,6918.17,271.5,5640.17,5911.67,1006.5,88943,83018,3258,67682,70940,12078,2022,'CACIMBINHAS',Cacimbinhas,'AL',2701209,598.0,598,49.8,49.8,1,21.0,21.0,Pequeno I
1659,1663,270135,5054,4655,115,4240,4355,300,5019.33,4643.17,121.08,4238.92,4360.0,283.17,60232,55718,1453,50867,52320,3398,2022,'CAMPESTRE',Campestre,'AL',2701357,3079.0,3079,256.6,256.6,1,196.0,196.0,Pequeno I
1660,1664,270140,23417,20466,1022,15056,16078,4388,23369.0,20579.42,1058.83,15300.33,16359.17,4220.25,280428,246953,12706,183604,196310,50643,2022,'CAMPO ALEGRE',Campo Alegre,'AL',2701407,3104.0,3104,258.7,258.7,2,213.0,213.0,Médio
1661,1665,270150,8575,8185,72,7790,7862,323,8387.17,8018.33,73.25,7591.08,7664.33,354.0,100646,96220,879,91093,91972,4248,2022,'CAMPO GRANDE',Campo Grande,'AL',2701506,674.0,674,56.2,56.2,1,80.0,80.0,Pequeno I
1662,1666,270160,15933,14818,598,13115,13713,1105,16190.33,15119.92,559.08,13555.08,14114.17,1005.75,194284,181439,6709,162661,169370,12069,2022,'CANAPI',Canapi,'AL',2701605,341.0,341,42.6,42.6,1,45.0,45.0,Pequeno I
1663,1667,270170,10171,9226,852,6307,7159,2067,10094.0,9259.5,866.67,6517.42,7384.08,1875.42,121128,111114,10400,78209,88609,22505,2022,'CAPELA',Capela,'AL',2701704,898.0,898,89.8,89.8,1,170.0,170.0,Pequeno I
1664,1668,270180,7439,7081,190,6160,6350,731,7320.92,7022.92,209.0,6187.92,6396.92,626.0,87851,84275,2508,74255,76763,7512,2022,'CARNEIROS',Carneiros,'AL',2701803,5559.0,10881,463.2,906.8,1,460.0,460.0,Pequeno I
1665,1669,270190,5970,5677,94,5271,5365,312,5652.33,5381.92,92.92,4983.58,5076.5,305.42,67828,64583,1115,59803,60918,3665,2022,'CHA PRETA',Chã Preta,'AL',2701902,167.0,167,15.2,15.2,1,18.0,18.0,Pequeno I
1666,1670,270200,8306,7662,855,5263,6118,1544,8112.25,7547.0,718.67,5372.58,6091.25,1455.75,97347,90564,8624,64471,73095,17469,2022,'COITE DO NOIA',Coité do Nóia,'AL',2702009,362.0,362,30.2,30.2,1,8.0,8.0,Pequeno I
1667,1671,270210,14579,13422,245,12306,12551,871,14191.33,13090.08,234.42,11994.42,12228.83,861.25,170296,157081,2813,143933,146746,10335,2022,'COLONIA LEOPOLDINA',Colônia Leopoldina,'AL',2702108,2758.0,2758,250.7,250.7,1,293.0,293.0,Pequeno II
1668,1672,270220,4532,4003,313,2892,3205,798,4491.17,3979.08,362.83,2780.58,3143.42,835.67,53894,47749,4354,33367,37721,10028,2022,'COQUEIRO SECO',Coqueiro Seco,'AL',2702207,1729.0,1729,144.1,144.1,1,147.0,147.0,Pequeno I
1669,1673,270230,29317,26457,2611,19201,21812,4645,28129.58,25467.42,2386.67,18559.42,20946.08,4521.33,337555,305609,28640,222713,251353,54256,2022,'CORURIPE',Coruripe,'AL',2702306,5773.0,5773,481.1,481.1,1,706.0,706.0,Médio
1670,1674,270235,19906,18422,826,14851,15677,2745,19397.92,18033.58,756.08,14832.58,15588.67,2444.92,232775,216403,9073,177991,187064,29339,2022,'CRAIBAS',Craíbas,'AL',2702355,1280.0,1280,106.7,106.7,1,98.0,98.0,Pequeno II
1671,1675,270240,33563,30337,2632,22545,25177,5160,33074.92,30079.0,2612.33,22607.75,25220.08,4858.92,396899,360948,31348,271293,302641,58307,2022,'DELMIRO GOUVEIA',Delmiro Gouveia,'AL',2702405,2481.0,2481,206.8,206.8,1,153.0,153.0,Pequeno II
1672,1676,270250,8216,7680,307,6714,7021,659,7670.92,7154.58,341.58,6146.33,6487.92,666.67,92051,85855,4099,73756,77855,8000,2022,'DOIS RIACHOS',Dois Riachos,'AL',2702504,946.0,946,78.8,78.8,1,82.0,82.0,Pequeno I
1673,1677,270255,13491,11596,501,8836,9337,2259,13381.08,11587.83,496.67,8830.25,9326.92,2260.92,160573,139054,5960,105963,111923,27131,2022,'ESTRELA DE ALAGOAS',Estrela de Alagoas,'AL',2702553,495.0,495,41.2,41.2,1,17.0,17.0,Pequeno I
1674,1678,270260,17772,16740,443,14242,14685,2055,17120.58,16174.0,479.08,13846.0,14325.08,1848.92,205447,194088,5749,166152,171901,22187,2022,'FEIRA GRANDE',Feira Grande,'AL',2702603,1265.0,1265,105.4,105.4,1,103.0,103.0,Pequeno II
1675,1679,270270,2857,2600,289,1910,2199,401,2833.92,2591.5,270.5,1935.75,2206.25,385.25,34007,31098,3246,23229,26475,4623,2022,'FELIZ DESERTO',Feliz Deserto,'AL',2702702,4603.0,4603,383.6,383.6,1,591.0,591.0,Pequeno I
1676,1680,270280,9681,8532,560,6559,7119,1413,9701.83,8627.75,551.42,6684.08,7235.5,1392.25,116422,103533,6617,80209,86826,16707,2022,'FLEXEIRAS',Flexeiras,'AL',2702801,1734.0,1734,144.5,144.5,1,98.0,98.0,Pequeno I
1677,1681,270290,26723,25265,738,22266,23004,2261,26032.75,24678.25,731.75,21773.5,22505.25,2173.0,312393,296139,8781,261282,270063,26076,2022,'GIRAU DO PONCIANO',Girau do Ponciano,'AL',2702900,571.0,571,47.6,47.6,1,52.0,52.0,Pequeno II
1678,1682,270300,11490,10296,394,8444,8838,1458,11426.58,10279.75,424.0,8376.58,8800.58,1479.17,137119,123357,5088,100519,105607,17750,2022,'IBATEGUARA',Ibateguara,'AL',2703007,4418.0,5518,368.2,459.8,1,455.0,455.0,Pequeno I
1679,1683,270310,20464,18688,575,15479,16054,2634,20378.42,18706.75,561.58,15838.33,16399.92,2306.83,244541,224481,6739,190060,196799,27682,2022,'IGACI',Igaci,'AL',2703106,5884.0,8495,490.3,707.9,1,0.0,2611.0,Pequeno II
1680,1684,270320,17343,15563,815,11197,12012,3551,17089.42,15469.25,890.33,11180.17,12070.5,3398.75,205073,185631,10684,134162,144846,40785,2022,'IGREJA NOVA',Igreja Nova,'AL',2703205,5460.0,5460,455.0,455.0,2,41.0,41.0,Pequeno II
1681,1685,270330,14256,13319,801,10941,11742,1577,13928.67,13088.75,889.58,10657.25,11546.83,1541.92,167144,157065,10675,127887,138562,18503,2022,'INHAPI',Inhapi,'AL',2703304,1116.0,1116,93.0,93.0,1,77.0,77.0,Pequeno I
1682,1686,270340,4601,4198,151,3532,3683,515,4550.5,4163.92,150.08,3528.08,3678.17,485.75,54606,49967,1801,42337,44138,5829,2022,'JACARE DOS HOMENS',Jacaré Dos Homens,'AL',2703403,1156.0,1156,96.3,96.3,1,644.0,644.0,Pequeno I
1683,1687,270350,4652,4133,284,3103,3387,746,4567.67,4092.83,290.58,3083.25,3373.83,719.0,54812,49114,3487,36999,40486,8628,2022,'JACUIPE',Jacuípe,'AL',2703502,496.0,496,62.0,62.0,1,,,Pequeno I
1684,1688,270360,7914,7480,120,7116,7236,244,7402.75,7017.58,129.5,6663.25,6792.75,224.83,88833,84211,1554,79959,81513,2698,2022,'JAPARATINGA',Japaratinga,'AL',2703601,2191.0,2191,182.6,182.6,1,377.0,377.0,Pequeno I
1685,1689,270370,4430,4149,159,3468,3627,522,4452.5,4200.5,163.0,3542.58,3705.58,494.92,53430,50406,1956,42511,44467,5939,2022,'JARAMATAIA',Jaramataia,'AL',2703700,254.0,254,23.1,23.1,1,54.0,54.0,Pequeno I
1686,1690,270375,8571,7892,50,7580,7630,262,8128.0,7503.25,50.0,7170.75,7220.75,282.5,97536,90039,600,86049,86649,3390,2022,'JEQUIA DA PRAIA',Jequiá da Praia,'AL',2703759,3039.0,3039,253.2,253.2,1,243.0,243.0,Pequeno I
1687,1691,270380,15852,14596,1429,11071,12500,2096,15735.67,14571.75,1388.75,11122.33,12511.08,2060.67,188828,174861,16665,133468,150133,24728,2022,'JOAQUIM GOMES',Joaquim Gomes,'AL',2703809,2620.0,2620,218.3,218.3,1,329.0,329.0,Pequeno II
1688,1692,270390,3236,2874,59,2428,2487,387,3203.0,2871.33,65.25,2435.0,2500.25,371.08,38436,34456,783,29220,30003,4453,2022,'JUNDIA',Jundiá,'AL',2703908,1179.0,1179,98.2,98.2,1,80.0,80.0,Pequeno I
1689,1693,270400,18241,16283,691,12365,13056,3227,17930.92,16169.42,576.67,12829.67,13406.33,2763.08,215171,194033,6920,153956,160876,33157,2022,'JUNQUEIRO',Junqueiro,'AL',2704005,3455.0,3455,287.9,287.9,1,266.0,266.0,Pequeno II
1690,1694,270410,14724,13613,461,11509,11970,1643,14276.92,13228.0,455.0,11211.58,11666.58,1561.42,171323,158736,5460,134539,139999,18737,2022,'LAGOA DA CANOA',Lagoa da Canoa,'AL',2704104,3861.0,3861,321.8,321.8,1,578.0,578.0,Pequeno I
1691,1695,270420,19288,18274,614,15942,16556,1718,18463.75,17499.08,737.42,15058.33,15795.75,1703.33,221565,209989,8849,180700,189549,20440,2022,'LIMOEIRO DE ANADIA',Limoeiro de Anadia,'AL',2704203,2187.0,2187,182.2,182.2,1,72.0,72.0,Pequeno II
1692,1696,270430,413519,362693,46667,219771,266438,96255,371188.25,326221.17,48793.92,187328.83,236122.75,90098.42,4454259,3914654,585527,2247946,2833473,1081181,2022,'MACEIO',Maceió,'AL',2704302,222994.0,222994,18582.8,18582.8,16,14858.0,14858.0,Metrópole
1693,1697,270440,13493,12594,426,10980,11406,1188,13284.83,12435.58,430.75,10892.08,11322.83,1112.75,159418,149227,5169,130705,135874,13353,2022,'MAJOR ISIDORO',Major Isidoro,'AL',2704401,1776.0,1776,148.0,148.0,1,173.0,173.0,Pequeno I
1694,1698,270450,23181,21717,892,18573,19465,2252,21539.67,20270.33,843.58,17416.83,18260.42,2009.92,258476,243244,10123,209002,219125,24119,2022,'MARAGOGI',Maragogi,'AL',2704500,6377.0,6377,531.4,531.4,1,228.0,228.0,Pequeno II
1695,1699,270460,9192,8334,364,7469,7833,501,8937.17,8160.42,324.42,7356.33,7680.75,479.67,107246,97925,3893,88276,92169,5756,2022,'MARAVILHA',Maravilha,'AL',2704609,3646.0,11648,303.8,970.7,1,0.0,2185.0,Pequeno I
1696,1700,270470,34879,32244,1985,25426,27411,4833,33493.83,31126.0,1802.17,24830.42,26632.58,4493.42,401926,373512,21626,297965,319591,53921,2022,'MARECHAL DEODORO',Marechal Deodoro,'AL',2704708,1786.0,1786,162.4,162.4,1,154.0,154.0,Pequeno II
1697,1701,270480,8490,7655,508,6121,6629,1026,8271.33,7522.42,475.0,6058.42,6533.42,989.0,99256,90269,5700,72701,78401,11868,2022,'MARIBONDO',Maribondo,'AL',2704807,593.0,593,49.4,49.4,1,31.0,31.0,Pequeno I
1698,1702,270490,2682,2508,117,2037,2154,354,2659.42,2492.67,128.08,2027.92,2156.0,336.67,31913,29912,1537,24335,25872,4040,2022,'MAR VERMELHO',Mar Vermelho,'AL',2704906,252.0,252,21.0,21.0,1,18.0,18.0,Pequeno I
1699,1703,270500,15679,14579,820,11651,12471,2108,15488.42,14476.25,807.08,11655.0,12462.08,2014.17,185861,173715,9685,139860,149545,24170,2022,'MATA GRANDE',Mata Grande,'AL',2705002,106.0,106,13.2,13.2,1,,,Pequeno II
1700,1704,270510,16972,15422,930,11955,12885,2537,16314.17,14909.33,1003.08,11477.75,12480.83,2428.5,195770,178912,12037,137733,149770,29142,2022,'MATRIZ DE CAMARAGIBE',Matriz de Camaragibe,'AL',2705101,3074.0,3074,256.2,256.2,1,44.0,44.0,Pequeno II
1701,1705,270520,12195,10610,2122,5163,7285,3325,12071.75,10597.42,2133.17,5085.5,7218.67,3378.75,144861,127169,25598,61026,86624,40545,2022,'MESSIAS',Messias,'AL',2705200,2694.0,2694,224.5,224.5,1,552.0,552.0,Pequeno I
1702,1706,270530,4155,3776,233,2652,2885,891,4034.5,3687.08,188.92,2626.0,2814.92,872.17,48414,44245,2267,31512,33779,10466,2022,'MINADOR DO NEGRAO',Minador do Negrão,'AL',2705309,1937.0,1937,161.4,161.4,1,54.0,54.0,Pequeno I
1703,1707,270540,6523,5961,214,5098,5312,649,6503.25,5981.0,234.83,5107.58,5342.42,638.58,78039,71772,2818,61291,64109,7663,2022,'MONTEIROPOLIS',Monteirópolis,'AL',2705408,7547.0,12087,628.9,1007.2,1,0.0,1857.0,Pequeno I
1704,1708,270550,18221,16353,1487,12168,13655,2698,18086.67,16337.67,1409.0,12520.25,13929.25,2408.42,217040,196052,16908,150243,167151,28901,2022,'MURICI',Murici,'AL',2705507,951.0,951,118.9,118.9,1,157.0,157.0,Pequeno II
1705,1709,270560,8027,7241,495,5595,6090,1151,7986.17,7248.17,466.92,5649.58,6116.5,1131.67,95834,86978,5603,67795,73398,13580,2022,'NOVO LINO',Novo Lino,'AL',2705606,916.0,916,76.3,76.3,1,48.0,48.0,Pequeno I
1706,1710,270570,14204,13041,1198,10360,11558,1483,13486.25,12418.08,985.33,9914.0,10899.33,1518.75,161835,149017,11824,118968,130792,18225,2022,'OLHO DAGUA DAS FLORES',Olho D´água Das Flores,'AL',2705705,3080.0,3080,308.0,308.0,1,420.0,420.0,Pequeno II
1707,1711,270580,6982,6596,297,5679,5976,620,6830.83,6477.0,315.25,5575.67,5890.92,586.08,81970,77724,3783,66908,70691,7033,2022,'OLHO DAGUA DO CASADO',Olho D´água do Casado,'AL',2705804,2364.0,7376,197.0,614.7,1,57.0,57.0,Pequeno I
1708,1712,270590,4767,4573,69,4270,4339,234,4809.58,4625.5,76.17,4360.67,4436.83,188.67,57715,55506,914,52328,53242,2264,2022,'OLHO DAGUA GRANDE',Olho D´água Grande,'AL',2705903,419.0,419,34.9,34.9,1,30.0,30.0,Pequeno I
1709,1713,270600,8887,8426,214,7370,7584,842,8892.33,8451.17,254.08,7429.58,7683.67,767.5,106708,101414,3049,89155,92204,9210,2022,'OLIVENCA',Olivença,'AL',2706000,56.0,13451,4.7,1120.9,1,0.0,1312.0,Pequeno I
1710,1714,270610,10248,9526,265,8401,8666,860,10100.58,9422.5,232.83,8360.0,8592.83,829.67,121207,113070,2794,100320,103114,9956,2022,'OURO BRANCO',Ouro Branco,'AL',2706109,435.0,435,36.2,36.2,1,45.0,45.0,Pequeno I
1711,1715,270620,3911,3679,106,3081,3187,492,3908.42,3696.58,114.92,3105.75,3220.67,475.92,46901,44359,1379,37269,38648,5711,2022,'PALESTINA',Palestina,'AL',2706208,610.0,610,50.8,50.8,1,61.0,61.0,Pequeno I
1712,1716,270630,48357,44289,1954,37270,39224,5065,46140.83,42384.33,2063.58,35432.83,37496.42,4887.92,553690,508612,24763,425194,449957,58655,2022,'PALMEIRA DOS INDIOS',Palmeira Dos Índios,'AL',2706307,9751.0,9751,812.6,812.6,1,894.0,894.0,Médio
1713,1717,270640,16485,14603,544,11667,12211,2392,16238.67,14838.83,624.33,12163.0,12787.33,2051.5,194864,178066,7492,145956,153448,24618,2022,'PAO DE ACUCAR',Pão de Açúcar,'AL',2706406,6144.0,6144,512.0,512.0,2,783.0,783.0,Pequeno II
1714,1718,270642,8666,8051,664,5860,6524,1527,8478.75,7943.5,674.25,5938.17,6612.42,1331.08,101745,95322,8091,71258,79349,15973,2022,'PARICONHA',Pariconha,'AL',2706422,1904.0,1904,158.7,158.7,1,107.0,107.0,Pequeno I
1715,1719,270644,10521,9502,624,7518,8142,1360,10082.08,9147.0,597.08,7309.92,7907.0,1240.0,120985,109764,7165,87719,94884,14880,2022,'PARIPUEIRA',Paripueira,'AL',2706448,850.0,850,85.0,85.0,1,,,Pequeno I
1716,1720,270650,10502,9802,795,8053,8848,954,10135.42,9487.58,782.33,7716.33,8498.67,988.92,121625,113851,9388,92596,101984,11867,2022,'PASSO DE CAMARAGIBE',Passo de Camaragibe,'AL',2706505,942.0,942,78.5,78.5,1,80.0,80.0,Pequeno I
1717,1721,270660,5296,4844,206,3700,3906,938,5246.83,4826.25,233.67,3691.08,3924.75,901.5,62962,57915,2804,44293,47097,10818,2022,'PAULO JACINTO',Paulo Jacinto,'AL',2706604,44.0,44,6.3,6.3,1,6.0,6.0,Pequeno I
1718,1722,270670,44879,40718,1418,34447,35865,4853,42920.83,39064.67,1239.0,33238.58,34477.58,4587.08,515050,468776,14868,398863,413731,55045,2022,'PENEDO',Penedo,'AL',2706703,19208.0,54026,1600.7,4502.2,2,911.0,4478.0,Médio
1719,1723,270680,14505,13699,407,12794,13201,498,14146.83,13397.58,423.33,12475.75,12899.08,498.5,169762,160771,5080,149709,154789,5982,2022,'PIACABUCU',Piaçabuçu,'AL',2706802,2385.0,2385,198.8,198.8,1,255.0,255.0,Pequeno I
1720,1724,270690,26865,24227,771,19816,20587,3640,25766.17,23392.08,871.67,19064.25,19935.92,3456.17,309194,280705,10460,228771,239231,41474,2022,'PILAR',Pilar,'AL',2706901,9376.0,9376,781.3,781.3,2,854.0,854.0,Pequeno II
1721,1725,270700,1791,1643,190,1062,1252,391,1732.25,1608.42,179.67,1101.08,1280.75,327.67,20787,19301,2156,13213,15369,3932,2022,'PINDOBA',Pindoba,'AL',2707008,834.0,834,69.5,69.5,1,42.0,42.0,Pequeno I
1722,1726,270710,18153,16842,1122,12995,14117,2725,17693.92,16506.33,1121.08,12925.0,14046.08,2460.25,212327,198076,13453,155100,168553,29523,2022,'PIRANHAS',Piranhas,'AL',2707107,3209.0,3209,267.4,267.4,1,89.0,89.0,Pequeno II
1723,1727,270720,11106,10280,315,8929,9244,1036,11024.25,10254.58,318.0,8982.0,9300.0,954.58,132291,123055,3816,107784,111600,11455,2022,'POCO DAS TRINCHEIRAS',Poço Das Trincheiras,'AL',2707206,6672.0,12474,556.0,1039.5,1,324.0,324.0,Pequeno I
1724,1728,270730,19156,17758,1322,14573,15895,1863,18884.0,17591.33,1222.25,14924.83,16147.08,1444.25,226608,211096,14667,179098,193765,17331,2022,'PORTO CALVO',Porto Calvo,'AL',2707305,2435.0,2435,202.9,202.9,1,486.0,486.0,Pequeno II
1725,1729,270740,6691,6288,242,5190,5432,856,6505.17,6138.25,267.75,5100.33,5368.08,770.17,78062,73659,3213,61204,64417,9242,2022,'PORTO DE PEDRAS',Porto de Pedras,'AL',2707404,265.0,265,22.1,22.1,1,10.0,10.0,Pequeno I
1726,1730,270750,15617,14571,395,12835,13230,1341,15478.25,14491.58,406.67,12791.17,13197.83,1293.75,185739,173899,4880,153494,158374,15525,2022,'PORTO REAL DO COLEGIO',Porto Real do Colégio,'AL',2707503,2020.0,2020,168.3,168.3,2,144.0,144.0,Pequeno I
1727,1731,270760,9825,8868,234,7382,7616,1252,9713.08,8862.0,259.33,7391.58,7650.92,1211.08,116557,106344,3112,88699,91811,14533,2022,'QUEBRANGULO',Quebrangulo,'AL',2707602,634.0,634,52.8,52.8,1,48.0,48.0,Pequeno I
1728,1732,270770,63248,56625,8178,35959,44137,12488,59402.42,53459.25,7688.58,34454.42,42143.0,11316.25,712829,641511,92263,413453,505716,135795,2022,'RIO LARGO',Rio Largo,'AL',2707701,14477.0,14477,1206.4,1206.4,3,613.0,613.0,Médio
1729,1733,270780,5343,5087,156,4560,4716,371,5252.67,5031.0,161.83,4517.33,4679.17,351.83,63032,60372,1942,54208,56150,4222,2022,'ROTEIRO',Roteiro,'AL',2707800,4273.0,4273,388.5,388.5,1,28.0,28.0,Pequeno I
1730,1734,270790,4894,4483,336,3539,3875,608,4803.75,4405.83,342.0,3426.58,3768.58,637.25,57645,52870,4104,41119,45223,7647,2022,'SANTA LUZIA DO NORTE',Santa Luzia do Norte,'AL',2707909,2052.0,2052,171.0,171.0,1,140.0,140.0,Pequeno I
1731,1735,270800,32554,30514,1418,25273,26691,3823,31928.75,30123.33,1401.33,25310.92,26712.25,3411.08,383145,361480,16816,303731,320547,40933,2022,'SANTANA DO IPANEMA',Santana do Ipanema,'AL',2708006,6938.0,6938,578.2,578.2,1,786.0,786.0,Pequeno II
1732,1736,270810,9823,8552,588,6272,6860,1692,9789.25,8588.5,606.75,6212.75,6819.5,1769.0,117471,103062,7281,74553,81834,21228,2022,'SANTANA DO MUNDAU',Santana do Mundaú,'AL',2708105,647.0,647,53.9,53.9,1,19.0,19.0,Pequeno I
1733,1737,270820,5184,4718,228,3760,3988,730,5074.58,4646.5,235.17,3705.5,3940.67,705.83,60895,55758,2822,44466,47288,8470,2022,'SAO BRAS',São Brás,'AL',2708204,296.0,296,32.9,32.9,1,10.0,10.0,Pequeno I
1734,1738,270830,13591,12152,575,9722,10297,1855,13271.0,11933.25,528.67,9710.0,10238.67,1694.58,159252,143199,6344,116520,122864,20335,2022,'SAO JOSE DA LAJE',São José da Laje,'AL',2708303,1535.0,11453,139.5,1041.2,1,292.0,292.0,Pequeno II
1735,1739,270840,26480,24469,1488,18998,20486,3983,26182.83,24411.67,1166.17,20059.5,21225.67,3186.0,314194,292940,13994,240714,254708,38232,2022,'SAO JOSE DA TAPERA',São José da Tapera,'AL',2708402,3613.0,3613,301.1,301.1,2,318.0,318.0,Pequeno II
1736,1740,270850,22184,20663,1572,17312,18884,1779,21835.08,20445.0,1425.75,17349.92,18775.67,1669.33,262021,245340,17109,208199,225308,20032,2022,'SAO LUIS DO QUITUNDE',São Luís do Quitunde,'AL',2708501,2834.0,2834,236.2,236.2,1,99.0,99.0,Pequeno II
1737,1741,270860,35127,31225,1406,25431,26837,4388,34298.25,30596.33,1444.58,24873.83,26318.42,4277.92,411579,367156,17335,298486,315821,51335,2022,'SAO MIGUEL DOS CAMPOS',São Miguel Dos Campos,'AL',2708600,5057.0,5057,421.4,421.4,2,193.0,193.0,Médio
1738,1742,270870,7004,6110,573,4027,4600,1510,6796.25,6004.58,568.33,4098.67,4667.0,1337.58,81555,72055,6820,49184,56004,16051,2022,'SAO MIGUEL DOS MILAGRES',São Miguel Dos Milagres,'AL',2708709,582.0,582,52.9,52.9,1,,,Pequeno I
1739,1743,270880,25313,23740,816,19396,20212,3528,24901.0,23476.08,894.25,19194.5,20088.75,3387.33,298812,281713,10731,230334,241065,40648,2022,'SAO SEBASTIAO',São Sebastião,'AL',2708808,3287.0,3287,273.9,273.9,1,347.0,347.0,Pequeno II
1740,1744,270890,10279,9327,1167,5522,6689,2638,9614.33,8782.42,949.17,5576.25,6525.42,2257.0,115372,105389,11390,66915,78305,27084,2022,'SATUBA',Satuba,'AL',2708907,417.0,417,37.9,37.9,1,35.0,35.0,Pequeno I
1741,1745,270895,10885,10260,391,8929,9320,940,10591.25,10058.5,343.92,8869.0,9212.92,845.58,127095,120702,4127,106428,110555,10147,2022,'SENADOR RUI PALMEIRA',Senador Rui Palmeira,'AL',2708956,633.0,633,52.8,52.8,1,40.0,40.0,Pequeno I
1742,1746,270900,4450,3781,71,3051,3122,659,4561.75,3873.17,85.75,3068.5,3154.25,718.92,54741,46478,1029,36822,37851,8627,2022,'TANQUE DARCA',Tanque D´arca,'AL',2709004,630.0,630,52.5,52.5,1,32.0,32.0,Pequeno I
1743,1747,270910,12966,11975,490,9843,10333,1642,12488.42,11552.75,432.75,9582.67,10015.42,1537.33,149861,138633,5193,114992,120185,18448,2022,'TAQUARANA',Taquarana,'AL',2709103,841.0,841,70.1,70.1,1,79.0,79.0,Pequeno I
1744,1748,270915,28859,25381,2746,16522,19268,6113,28440.33,25221.08,2543.83,16908.75,19452.58,5768.5,341284,302653,30526,202905,233431,69222,2022,'TEOTONIO VILELA',Teotônio Vilela,'AL',2709152,14510.0,14510,1209.2,1209.2,3,941.0,941.0,Pequeno II
1745,1749,270920,18214,16894,481,14275,14756,2138,17914.08,16812.58,447.58,14401.17,14848.75,1963.83,214969,201751,5371,172814,178185,23566,2022,'TRAIPU',Traipu,'AL',2709202,2067.0,2067,172.2,172.2,1,120.0,120.0,Pequeno II
1746,1750,270930,44976,39615,4035,29442,33477,6138,43599.08,38517.67,3844.0,28743.25,32587.25,5930.42,523189,462212,46128,344919,391047,71165,2022,'UNIAO DOS PALMARES',União Dos Palmares,'AL',2709301,14421.0,14421,1201.8,1201.8,3,3840.0,3840.0,Médio
1747,1751,270940,17385,16039,752,12616,13368,2671,17473.33,16145.75,837.92,12670.17,13508.08,2637.67,209680,193749,10055,152042,162097,31652,2022,'VICOSA',Viçosa,'AL',2709400,798.0,798,79.8,79.8,1,68.0,68.0,Pequeno II
1748,1752,280010,1831,1499,80,962,1042,457,1871.25,1566.0,89.92,1026.33,1116.25,449.75,22455,18792,1079,12316,13395,5397,2022,'AMPARO DE SAO FRANCISCO',Amparo de São Francisco,'SE',2800100,521.0,521,47.4,47.4,1,29.0,29.0,Pequeno I
1749,1753,280020,13844,12267,912,9124,10036,2231,13406.92,12016.83,868.0,8897.5,9765.5,2251.33,160883,144202,10416,106770,117186,27016,2022,'AQUIDABA',Aquidabã,'SE',2800209,14324.0,14324,1302.2,1302.2,1,,,Pequeno II
1750,1754,280030,240599,212663,33860,124395,158255,54408,218263.33,193485.08,31634.0,110811.08,142445.08,51040.0,2619160,2321821,379608,1329733,1709341,612480,2022,'ARACAJU',Aracaju,'SE',2800308,253648.0,316012,21137.3,26334.3,17,18075.0,21127.0,Grande
1751,1755,280040,8586,7876,482,5875,6357,1519,8546.92,7910.0,634.92,5760.67,6395.58,1514.42,102563,94920,7619,69128,76747,18173,2022,'ARAUA',Arauá,'SE',2800407,7193.0,7193,599.4,599.4,1,463.0,463.0,Pequeno I
1752,1756,280050,13065,11655,2517,5836,8353,3302,12655.5,11439.75,2305.0,5963.92,8268.92,3170.83,151866,137277,27660,71567,99227,38050,2022,'AREIA BRANCA',Areia Branca,'SE',2800506,7240.0,10353,603.3,862.8,1,677.0,677.0,Pequeno I
1753,1757,280060,20068,17508,2604,10591,13195,4313,18598.33,16364.42,2614.58,9564.83,12179.42,4185.0,223180,196373,31375,114778,146153,50220,2022,'BARRA DOS COQUEIROS',Barra Dos Coqueiros,'SE',2800605,2774.0,2774,231.2,231.2,1,536.0,536.0,Pequeno II
1754,1758,280067,18395,16375,1032,12069,13101,3274,18169.58,16339.75,918.83,12043.25,12962.08,3377.67,218035,196077,11026,144519,155545,40532,2022,'BOQUIM',Boquim,'SE',2800670,1764.0,1764,147.0,147.0,1,59.0,59.0,Pequeno II
1755,1759,280070,5690,5406,405,4113,4518,888,5683.33,5436.33,391.58,4368.75,4760.33,676.0,68200,65236,4699,52425,57124,8112,2022,'BREJO GRANDE',Brejo Grande,'SE',2800704,558.0,558,46.5,46.5,1,150.0,150.0,Pequeno I
1756,1760,280100,11908,10637,1142,7079,8221,2416,11472.0,10321.5,1103.75,6971.92,8075.67,2245.83,137664,123858,13245,83663,96908,26950,2022,'CAMPO DO BRITO',Campo do Brito,'SE',2801009,6976.0,9253,581.3,771.1,1,594.0,594.0,Pequeno I
1757,1761,280110,4131,3727,75,3341,3416,311,4041.75,3682.17,74.75,3302.0,3376.75,305.42,48501,44186,897,39624,40521,3665,2022,'CANHOBA',Canhoba,'SE',2801108,2231.0,2231,185.9,185.9,1,629.0,629.0,Pequeno I
1758,1762,280120,23491,21726,2515,15629,18144,3582,22890.92,21284.42,2305.25,15591.42,17896.67,3387.75,274691,255413,27663,187097,214760,40653,2022,'CANINDE DE SAO FRANCISCO',Canindé de São Francisco,'SE',2801207,6420.0,6420,535.0,535.0,1,1382.0,1382.0,Pequeno II
1759,1763,280130,22249,20285,1395,15777,17172,3113,22043.5,20273.08,1232.42,16159.33,17391.75,2881.33,264522,243277,14789,193912,208701,34576,2022,'CAPELA',Capela,'SE',2801306,7315.0,7315,609.6,609.6,2,1203.0,1203.0,Pequeno II
1760,1764,280140,14806,13590,1128,10462,11590,2000,14358.42,13274.25,1023.92,10446.17,11470.08,1804.17,172301,159291,12287,125354,137641,21650,2022,'CARIRA',Carira,'SE',2801405,13961.0,13961,1163.4,1163.4,1,1603.0,1603.0,Pequeno II
1761,1765,280150,11025,10069,1065,7085,8150,1919,10943.17,10083.5,1043.25,7372.42,8415.67,1667.83,131318,121002,12519,88469,100988,20014,2022,'CARMOPOLIS',Carmópolis,'SE',2801504,6901.0,12485,575.1,1040.4,1,0.0,1296.0,Pequeno I
1762,1766,280160,3854,3468,390,2277,2667,801,3741.33,3393.08,390.0,2244.17,2634.17,758.92,44896,40717,4680,26930,31610,9107,2022,'CEDRO DE SAO JOAO',Cedro de São João,'SE',2801603,3735.0,3735,311.2,311.2,1,270.0,270.0,Pequeno I
1763,1767,280170,15039,14102,491,11871,12362,1740,14503.17,13679.17,563.83,11435.42,11999.25,1679.92,174038,164150,6766,137225,143991,20159,2022,'CRISTINAPOLIS',Cristinápolis,'SE',2801702,4570.0,9457,380.8,788.1,1,386.0,386.0,Pequeno I
1764,1768,280190,3409,3171,103,2879,2982,189,3223.92,2999.92,104.42,2653.67,2758.08,241.83,38687,35999,1253,31844,33097,2902,2022,'CUMBE',Cumbe,'SE',2801900,4342.0,4342,361.8,361.8,1,258.0,258.0,Pequeno I
1765,1769,280200,3528,3134,231,2205,2436,698,3541.92,3185.5,232.0,2281.17,2513.17,672.33,42503,38226,2784,27374,30158,8068,2022,'DIVINA PASTORA',Divina Pastora,'SE',2802007,9391.0,9391,782.6,782.6,1,698.0,698.0,Pequeno I
1766,1770,280210,46474,42461,4661,28054,32715,9746,45073.08,41404.67,4382.17,27632.08,32014.25,9390.42,540877,496856,52586,331585,384171,112685,2022,'ESTANCIA',Estância,'SE',2802106,13702.0,13702,1141.8,1141.8,2,750.0,750.0,Médio
1767,1771,280220,4785,4378,253,3515,3768,610,4696.83,4314.75,219.58,3489.67,3709.25,605.5,56362,51777,2635,41876,44511,7266,2022,'FEIRA NOVA',Feira Nova,'SE',2802205,1292.0,4465,107.7,372.1,1,0.0,1099.0,Pequeno I
1768,1772,280230,11409,9972,535,6822,7357,2615,11345.33,10022.67,584.58,7000.5,7585.08,2437.58,136144,120272,7015,84006,91021,29251,2022,'FREI PAULO',Frei Paulo,'SE',2802304,3308.0,15519,275.7,1293.2,1,308.0,308.0,Pequeno I
1769,1773,280240,9190,8496,176,7193,7369,1127,9144.83,8508.25,207.5,7218.08,7425.58,1082.67,109738,102099,2490,86617,89107,12992,2022,'GARARU',Gararu,'SE',2802403,937.0,937,78.1,78.1,1,129.0,129.0,Pequeno I
1770,1774,280250,2355,2097,133,1562,1695,402,2311.08,2067.67,146.33,1535.5,1681.83,385.83,27733,24812,1756,18426,20182,4630,2022,'GENERAL MAYNARD',General Maynard,'SE',2802502,4044.0,4044,367.6,367.6,1,480.0,480.0,Pequeno I
1771,1775,280260,5913,5461,94,5002,5096,365,5748.67,5341.17,101.75,4903.17,5004.92,336.25,68984,64094,1221,58838,60059,4035,2022,'GRACHO CARDOSO',Gracho Cardoso,'SE',2802601,3802.0,3802,316.8,316.8,1,838.0,838.0,Pequeno I
1772,1776,280270,6967,6424,361,5373,5734,690,6876.33,6385.67,405.83,5291.75,5697.58,688.08,82516,76628,4870,63501,68371,8257,2022,'ILHA DAS FLORES',Ilha Das Flores,'SE',2802700,1247.0,2550,103.9,212.5,1,25.0,25.0,Pequeno I
1773,1777,280280,12407,11572,1366,8169,9535,2037,12346.83,11601.0,1278.67,8441.83,9720.5,1880.5,148162,139212,15344,101302,116646,22566,2022,'INDIAROBA',Indiaroba,'SE',2802809,4322.0,4322,360.2,360.2,1,268.0,268.0,Pequeno I
1774,1778,280290,58329,53070,5138,34535,39673,13397,54867.58,50353.92,4536.42,33918.5,38454.92,11899.0,658411,604247,54437,407022,461459,142788,2022,'ITABAIANA',Itabaiana,'SE',2802908,7807.0,7807,650.6,650.6,2,417.0,417.0,Médio
1775,1779,280300,31563,29234,1622,24099,25721,3513,30700.08,28654.08,1943.92,23290.75,25234.67,3419.42,368401,343849,23327,279489,302816,41033,2022,'ITABAIANINHA',Itabaianinha,'SE',2803005,3424.0,3424,285.3,285.3,1,183.0,183.0,Pequeno II
1776,1780,280310,3804,3339,122,2559,2681,658,3767.5,3353.5,128.83,2533.08,2661.92,691.58,45210,40242,1546,30397,31943,8299,2022,'ITABI',Itabi,'SE',2803104,844.0,844,105.5,105.5,1,,,Pequeno I
1777,1781,280320,26056,23745,2429,16700,19129,4616,24971.67,22924.92,2454.92,15875.58,18330.5,4594.42,299660,275099,29459,190507,219966,55133,2022,'ITAPORANGA DAJUDA',Itaporanga D´ajuda,'SE',2803203,2244.0,2244,187.0,187.0,1,112.0,112.0,Pequeno II
1778,1782,280330,12319,10973,788,7874,8662,2311,12178.83,10947.42,744.17,8038.58,8782.75,2164.67,146146,131369,8930,96463,105393,25976,2022,'JAPARATUBA',Japaratuba,'SE',2803302,8723.0,9953,726.9,829.4,2,1020.0,1020.0,Pequeno I
1779,1783,280340,12001,10814,297,9574,9871,943,11926.92,10804.58,353.25,9563.33,9916.58,888.0,143123,129655,4239,114760,118999,10656,2022,'JAPOATA',Japoatã,'SE',2803401,792.0,792,66.0,66.0,1,16.0,16.0,Pequeno I
1780,1784,280350,73146,67192,2357,56108,58465,8727,68675.58,63527.83,2459.75,52244.75,54704.5,8823.33,824107,762334,29517,626937,656454,105880,2022,'LAGARTO',Lagarto,'SE',2803500,40215.0,40215,3351.2,3351.2,4,1842.0,1842.0,Médio
1781,1785,280360,17158,15631,1879,9711,11590,4041,16596.0,15331.67,1876.75,9716.42,11593.17,3738.5,199152,183980,22521,116597,139118,44862,2022,'LARANJEIRAS',Laranjeiras,'SE',2803609,8092.0,8092,674.3,674.3,2,568.0,568.0,Pequeno II
1782,1786,280370,5947,5002,257,3704,3961,1041,5769.83,4931.0,207.25,3762.5,3969.75,961.25,69238,59172,2487,45150,47637,11535,2022,'MACAMBIRA',Macambira,'SE',2803708,1424.0,1424,118.7,118.7,1,84.0,84.0,Pequeno I
1783,1787,280380,2935,2654,213,1869,2082,572,2868.92,2617.83,184.33,1879.58,2063.92,553.92,34427,31414,2212,22555,24767,6647,2022,'MALHADA DOS BOIS',Malhada Dos Bois,'SE',2803807,4383.0,4383,398.5,398.5,1,166.0,166.0,Pequeno I
1784,1788,280390,10162,8953,456,7262,7718,1235,9796.25,8732.0,435.75,7069.5,7505.25,1226.75,117555,104784,5229,84834,90063,14721,2022,'MALHADOR',Malhador,'SE',2803906,5213.0,9152,434.4,762.7,1,0.0,1233.0,Pequeno I
1785,1789,280400,10573,9705,863,7271,8134,1571,10384.5,9608.67,937.67,7077.5,8015.17,1593.5,124614,115304,11252,84930,96182,19122,2022,'MARUIM',Maruim,'SE',2804003,6151.0,6151,512.6,512.6,1,655.0,655.0,Pequeno I
1786,1790,280410,7947,7083,755,4394,5149,1934,7639.83,6871.42,672.25,4281.5,4953.75,1917.67,91678,82457,8067,51378,59445,23012,2022,'MOITA BONITA',Moita Bonita,'SE',2804102,2580.0,2580,215.0,215.0,1,585.0,585.0,Pequeno I
1787,1791,280420,12226,11515,283,10419,10702,813,11976.83,11389.08,264.25,10387.75,10652.0,737.08,143722,136669,3171,124653,127824,8845,2022,'MONTE ALEGRE DE SERGIPE',Monte Alegre de Sergipe,'SE',2804201,5976.0,7051,498.0,587.6,1,591.0,591.0,Pequeno I
1788,1792,280430,5813,5386,174,4576,4750,636,5589.17,5194.83,190.08,4327.33,4517.42,677.42,67070,62338,2281,51928,54209,8129,2022,'MURIBECA',Muribeca,'SE',2804300,50.0,50,50.0,50.0,1,,,Pequeno I
1789,1793,280440,12192,11242,503,9288,9791,1451,11925.58,11063.67,513.58,9187.5,9701.08,1362.58,143107,132764,6163,110250,116413,16351,2022,'NEOPOLIS',Neópolis,'SE',2804409,2334.0,2334,212.2,212.2,1,206.0,206.0,Pequeno I
1790,1794,280445,6307,5876,164,4545,4709,1167,6282.42,5845.92,166.58,4466.67,4633.25,1212.67,75389,70151,1999,53600,55599,14552,2022,'NOSSA SENHORA APARECIDA',Nossa Senhora Aparecida,'SE',2804458,2190.0,2190,182.5,182.5,1,612.0,612.0,Pequeno I
1791,1795,280450,26525,24229,5446,12331,17777,6452,25740.5,23681.33,5489.83,11959.5,17449.33,6232.0,308886,284176,65878,143514,209392,74784,2022,'NOSSA SENHORA DA GLORIA',Nossa Senhora da Glória,'SE',2804508,5337.0,5337,444.8,444.8,2,444.0,444.0,Pequeno II
1792,1796,280460,17984,16858,980,13975,14955,1903,17474.92,16450.75,881.42,13876.5,14757.92,1692.83,209699,197409,10577,166518,177095,20314,2022,'NOSSA SENHORA DAS DORES',Nossa Senhora Das Dores,'SE',2804607,1771.0,1771,147.6,147.6,1,96.0,96.0,Pequeno II
1793,1797,280470,5008,4370,346,3084,3430,940,4968.5,4400.92,319.33,3126.5,3445.83,955.08,59622,52811,3832,37518,41350,11461,2022,'NOSSA SENHORA DE LOURDES',Nossa Senhora de Lourdes,'SE',2804706,2642.0,2642,220.2,220.2,1,133.0,133.0,Pequeno I
1794,1798,280480,128344,117060,12010,80703,92713,24347,120863.83,110913.83,10839.92,77343.08,88183.0,22730.83,1450366,1330966,130079,928117,1058196,272770,2022,'NOSSA SENHORA DO SOCORRO',Nossa Senhora do Socorro,'SE',2804805,66789.0,66789,5565.8,5565.8,4,3307.0,3307.0,Grande
1795,1799,280490,11109,9888,559,7066,7625,2263,11055.0,9927.67,557.08,7179.25,7736.33,2191.33,132660,119132,6685,86151,92836,26296,2022,'PACATUBA',Pacatuba,'SE',2804904,6900.0,6900,627.3,627.3,1,927.0,927.0,Pequeno I
1796,1800,280500,2606,2313,75,1926,2001,312,2575.83,2320.92,72.92,1926.33,1999.25,321.67,30910,27851,875,23116,23991,3860,2022,'PEDRA MOLE',Pedra Mole,'SE',2805000,696.0,1704,58.0,142.0,1,400.0,400.0,Pequeno I
1797,1801,280510,7482,6859,153,6052,6205,654,7142.83,6552.92,191.33,5539.0,5730.33,822.58,85714,78635,2296,66468,68764,9871,2022,'PEDRINHAS',Pedrinhas,'SE',2805109,5552.0,11232,462.7,936.0,1,0.0,1338.0,Pequeno I
1798,1802,280520,4781,4384,298,3331,3629,755,4617.5,4247.83,258.92,3287.08,3546.0,701.83,55410,50974,3107,39445,42552,8422,2022,'PINHAO',Pinhão,'SE',2805208,2016.0,2016,168.0,168.0,1,539.0,539.0,Pequeno I
1799,1803,280530,6417,5907,282,4584,4866,1041,6296.83,5829.0,327.0,4554.5,4881.5,947.5,75562,69948,3924,54654,58578,11370,2022,'PIRAMBU',Pirambu,'SE',2805307,4449.0,4449,404.5,404.5,1,367.0,367.0,Pequeno I
1800,1804,280540,24526,23050,1016,19496,20512,2538,24223.5,22878.25,986.17,19569.0,20555.17,2323.08,290682,274539,11834,234828,246662,27877,2022,'POCO REDONDO',Poço Redondo,'SE',2805406,12976.0,12976,1081.3,1081.3,2,1156.0,1156.0,Pequeno II
1801,1805,280550,16735,14813,451,12081,12532,2281,16409.5,14629.92,461.08,11976.83,12437.92,2192.0,196914,175559,5533,143722,149255,26304,2022,'POCO VERDE',Poço Verde,'SE',2805505,5443.0,5443,453.6,453.6,1,1022.0,1022.0,Pequeno II
1802,1806,280560,21387,20497,409,18162,18571,1926,21143.92,20347.83,448.92,18012.0,18460.92,1886.92,253727,244174,5387,216144,221531,22643,2022,'PORTO DA FOLHA',Porto da Folha,'SE',2805604,12714.0,14993,1059.5,1249.4,2,839.0,839.0,Pequeno II
1803,1807,280570,17747,15886,735,12337,13072,2814,16730.92,15037.25,769.58,11484.33,12253.92,2783.33,200771,180447,9235,137812,147047,33400,2022,'PROPRIA',Propriá,'SE',2805703,5942.0,5942,495.2,495.2,2,282.0,282.0,Pequeno II
1804,1808,280580,16232,14958,900,11931,12831,2127,15689.5,14528.58,987.83,11418.5,12406.33,2122.25,188274,174343,11854,137022,148876,25467,2022,'RIACHAO DO DANTAS',Riachão do Dantas,'SE',2805802,1358.0,5398,113.2,449.8,1,110.0,110.0,Pequeno I
1805,1809,280590,7053,6421,419,4603,5022,1399,6921.75,6353.25,428.25,4667.92,5096.17,1257.08,83061,76239,5139,56015,61154,15085,2022,'RIACHUELO',Riachuelo,'SE',2805901,3945.0,6787,328.8,565.6,1,0.0,1764.0,Pequeno I
1806,1810,280600,11190,10305,364,8012,8376,1929,10711.33,9939.33,433.75,7573.08,8006.83,1932.5,128536,119272,5205,90877,96082,23190,2022,'RIBEIROPOLIS',Ribeirópolis,'SE',2806008,712.0,712,59.3,59.3,1,137.0,137.0,Pequeno I
1807,1811,280610,6875,6394,297,5300,5597,797,6738.25,6297.17,291.08,5246.33,5537.42,759.75,80859,75566,3493,62956,66449,9117,2022,'ROSARIO DO CATETE',Rosário do Catete,'SE',2806107,1867.0,12049,169.7,1095.4,1,0.0,1270.0,Pequeno I
1808,1812,280620,15633,14207,847,10804,11651,2556,14829.5,13574.0,857.83,10342.25,11200.08,2373.92,177954,162888,10294,124107,134401,28487,2022,'SALGADO',Salgado,'SE',2806206,1934.0,1934,161.2,161.2,1,55.0,55.0,Pequeno I
1809,1813,280630,11435,10882,842,8549,9391,1491,11173.25,10672.17,642.42,8679.25,9321.67,1350.5,134079,128066,7709,104151,111860,16206,2022,'SANTA LUZIA DO ITANHY',Santa Luzia do Itanhy,'SE',2806305,4267.0,5502,474.1,611.3,1,628.0,628.0,Pequeno I
1810,1814,280640,6577,6134,218,5449,5667,467,6551.25,6147.92,226.92,5482.17,5709.08,438.83,78615,73775,2723,65786,68509,5266,2022,'SANTANA DO SAO FRANCISCO',Santana do São Francisco,'SE',2806404,2196.0,3510,183.0,292.5,1,396.0,396.0,Pequeno I
1811,1815,280650,3423,3050,272,2089,2361,689,3381.83,3035.33,286.0,2079.0,2365.0,670.33,40582,36424,3432,24948,28380,8044,2022,'SANTA ROSA DE LIMA',Santa Rosa de Lima,'SE',2806503,1530.0,1530,139.1,139.1,1,184.0,184.0,Pequeno I
1812,1816,280660,8989,8282,220,7292,7512,770,8647.5,7983.17,258.25,6966.75,7225.0,758.17,103770,95798,3099,83601,86700,9098,2022,'SANTO AMARO DAS BROTAS',Santo Amaro Das Brotas,'SE',2806602,4381.0,5978,365.1,498.2,1,363.0,363.0,Pequeno I
1813,1817,280670,52171,47601,6533,31357,37890,9711,49712.83,45640.5,4915.33,32353.08,37268.42,8372.08,596554,547686,58984,388237,447221,100465,2022,'SAO CRISTOVAO',São Cristóvão,'SE',2806701,35044.0,35044,2920.3,2920.3,2,2399.0,2399.0,Médio
1814,1818,280680,7491,6771,538,4791,5329,1442,7263.17,6602.83,528.25,4689.33,5217.58,1385.25,87158,79234,6339,56272,62611,16623,2022,'SAO DOMINGOS',São Domingos,'SE',2806800,4630.0,6152,420.9,559.3,1,169.0,169.0,Pequeno I
1815,1819,280690,2600,2344,133,1888,2021,323,2516.33,2287.75,129.75,1837.92,1967.67,320.08,30196,27453,1557,22055,23612,3841,2022,'SAO FRANCISCO',São Francisco,'SE',2806909,2707.0,2707,246.1,246.1,1,,,Pequeno I
1816,1820,280700,3027,2724,77,2196,2273,451,3003.83,2723.5,98.42,2164.58,2263.0,460.5,36046,32682,1181,25975,27156,5526,2022,'SAO MIGUEL DO ALEIXO',São Miguel do Aleixo,'SE',2807006,2115.0,2115,176.2,176.2,1,525.0,525.0,Pequeno I
1817,1821,280710,36590,33393,1566,28820,30386,3007,36078.42,33062.25,1638.92,28492.42,30131.33,2930.92,432941,396747,19667,341909,361576,35171,2022,'SIMAO DIAS',Simão Dias,'SE',2807105,6390.0,6390,532.5,532.5,2,372.0,372.0,Pequeno II
1818,1822,280720,6415,5738,124,4765,4889,849,6306.08,5681.42,171.0,4597.08,4768.08,913.33,75673,68177,2052,55165,57217,10960,2022,'SIRIRI',Siriri,'SE',2807204,3817.0,3817,347.0,347.0,1,119.0,119.0,Pequeno I
1819,1823,280730,2847,2555,212,1737,1949,606,2852.25,2593.0,228.17,1794.17,2022.33,570.67,34227,31116,2738,21530,24268,6848,2022,'TELHA',Telha,'SE',2807303,3060.0,3060,255.0,255.0,1,255.0,255.0,Pequeno I
1820,1824,280740,40048,36038,2172,28191,30363,5675,38568.75,34889.92,2163.42,26854.58,29018.0,5871.92,462825,418679,25961,322255,348216,70463,2022,'TOBIAS BARRETO',Tobias Barreto,'SE',2807402,6070.0,6070,505.8,505.8,2,663.0,663.0,Pequeno II
1821,1825,280750,10337,9309,660,6556,7216,2093,10261.25,9320.67,646.5,6614.75,7261.25,2059.42,123135,111848,7758,79377,87135,24713,2022,'TOMAR DO GERU',Tomar do Geru,'SE',2807501,4560.0,4560,380.0,380.0,1,270.0,270.0,Pequeno I
1822,1826,280760,19242,17413,1583,12489,14072,3341,18534.58,16949.83,1569.08,11920.92,13490.0,3459.83,222415,203398,18829,143051,161880,41518,2022,'UMBAUBA',Umbaúba,'SE',2807600,2199.0,2199,183.2,183.2,1,410.0,410.0,Pequeno II
1823,1827,290010,7084,5145,53,4302,4355,790,6960.17,5129.42,41.5,4202.42,4243.92,885.5,83522,61553,498,50429,50927,10626,2022,'ABAIRA',Abaíra,'BA',2900108,3129.0,3129,260.8,260.8,1,285.0,285.0,Pequeno I
1824,1828,290020,15278,14465,823,12326,13149,1316,15103.33,14381.42,815.17,12389.58,13204.75,1176.67,181240,172577,9782,148675,158457,14120,2022,'ABARE',Abaré,'BA',2900207,486.0,486,40.5,40.5,1,40.0,40.0,Pequeno I
1825,1829,290030,11254,10058,625,8136,8761,1297,11087.92,9998.33,485.17,8393.75,8878.92,1119.42,133055,119980,5822,100725,106547,13433,2022,'ACAJUTIBA',Acajutiba,'BA',2900306,2879.0,2879,239.9,239.9,1,189.0,189.0,Pequeno I
1826,1830,290035,12116,10479,430,8403,8833,1646,11881.92,10413.08,486.5,8275.33,8761.83,1651.25,142583,124957,5838,99304,105142,19815,2022,'ADUSTINA',Adustina,'BA',2900355,1348.0,1348,112.3,112.3,1,29.0,29.0,Pequeno I
1827,1831,290040,12220,11062,423,9633,10056,1006,11635.42,10607.58,584.08,8933.42,9517.5,1090.08,139625,127291,7009,107201,114210,13081,2022,'AGUA FRIA',Água Fria,'BA',2900405,944.0,944,94.4,94.4,1,,,Pequeno I
1828,1832,290050,7203,6401,475,4210,4685,1716,7025.0,6291.33,450.5,4217.0,4667.5,1623.83,84300,75496,5406,50604,56010,19486,2022,'ERICO CARDOSO',Érico Cardoso,'BA',2900504,1177.0,1177,98.1,98.1,1,81.0,81.0,Pequeno I
1829,1833,290060,3655,2969,389,2020,2409,560,3511.42,2883.42,369.33,1924.83,2294.17,589.25,42137,34601,4432,23098,27530,7071,2022,'AIQUARA',Aiquara,'BA',2900603,1295.0,1295,107.9,107.9,1,75.0,75.0,Pequeno I
1830,1834,290070,99460,90137,5554,69087,74641,15496,93949.83,85988.08,5006.92,66839.67,71846.58,14141.5,1127398,1031857,60083,802076,862159,169698,2022,'ALAGOINHAS',Alagoinhas,'BA',2900702,36098.0,36098,3008.2,3008.2,4,1633.0,1633.0,Grande
1831,1835,290080,19070,17499,1827,12515,14342,3157,17734.25,16426.25,1631.25,11930.17,13561.42,2864.83,212811,197115,19575,143162,162737,34378,2022,'ALCOBACA',Alcobaça,'BA',2900801,2319.0,2319,193.2,193.2,1,81.0,81.0,Pequeno II
1832,1836,290090,4490,3688,58,3373,3431,257,4399.92,3637.83,51.58,3314.5,3366.08,271.75,52799,43654,619,39774,40393,3261,2022,'ALMADINA',Almadina,'BA',2900900,5792.0,11629,482.7,969.1,1,282.0,282.0,Pequeno I
1833,1837,290100,27711,24218,3906,13138,17044,7174,27211.58,24056.42,3707.58,13566.0,17273.58,6782.83,326539,288677,44491,162792,207283,81394,2022,'AMARGOSA',Amargosa,'BA',2901007,23512.0,25576,1959.3,2131.3,2,1268.0,1268.0,Pequeno II
1834,1838,290110,15699,14130,1792,8602,10394,3736,15119.58,13853.92,1609.92,8890.25,10500.17,3353.75,181435,166247,19319,106683,126002,40245,2022,'AMELIA RODRIGUES',Amélia Rodrigues,'BA',2901106,1768.0,1768,147.3,147.3,1,167.0,167.0,Pequeno II
1835,1839,290115,12859,11555,1038,8877,9915,1640,12563.33,11375.92,916.0,8818.92,9734.92,1641.0,150760,136511,10992,105827,116819,19692,2022,'AMERICA DOURADA',América Dourada,'BA',2901155,908.0,908,100.9,100.9,1,56.0,56.0,Pequeno I
1836,1840,290120,17498,15628,549,13064,13613,2015,17012.75,15301.5,569.5,12712.58,13282.08,2019.42,204153,183618,6834,152551,159385,24233,2022,'ANAGE',Anagé,'BA',2901205,1825.0,1825,152.1,152.1,1,42.0,42.0,Pequeno II
1837,1841,290130,11716,10060,565,7394,7959,2101,11704.67,10164.17,508.75,7674.33,8183.08,1981.08,140456,121970,6105,92092,98197,23773,2022,'ANDARAI',Andaraí,'BA',2901304,3265.0,3265,272.1,272.1,1,424.0,424.0,Pequeno I
1838,1842,290135,11402,9671,414,7484,7898,1773,11049.33,9500.08,417.42,7327.08,7744.5,1755.58,132592,114001,5009,87925,92934,21067,2022,'ANDORINHA',Andorinha,'BA',2901353,6190.0,6190,515.8,515.8,2,492.0,492.0,Pequeno I
1839,1843,290140,12372,10716,521,8763,9284,1432,12229.92,10714.83,489.17,8918.67,9407.83,1307.0,146759,128578,5870,107024,112894,15684,2022,'ANGICAL',Angical,'BA',2901403,2074.0,2074,207.4,207.4,1,74.0,74.0,Pequeno I
1840,1844,290150,7671,7080,395,5816,6211,869,7234.17,6699.08,352.83,5467.0,5819.83,879.25,86810,80389,4234,65604,69838,10551,2022,'ANGUERA',Anguera,'BA',2901502,2706.0,2706,225.5,225.5,1,220.0,220.0,Pequeno I
1841,1845,290160,8435,7751,353,6455,6808,943,8295.5,7672.92,344.75,6422.25,6767.0,905.92,99546,92075,4137,77067,81204,10871,2022,'ANTAS',Antas,'BA',2901601,981.0,981,81.8,81.8,1,51.0,51.0,Pequeno I
1842,1846,290170,9285,8705,282,7759,8041,664,9035.75,8537.25,259.33,7726.58,7985.92,551.33,108429,102447,3112,92719,95831,6616,2022,'ANTONIO CARDOSO',Antônio Cardoso,'BA',2901700,1166.0,1166,97.2,97.2,1,36.0,36.0,Pequeno I
1843,1847,290180,8663,7716,246,6399,6645,1071,8587.92,7679.75,273.83,6368.75,6642.58,1037.17,103055,92157,3286,76425,79711,12446,2022,'ANTONIO GONCALVES',Antônio Gonçalves,'BA',2901809,800.0,800,66.7,66.7,1,42.0,42.0,Pequeno I
1844,1848,290190,13148,12293,339,10548,10887,1406,12738.67,11949.08,405.83,10054.0,10459.83,1489.25,152864,143389,4870,120648,125518,17871,2022,'APORA',Aporá,'BA',2901908,1203.0,1203,100.2,100.2,2,56.0,56.0,Pequeno I
1845,1849,290195,6754,5885,317,4810,5127,758,6439.5,5662.5,245.92,4758.42,5004.33,658.17,77274,67950,2951,57101,60052,7898,2022,'APUAREMA',Apuarema,'BA',2901957,5293.0,5293,481.2,481.2,1,20.0,20.0,Pequeno I
1846,1850,290200,12321,10505,599,7412,8011,2494,12150.83,10470.58,514.92,7678.67,8193.58,2277.0,145810,125647,6179,92144,98323,27324,2022,'ARACATU',Aracatu,'BA',2902005,3837.0,3837,319.8,319.8,1,138.0,138.0,Pequeno I
1847,1851,290205,9704,8896,442,7075,7517,1379,9504.92,8815.33,480.5,6948.58,7429.08,1386.25,114059,105784,5766,83383,89149,16635,2022,'ARACAS',Araças,'BA',2902054,1634.0,1634,136.2,136.2,1,95.0,95.0,Pequeno I
1848,1852,290210,39668,36529,3015,28217,31232,5297,38234.0,35458.25,2678.25,27887.75,30566.0,4892.25,458808,425499,32139,334653,366792,58707,2022,'ARACI',Araci,'BA',2902104,5829.0,5829,485.8,485.8,2,168.0,168.0,Médio
1849,1853,290220,7720,7149,223,6151,6374,775,7515.75,6982.25,239.83,5951.58,6191.42,790.83,90189,83787,2878,71419,74297,9490,2022,'ARAMARI',Aramari,'BA',2902203,123.0,123,123.0,123.0,1,123.0,123.0,Pequeno I
1850,1854,290225,6932,5998,120,5431,5551,447,6986.17,6096.92,147.25,5490.17,5637.42,459.5,83834,73163,1767,65882,67649,5514,2022,'ARATACA',Arataca,'BA',2902252,5139.0,5139,467.2,467.2,1,480.0,480.0,Pequeno I
1851,1855,290230,7455,7073,241,6006,6247,826,7263.67,6933.33,188.83,6061.42,6250.25,683.08,87164,83200,2266,72737,75003,8197,2022,'ARATUIPE',Aratuípe,'BA',2902302,1264.0,1264,105.3,105.3,1,131.0,131.0,Pequeno I
1852,1856,290240,10375,9225,249,8000,8249,976,10110.33,9025.25,251.42,7802.58,8054.0,971.25,121324,108303,3017,93631,96648,11655,2022,'AURELINO LEAL',Aurelino Leal,'BA',2902401,5956.0,5956,496.3,496.3,1,362.0,362.0,Pequeno I
1853,1857,290250,12078,10751,378,9031,9409,1342,11902.25,10704.58,368.75,8989.08,9357.83,1346.75,142827,128455,4425,107869,112294,16161,2022,'BAIANOPOLIS',Baianópolis,'BA',2902500,965.0,965,107.2,107.2,1,37.0,37.0,Pequeno I
1854,1858,290260,14104,12605,655,10318,10973,1632,13920.42,12538.75,695.67,10267.08,10962.75,1576.0,167045,150465,8348,123205,131553,18912,2022,'BAIXA GRANDE',Baixa Grande,'BA',2902609,649.0,649,72.1,72.1,1,106.0,106.0,Pequeno II
1855,1859,290265,10646,9190,897,5845,6742,2448,10613.92,9256.25,774.5,6209.58,6984.08,2272.17,127367,111075,9294,74515,83809,27266,2022,'BANZAE',Banzaê,'BA',2902658,12284.0,14269,1023.7,1189.1,3,756.0,756.0,Pequeno I
1856,1860,290270,39360,37291,2795,28562,31357,5934,38480.42,36776.5,2643.17,28831.67,31474.83,5301.67,461765,441318,31718,345980,377698,63620,2022,'BARRA',Barra,'BA',2902708,2285.0,2285,207.7,207.7,1,119.0,119.0,Pequeno II
1857,1861,290280,20208,18098,1813,11862,13675,4423,19662.33,17733.17,1465.33,12156.67,13622.0,4111.17,235948,212798,17584,145880,163464,49334,2022,'BARRA DA ESTIVA',Barra da Estiva,'BA',2902807,1130.0,1130,94.2,94.2,1,94.0,94.0,Pequeno II
1858,1862,290290,31035,26661,3054,16348,19402,7259,30495.83,26581.08,2800.83,17172.17,19973.0,6608.08,365950,318973,33610,206066,239676,79297,2022,'BARRA DO CHOCA',Barra do Choça,'BA',2902906,15896.0,15896,1324.7,1324.7,2,1102.0,1102.0,Pequeno II
1859,1863,290300,12260,9712,590,6648,7238,2474,12077.17,9658.08,630.42,6650.58,7281.0,2377.08,144926,115897,7565,79807,87372,28525,2022,'BARRA DO MENDES',Barra do Mendes,'BA',2903003,978.0,978,81.5,81.5,1,129.0,129.0,Pequeno I
1860,1864,290310,4924,4342,78,3972,4050,292,4625.42,4100.83,90.58,3681.92,3772.5,328.33,55505,49210,1087,44183,45270,3940,2022,'BARRA DO ROCHA',Barra do Rocha,'BA',2903102,6962.0,6962,580.2,580.2,1,600.0,600.0,Pequeno I
1861,1865,290320,81326,71444,12238,41260,53498,17946,75624.0,66784.33,11468.42,38576.67,50045.08,16739.25,907488,801412,137621,462920,600541,200871,2022,'BARREIRAS',Barreiras,'BA',2903201,100055.0,125306,8337.9,10442.2,6,6693.0,6693.0,Grande
1862,1866,290323,11235,10084,295,7883,8178,1906,10941.92,9907.42,296.5,7747.08,8043.58,1863.83,131303,118889,3558,92965,96523,22366,2022,'BARRO ALTO',Barro Alto,'BA',2903235,188.0,188,15.7,15.7,1,10.0,10.0,Pequeno I
1863,1867,290327,12841,11227,975,7447,8422,2805,12695.67,11339.75,961.5,7757.25,8718.75,2621.0,152348,136077,11538,93087,104625,31452,2022,'BARROCAS',Barrocas,'BA',2903276,974.0,974,81.2,81.2,1,56.0,56.0,Pequeno I
1864,1868,290330,5064,4438,29,4133,4162,276,5038.33,4441.08,41.42,4114.33,4155.75,285.33,60460,53293,497,49372,49869,3424,2022,'BARRO PRETO',Governador Lomanto Júnior,'BA',2903300,1054.0,1054,87.8,87.8,1,74.0,74.0,Pequeno I
1865,1869,290340,16202,14169,1099,11184,12283,1886,15683.5,13774.42,1168.17,10680.83,11849.0,1925.42,188202,165293,14018,128170,142188,23105,2022,'BELMONTE',Belmonte,'BA',2903409,6460.0,6460,587.3,587.3,1,84.0,84.0,Pequeno II
1866,1870,290350,14384,12694,759,9069,9828,2866,14071.17,12505.58,795.25,8879.42,9674.67,2830.92,168854,150067,9543,106553,116096,33971,2022,'BELO CAMPO',Belo Campo,'BA',2903508,4439.0,4439,493.2,493.2,1,476.0,476.0,Pequeno I
1867,1871,290360,13934,12745,269,11177,11446,1299,13709.92,12703.25,282.75,11146.58,11429.33,1273.92,164519,152439,3393,133759,137152,15287,2022,'BIRITINGA',Biritinga,'BA',2903607,854.0,854,71.2,71.2,1,79.0,79.0,Pequeno I
1868,1872,290370,12642,10517,414,7442,7856,2661,12790.75,10788.67,433.25,7754.92,8188.17,2600.5,153489,129464,5199,93059,98258,31206,2022,'BOA NOVA',Boa Nova,'BA',2903706,1803.0,1803,163.9,163.9,1,84.0,84.0,Pequeno I
1869,1873,290380,15459,13828,309,11804,12113,1715,15463.25,13950.25,329.17,12052.25,12381.42,1568.83,185559,167403,3950,144627,148577,18826,2022,'BOA VISTA DO TUPIM',Boa Vista do Tupim,'BA',2903805,5533.0,5533,461.1,461.1,2,137.0,137.0,Pequeno I
1870,1874,290390,46981,41561,3936,28471,32407,9154,45494.83,40602.0,3988.83,27828.83,31817.67,8784.33,545938,487224,47866,333946,381812,105412,2022,'BOM JESUS DA LAPA',Bom Jesus da Lapa,'BA',2903904,5592.0,5592,508.4,508.4,3,,,Médio
1871,1875,290395,8782,7517,261,5744,6005,1512,8739.17,7562.67,294.92,5756.67,6051.58,1511.08,104870,90752,3539,69080,72619,18133,2022,'BOM JESUS DA SERRA',Bom Jesus da Serra,'BA',2903953,3173.0,3173,264.4,264.4,1,250.0,250.0,Pequeno I
1872,1876,290400,11102,9578,558,6969,7527,2051,10913.17,9511.58,511.92,7040.0,7551.92,1959.67,130958,114139,6143,84480,90623,23516,2022,'BONINAL',Boninal,'BA',2904001,3629.0,3629,302.4,302.4,2,195.0,195.0,Pequeno I
1873,1877,290405,13959,12459,1255,8353,9608,2851,13879.92,12519.17,1107.83,8632.42,9740.25,2778.92,166559,150230,13294,103589,116883,33347,2022,'BONITO',Bonito,'BA',2904050,966.0,966,80.5,80.5,1,90.0,90.0,Pequeno I
1874,1878,290410,16067,13607,661,9957,10618,2989,15896.42,13557.58,647.83,10013.0,10660.83,2896.75,190757,162691,7774,120156,127930,34761,2022,'BOQUIRA',Boquira,'BA',2904100,835.0,835,92.8,92.8,1,81.0,81.0,Pequeno II
1875,1879,290420,9071,7946,280,6174,6454,1492,8956.42,7944.25,281.42,6257.08,6538.5,1405.75,107477,95331,3377,75085,78462,16869,2022,'BOTUPORA',Botuporã,'BA',2904209,1957.0,1957,163.1,163.1,1,110.0,110.0,Pequeno I
1876,1880,290430,9613,8514,484,6509,6993,1521,9410.0,8390.42,507.92,6278.83,6786.75,1603.67,112920,100685,6095,75346,81441,19244,2022,'BREJOES',Brejões,'BA',2904308,2549.0,2549,212.4,212.4,1,239.0,239.0,Pequeno I
1877,1881,290440,7659,6174,383,4406,4789,1385,7523.33,6073.08,359.5,4360.92,4720.42,1352.67,90280,72877,4314,52331,56645,16232,2022,'BREJOLANDIA',Brejolândia,'BA',2904407,1100.0,1100,220.0,220.0,1,,,Pequeno I
1878,1882,290450,9982,8557,222,7317,7539,1018,9570.33,8274.58,289.08,6853.92,7143.0,1131.58,114844,99295,3469,82247,85716,13579,2022,'BROTAS DE MACAUBAS',Brotas de Macaúbas,'BA',2904506,2307.0,2307,230.7,230.7,1,211.0,211.0,Pequeno I
1879,1883,290460,39633,34513,7490,13704,21194,13319,38000.33,33614.58,6871.58,14309.75,21181.33,12433.25,456004,403375,82459,171717,254176,149199,2022,'BRUMADO',Brumado,'BA',2904605,12190.0,12190,1015.8,1015.8,3,972.0,972.0,Médio
1880,1884,290470,12061,10121,940,6649,7589,2532,11846.58,9989.25,1046.5,6364.08,7410.58,2578.67,142159,119871,12558,76369,88927,30944,2022,'BUERAREMA',Buerarema,'BA',2904704,3049.0,3049,254.1,254.1,1,304.0,304.0,Pequeno I
1881,1885,290475,19991,17690,446,14513,14959,2731,19890.42,17802.17,467.5,14680.0,15147.5,2654.67,238685,213626,5610,176160,181770,31856,2022,'BURITIRAMA',Buritirama,'BA',2904753,1383.0,1383,115.2,115.2,1,80.0,80.0,Pequeno I
1882,1886,290480,4931,4314,223,3112,3335,979,4851.5,4295.58,227.75,3065.92,3293.67,1001.92,58218,51547,2733,36791,39524,12023,2022,'CAATIBA',Caatiba,'BA',2904803,1442.0,1442,131.1,131.1,1,180.0,180.0,Pequeno I
1883,1887,290485,14248,13190,663,10578,11241,1949,14021.08,13075.33,625.0,10724.58,11349.58,1725.75,168253,156904,7500,128695,136195,20709,2022,'CABACEIRAS DO PARAGUACU',Cabaceiras do Paraguaçu,'BA',2904852,903.0,903,75.2,75.2,1,90.0,90.0,Pequeno I
1884,1888,290490,23487,21981,943,18223,19166,2815,22772.25,21401.83,890.75,17753.42,18644.17,2757.67,273267,256822,10689,213041,223730,33092,2022,'CACHOEIRA',Cachoeira,'BA',2904902,2395.0,2395,199.6,199.6,3,329.0,329.0,Pequeno II
1885,1889,290500,13619,11211,2171,4313,6484,4727,13280.33,11160.17,1985.75,4559.42,6545.17,4615.0,159364,133922,23829,54713,78542,55380,2022,'CACULE',Caculé,'BA',2905008,3499.0,3499,291.6,291.6,1,206.0,206.0,Pequeno II
1886,1890,290510,9245,8306,230,7307,7537,769,9142.33,8279.83,229.92,7322.75,7552.67,727.17,109708,99358,2759,87873,90632,8726,2022,'CAEM',Caém,'BA',2905107,4268.0,11737,355.7,978.1,1,96.0,96.0,Pequeno I
1887,1891,290515,10390,9576,86,8727,8813,763,10373.08,9621.67,110.67,8809.92,8920.58,701.08,124477,115460,1328,105719,107047,8413,2022,'CAETANOS',Caetanos,'BA',2905156,1909.0,1909,159.1,159.1,1,173.0,173.0,Pequeno I
1888,1892,290520,37430,30748,1709,19386,21095,9653,36284.83,30410.17,1927.67,18922.25,20849.92,9560.25,435418,364922,23132,227067,250199,114723,2022,'CAETITE',Caetité,'BA',2905206,8635.0,8635,719.6,719.6,2,665.0,665.0,Pequeno II
1889,1893,290530,15055,13489,380,11262,11642,1847,14820.42,13398.25,434.42,11184.58,11619.0,1779.25,177845,160779,5213,134215,139428,21351,2022,'CAFARNAUM',Cafarnaum,'BA',2905305,555.0,555,185.0,185.0,1,,,Pequeno I
1890,1894,290540,10503,10047,464,8859,9323,724,10056.08,9612.83,279.17,8744.67,9023.83,589.0,120673,115354,3350,104936,108286,7068,2022,'CAIRU',Cairu,'BA',2905404,6923.0,6923,576.9,576.9,3,582.0,582.0,Pequeno I
1891,1895,290550,11512,10715,107,9883,9990,725,11502.83,10761.83,108.5,9943.5,10052.0,709.83,138034,129142,1302,119322,120624,8518,2022,'CALDEIRAO GRANDE',Caldeirão Grande,'BA',2905503,1321.0,1321,120.1,120.1,1,2.0,2.0,Pequeno I
1892,1896,290560,17841,15172,1595,9245,10840,4332,17381.25,14938.0,1417.42,9643.5,11060.92,3877.08,208575,179256,17009,115722,132731,46525,2022,'CAMACAN',Camacan,'BA',2905602,17502.0,17502,1458.5,1458.5,1,1361.0,1361.0,Pequeno II
1893,1897,290570,149407,139972,10157,109975,120132,19840,128162.17,120360.92,6983.58,96937.08,103920.67,16440.25,1537946,1444331,83803,1163245,1247048,197283,2022,'CAMACARI',Camaçari,'BA',2905701,54246.0,54246,4520.5,4520.5,7,1523.0,1523.0,Grande
1894,1898,290580,25948,23902,2040,18001,20041,3861,24982.33,23113.83,2018.83,17492.92,19511.75,3602.08,299788,277366,24226,209915,234141,43225,2022,'CAMAMU',Camamu,'BA',2905800,8036.0,8036,669.7,669.7,2,305.0,305.0,Pequeno II
1895,1899,290590,23095,20688,555,17060,17615,3073,22570.42,20336.33,657.42,16716.25,17373.67,2962.67,270845,244036,7889,200595,208484,35552,2022,'CAMPO ALEGRE DE LOURDES',Campo Alegre de Lourdes,'BA',2905909,7042.0,7042,586.8,586.8,1,528.0,528.0,Pequeno II
1896,1900,290600,56894,51801,2947,40381,43328,8473,55857.08,51184.08,2714.92,40428.67,43143.58,8040.5,670285,614209,32579,485144,517723,96486,2022,'CAMPO FORMOSO',Campo Formoso,'BA',2906006,27283.0,31083,2273.6,2590.2,4,1835.0,1835.0,Médio
1897,1901,290610,8310,7010,320,4878,5198,1812,8237.58,7025.83,364.42,4869.17,5233.58,1792.25,98851,84310,4373,58430,62803,21507,2022,'CANAPOLIS',Canápolis,'BA',2906105,276.0,276,46.0,46.0,1,,,Pequeno I
1898,1902,290620,18913,17206,1134,13756,14890,2316,18497.83,16949.92,971.67,13803.08,14774.75,2175.17,221974,203399,11660,165637,177297,26102,2022,'CANARANA',Canarana,'BA',2906204,6053.0,6053,550.3,550.3,1,580.0,580.0,Pequeno II
1899,1903,290630,25043,22190,1618,17612,19230,2960,24035.67,21364.33,1615.0,16770.5,18385.5,2978.83,288428,256372,19380,201246,220626,35746,2022,'CANAVIEIRAS',Canavieiras,'BA',2906303,2838.0,2838,236.5,236.5,1,317.0,317.0,Pequeno II
1900,1904,290640,7387,6306,514,4553,5067,1239,7295.67,6275.0,461.83,4558.33,5020.17,1254.83,87548,75300,5542,54700,60242,15058,2022,'CANDEAL',Candeal,'BA',2906402,4768.0,4768,397.3,397.3,1,285.0,285.0,Pequeno I
1901,1905,290650,43448,41303,2215,36174,38389,2914,38552.08,36592.42,2956.33,30587.33,33543.67,3048.75,462625,439109,35476,367048,402524,36585,2022,'CANDEIAS',Candeias,'BA',2906501,10001.0,10001,833.4,833.4,3,1300.0,1300.0,Médio
1902,1906,290660,10655,9029,500,6402,6902,2127,10327.83,8943.67,413.25,6526.42,6939.67,2004.0,123934,107324,4959,78317,83276,24048,2022,'CANDIBA',Candiba,'BA',2906600,1751.0,1751,145.9,145.9,1,159.0,159.0,Pequeno I
1903,1907,290670,21120,19235,582,16558,17140,2095,20434.0,18649.08,716.33,15737.33,16453.67,2195.42,245208,223789,8596,188848,197444,26345,2022,'CANDIDO SALES',Cândido Sales,'BA',2906709,8872.0,8872,739.3,739.3,1,388.0,388.0,Pequeno II
1904,1908,290680,32047,28559,910,23226,24136,4423,31712.0,28532.67,1066.83,23416.92,24483.75,4048.92,380544,342392,12802,281003,293805,48587,2022,'CANSANCAO',Cansanção,'BA',2906808,1883.0,1883,156.9,156.9,1,148.0,148.0,Pequeno II
1905,1909,290682,13728,12539,686,10079,10765,1774,13372.58,12324.5,609.08,10086.58,10695.67,1628.83,160471,147894,7309,121039,128348,19546,2022,'CANUDOS',Canudos,'BA',2906824,2613.0,2613,237.5,237.5,1,310.0,310.0,Pequeno I
1906,1910,290685,8745,7028,1020,4122,5142,1886,8495.92,6925.08,935.58,4082.83,5018.42,1906.67,101951,83101,11227,48994,60221,22880,2022,'CAPELA DO ALTO ALEGRE',Capela do Alto Alegre,'BA',2906857,7305.0,11683,608.8,973.6,1,0.0,1233.0,Pequeno I
1907,1911,290687,21534,18943,2496,12222,14718,4225,19916.83,17609.17,2113.08,11644.5,13757.58,3851.58,239002,211310,25357,139734,165091,46219,2022,'CAPIM GROSSO',Capim Grosso,'BA',2906873,1642.0,1642,136.8,136.8,1,133.0,133.0,Pequeno II
1908,1912,290689,8340,6859,891,4365,5256,1603,8259.33,6874.83,813.58,4471.42,5285.0,1589.83,99112,82498,9763,53657,63420,19078,2022,'CARAIBAS',Caraíbas,'BA',2906899,833.0,833,69.4,69.4,1,14.0,14.0,Pequeno I
1909,1913,290690,16096,14271,978,10251,11229,3042,15401.08,13771.25,875.0,10111.92,10986.92,2784.33,184813,165255,10500,121343,131843,33412,2022,'CARAVELAS',Caravelas,'BA',2906907,3116.0,3116,311.6,311.6,1,197.0,197.0,Pequeno II
1910,1914,290700,7861,7322,176,6440,6616,706,7676.17,7210.25,169.0,6447.5,6616.5,593.75,92114,86523,2028,77370,79398,7125,2022,'CARDEAL DA SILVA',Cardeal da Silva,'BA',2907004,3526.0,3526,293.8,293.8,1,27.0,27.0,Pequeno I
1911,1915,290710,25461,23101,737,19952,20689,2412,24852.58,22746.08,772.33,19514.0,20286.33,2459.75,298231,272953,9268,234168,243436,29517,2022,'CARINHANHA',Carinhanha,'BA',2907103,6698.0,6698,558.2,558.2,3,440.0,440.0,Pequeno II
1912,1916,290720,57768,53573,3389,41362,44751,8822,55269.17,51768.08,3112.83,40770.25,43883.08,7885.0,663230,621217,37354,489243,526597,94620,2022,'CASA NOVA',Casa Nova,'BA',2907202,4055.0,42758,337.9,3563.2,1,1600.0,1600.0,Médio
1913,1917,290730,18236,16604,913,12304,13217,3387,17683.17,16245.58,734.42,12576.25,13310.67,2934.92,212198,194947,8813,150915,159728,35219,2022,'CASTRO ALVES',Castro Alves,'BA',2907301,2712.0,2712,226.0,226.0,1,81.0,81.0,Pequeno II
1914,1918,290740,2995,2503,45,2170,2215,288,2945.83,2514.42,47.75,2185.33,2233.08,281.33,35350,30173,573,26224,26797,3376,2022,'CATOLANDIA',Catolândia,'BA',2907400,1210.0,1210,121.0,121.0,1,90.0,90.0,Pequeno I
1915,1919,290750,33884,30237,903,23893,24796,5441,32123.17,29011.5,1165.58,22565.33,23730.92,5280.58,385478,348138,13987,270784,284771,63367,2022,'CATU',Catu,'BA',2907509,7211.0,7211,600.9,600.9,2,181.0,181.0,Médio
1916,1920,290755,6187,5342,284,3725,4009,1333,6069.92,5279.67,327.25,3635.92,3963.17,1316.5,72839,63356,3927,43631,47558,15798,2022,'CATURAMA',Caturama,'BA',2907558,1257.0,1257,104.8,104.8,1,27.0,27.0,Pequeno I
1917,1921,290760,11843,10432,520,7515,8035,2397,11522.75,10166.58,575.75,7229.67,7805.42,2361.17,138273,121999,6909,86756,93665,28334,2022,'CENTRAL',Central,'BA',2907608,1007.0,1007,100.7,100.7,1,90.0,90.0,Pequeno I
1918,1922,290770,8741,8409,201,7463,7664,745,8562.75,8246.67,225.92,7213.33,7439.25,807.42,102753,98960,2711,86560,89271,9689,2022,'CHORROCHO',Chorrochó,'BA',2907707,1424.0,1424,118.7,118.7,2,50.0,50.0,Pequeno I
1919,1923,290780,21360,19439,654,15126,15780,3659,20905.5,19182.25,690.08,15076.17,15766.25,3416.0,250866,230187,8281,180914,189195,40992,2022,'CICERO DANTAS',Cícero Dantas,'BA',2907806,11492.0,11492,957.7,957.7,1,1276.0,1276.0,Pequeno II
1920,1924,290790,14842,13536,688,11131,11819,1717,14350.08,13193.25,643.67,10941.42,11585.08,1608.17,172201,158319,7724,131297,139021,19298,2022,'CIPO',Cipó,'BA',2907905,10708.0,10708,892.3,892.3,3,654.0,654.0,Pequeno I
1921,1925,290800,15153,12416,646,9359,10005,2411,14959.5,12340.92,570.75,9462.25,10033.0,2307.92,179514,148091,6849,113547,120396,27695,2022,'COARACI',Coaraci,'BA',2908002,4763.0,4763,396.9,396.9,1,136.0,136.0,Pequeno II
1922,1926,290810,15034,13092,538,10154,10692,2400,14612.58,12870.5,485.25,10016.58,10501.83,2368.67,175351,154446,5823,120199,126022,28424,2022,'COCOS',Cocos,'BA',2908101,1800.0,1800,150.0,150.0,1,49.0,49.0,Pequeno I
1923,1927,290820,14545,13206,681,9326,10007,3199,14344.67,13308.25,770.58,9572.25,10342.83,2965.42,172136,159699,9247,114867,124114,35585,2022,'CONCEICAO DA FEIRA',Conceição da Feira,'BA',2908200,1350.0,1350,112.5,112.5,1,122.0,122.0,Pequeno II
1924,1928,290830,11546,10503,325,7932,8257,2246,11177.92,10271.33,273.83,8071.92,8345.75,1925.58,134135,123256,3286,96863,100149,23107,2022,'CONCEICAO DO ALMEIDA',Conceição do Almeida,'BA',2908309,1298.0,1298,108.2,108.2,1,56.0,56.0,Pequeno I
1925,1929,290840,52066,46575,4349,32020,36369,10206,49863.33,45128.25,4184.67,31916.08,36100.75,9027.5,598360,541539,50216,382993,433209,108330,2022,'CONCEICAO DO COITE',Conceição do Coité,'BA',2908408,7195.0,7195,599.6,599.6,2,527.0,527.0,Médio
1926,1930,290850,20455,18782,709,15678,16387,2395,19110.5,17790.5,720.5,15099.5,15820.0,1970.5,229326,213486,8646,181194,189840,23646,2022,'CONCEICAO DO JACUIPE',Conceição do Jacuípe,'BA',2908507,3150.0,3150,262.5,262.5,1,57.0,57.0,Pequeno II
1927,1931,290860,18686,17505,861,14956,15817,1688,18215.67,17116.0,827.25,14649.83,15477.08,1638.92,218588,205392,9927,175798,185725,19667,2022,'CONDE',Conde,'BA',2908606,3385.0,3385,282.1,282.1,1,103.0,103.0,Pequeno II
1928,1932,290870,14226,11597,844,7679,8523,3074,13886.42,11441.33,821.25,7621.42,8442.67,2998.67,166637,137296,9855,91457,101312,35984,2022,'CONDEUBA',Condeúba,'BA',2908705,2546.0,2546,212.2,212.2,1,153.0,153.0,Pequeno I
1929,1933,290880,3698,3243,447,1990,2437,806,3654.75,3242.83,412.5,2040.42,2452.92,789.92,43857,38914,4950,24485,29435,9479,2022,'CONTENDAS DO SINCORA',Contendas do Sincorá,'BA',2908804,4353.0,4353,395.7,395.7,1,195.0,195.0,Pequeno I
1930,1934,290890,20926,19295,607,17272,17879,1416,20102.67,18722.5,518.08,16989.5,17507.58,1214.92,241232,224670,6217,203874,210091,14579,2022,'CORACAO DE MARIA',Coração de Maria,'BA',2908903,5637.0,5637,469.8,469.8,1,80.0,80.0,Pequeno II
1931,1935,290900,6692,5539,484,3328,3812,1727,6649.5,5577.67,420.42,3405.17,3825.58,1752.08,79794,66932,5045,40862,45907,21025,2022,'CORDEIROS',Cordeiros,'BA',2909000,2833.0,2833,236.1,236.1,1,62.0,62.0,Pequeno I
1932,1936,290910,12923,10757,119,9228,9347,1410,12801.5,10730.83,134.67,9182.83,9317.5,1413.33,153618,128770,1616,110194,111810,16960,2022,'CORIBE',Coribe,'BA',2909109,2788.0,12819,278.8,1281.9,1,943.0,943.0,Pequeno I
1933,1937,290920,13775,12700,230,11385,11615,1085,13730.58,12801.33,240.92,11757.83,11998.75,802.58,164767,153616,2891,141094,143985,9631,2022,'CORONEL JOAO SA',Coronel João sá,'BA',2909208,2181.0,2181,181.8,181.8,1,193.0,193.0,Pequeno I
1934,1938,290930,22279,19084,947,13842,14789,4295,21913.58,19009.08,951.67,14070.5,15022.17,3986.92,262963,228109,11420,168846,180266,47843,2022,'CORRENTINA',Correntina,'BA',2909307,956.0,956,79.7,79.7,1,59.0,59.0,Pequeno II
1935,1939,290940,10537,9404,540,7195,7735,1669,10472.42,9477.33,565.25,7439.25,8004.5,1472.83,125669,113728,6783,89271,96054,17674,2022,'COTEGIPE',Cotegipe,'BA',2909406,2953.0,2953,268.5,268.5,1,144.0,144.0,Pequeno I
1936,1940,290950,3867,3349,283,2183,2466,883,3816.58,3353.17,276.92,2263.42,2540.33,812.83,45799,40238,3323,27161,30484,9754,2022,'CRAVOLANDIA',Cravolândia,'BA',2909505,1535.0,1535,127.9,127.9,1,63.0,63.0,Pequeno I
1937,1941,290960,15930,14881,582,12395,12977,1904,15568.75,14648.17,590.83,12276.0,12866.83,1781.33,186825,175778,7090,147312,154402,21376,2022,'CRISOPOLIS',Crisópolis,'BA',2909604,1567.0,1567,130.6,130.6,1,81.0,81.0,Pequeno II
1938,1942,290970,10213,8882,424,6661,7085,1797,10013.58,8790.33,428.58,6726.67,7155.25,1635.08,120163,105484,5143,80720,85863,19621,2022,'CRISTOPOLIS',Cristópolis,'BA',2909703,1658.0,1658,138.2,138.2,1,135.0,135.0,Pequeno I
1939,1943,290980,36321,32920,2006,22499,24505,8415,34187.33,30987.83,1991.08,20735.33,22726.42,8261.42,410248,371854,23893,248824,272717,99137,2022,'CRUZ DAS ALMAS',Cruz Das Almas,'BA',2909802,603.0,603,50.2,50.2,1,35.0,35.0,Médio
1940,1944,290990,27711,25598,1105,20797,21902,3696,26964.08,25026.42,1133.92,20433.5,21567.42,3459.0,323569,300317,13607,245202,258809,41508,2022,'CURACA',Curaçá,'BA',2909901,31662.0,31662,2638.5,2638.5,2,2286.0,2286.0,Pequeno II
1941,1945,291000,9056,7901,431,6359,6790,1111,8973.75,7872.75,383.08,6440.67,6823.75,1049.0,107685,94473,4597,77288,81885,12588,2022,'DARIO MEIRA',Dário Meira,'BA',2910008,858.0,858,71.5,71.5,1,40.0,40.0,Pequeno I
1942,1946,291005,45708,42480,2268,34455,36723,5757,42801.0,40023.42,2192.92,32896.5,35089.42,4934.0,513612,480281,26315,394758,421073,59208,2022,'DIAS DAVILA',Dias D´ávila,'BA',2910057,9376.0,9376,781.3,781.3,1,448.0,448.0,Médio
1943,1947,291010,10007,8305,499,5200,5699,2606,9833.08,8328.5,527.75,5254.58,5782.33,2546.17,117997,99942,6333,63055,69388,30554,2022,'DOM BASILIO',Dom Basílio,'BA',2910107,726.0,726,60.5,60.5,1,43.0,43.0,Pequeno I
1944,1948,291020,3471,2976,96,1994,2090,886,3358.33,2889.92,92.5,1964.5,2057.0,832.92,40300,34679,1110,23574,24684,9995,2022,'DOM MACEDO COSTA',Dom Macedo Costa,'BA',2910206,1843.0,1843,153.6,153.6,1,454.0,454.0,Pequeno I
1945,1949,291030,6522,5212,425,3205,3630,1582,6412.83,5131.17,366.25,3200.0,3566.25,1564.92,76954,61574,4395,38400,42795,18779,2022,'ELISIO MEDRADO',Elísio Medrado,'BA',2910305,1444.0,1444,120.3,120.3,1,66.0,66.0,Pequeno I
1946,1950,291040,15451,13736,769,10599,11368,2368,15302.42,13725.08,724.33,10720.33,11444.67,2280.42,183629,164701,8692,128644,137336,27365,2022,'ENCRUZILHADA',Encruzilhada,'BA',2910404,4950.0,4950,412.5,412.5,3,237.0,237.0,Pequeno II
1947,1951,291050,28046,25816,2950,18664,21614,4202,25462.08,23533.5,2548.0,17188.17,19736.17,3797.33,305545,282402,30576,206258,236834,45568,2022,'ENTRE RIOS',Entre Rios,'BA',2910503,1620.0,1620,135.0,135.0,2,93.0,93.0,Pequeno II
1948,1952,291060,23720,21997,2031,16507,18538,3459,22295.75,20773.92,1728.25,15929.33,17657.58,3116.33,267549,249287,20739,191152,211891,37396,2022,'ESPLANADA',Esplanada,'BA',2910602,3834.0,3834,319.5,319.5,2,159.0,159.0,Pequeno II
1949,1953,291070,48405,43226,1141,36396,37537,5689,46826.75,41980.17,1308.25,34860.0,36168.25,5811.92,561921,503762,15699,418320,434019,69743,2022,'EUCLIDES DA CUNHA',Euclides da Cunha,'BA',2910701,10357.0,10357,863.1,863.1,2,760.0,760.0,Médio
1950,1954,291072,76330,63137,9321,34964,44285,18852,72492.0,60241.83,8878.25,32734.42,41612.67,18629.17,869904,722902,106539,392813,499352,223550,2022,'EUNAPOLIS',Eunápolis,'BA',2910727,40540.0,70590,3378.3,5882.5,3,4391.0,4391.0,Grande
1951,1955,291075,14277,13218,286,10539,10825,2393,14135.25,13161.17,277.0,10685.0,10962.0,2199.17,169623,157934,3324,128220,131544,26390,2022,'FATIMA',Fátima,'BA',2910750,1487.0,1487,123.9,123.9,1,58.0,58.0,Pequeno I
1952,1956,291077,4741,3963,172,2776,2948,1015,4659.67,3929.83,145.33,2757.5,2902.83,1027.0,55916,47158,1744,33090,34834,12324,2022,'FEIRA DA MATA',Feira da Mata,'BA',2910776,422.0,422,46.9,46.9,1,18.0,18.0,Pequeno I
1953,1957,291080,350974,308454,64050,148989,213039,95415,326389.75,288305.75,61730.08,133122.0,194852.08,93453.67,3916677,3459669,740761,1597464,2338225,1121444,2022,'FEIRA DE SANTANA',Feira de Santana,'BA',2910800,123319.0,123319,10276.6,10276.6,16,5785.0,5785.0,Grande
1954,1958,291085,15122,13102,593,10431,11024,2078,14829.75,13003.67,521.42,10598.08,11119.5,1884.17,177957,156044,6257,127177,133434,22610,2022,'FILADELFIA',Filadélfia,'BA',2910859,1998.0,1998,181.6,181.6,1,176.0,176.0,Pequeno I
1955,1959,291090,4325,3586,89,3012,3101,485,4244.92,3547.5,84.5,3002.75,3087.25,460.25,50939,42570,1014,36033,37047,5523,2022,'FIRMINO ALVES',Firmino Alves,'BA',2910909,579.0,579,52.6,52.6,1,30.0,30.0,Pequeno I
1956,1960,291100,7446,6051,244,4745,4989,1062,7405.33,6085.83,253.67,4752.0,5005.67,1080.17,88864,73030,3044,57024,60068,12962,2022,'FLORESTA AZUL',Floresta Azul,'BA',2911006,779.0,779,64.9,64.9,1,52.0,52.0,Pequeno I
1957,1961,291110,19243,17296,1259,12621,13880,3416,18889.58,17068.17,1133.75,12796.0,13929.75,3138.42,226675,204818,13605,153552,167157,37661,2022,'FORMOSA DO RIO PRETO',Formosa do Rio Preto,'BA',2911105,2140.0,2140,237.8,237.8,1,,,Pequeno II
1958,1962,291120,21045,19226,1170,15027,16197,3029,20343.17,18649.58,987.42,14693.25,15680.67,2968.92,244118,223795,11849,176319,188168,35627,2022,'GANDU',Gandu,'BA',2911204,12201.0,12201,1109.2,1109.2,1,950.0,950.0,Pequeno II
1959,1963,291125,4399,3637,138,3122,3260,377,4285.67,3578.75,117.25,3057.0,3174.25,404.5,51428,42945,1407,36684,38091,4854,2022,'GAVIAO',Gavião,'BA',2911253,504.0,504,45.8,45.8,1,43.0,43.0,Pequeno I
1960,1964,291130,9663,7829,326,5850,6176,1653,9599.08,7869.83,332.67,5808.5,6141.17,1728.67,115189,94438,3992,69702,73694,20744,2022,'GENTIO DO OURO',Gentio do Ouro,'BA',2911303,1365.0,1365,151.7,151.7,1,100.0,100.0,Pequeno I
1961,1965,291140,13849,10911,1577,6343,7920,2991,13603.17,10964.17,1393.67,6596.67,7990.33,2973.83,163238,131570,16724,79160,95884,35686,2022,'GLORIA',Glória,'BA',2911402,1155.0,1155,96.2,96.2,1,89.0,89.0,Pequeno I
1962,1966,291150,5945,5156,69,4802,4871,285,5833.25,5097.75,32.25,4809.75,4842.0,255.75,69999,61173,387,57717,58104,3069,2022,'GONGOGI',Gongogi,'BA',2911501,1005.0,1005,83.8,83.8,1,60.0,60.0,Pequeno I
1963,1967,291160,15056,13419,1541,8307,9848,3571,14724.25,13305.67,1403.5,8576.92,9980.42,3325.25,176691,159668,16842,102923,119765,39903,2022,'GOVERNADOR MANGABEIRA',Governador Mangabeira,'BA',2911600,1614.0,1614,134.5,134.5,1,79.0,79.0,Pequeno I
1964,1968,291165,6249,4900,117,3222,3339,1561,6182.25,4930.17,135.5,3321.25,3456.75,1473.42,74187,59162,1626,39855,41481,17681,2022,'GUAJERU',Guajeru,'BA',2911659,1626.0,16591,135.5,1382.6,1,747.0,747.0,Pequeno I
1965,1969,291170,61446,53944,4019,33771,37790,16154,58885.33,52081.17,3591.58,33452.75,37044.33,15036.83,706624,624974,43099,401433,444532,180442,2022,'GUANAMBI',Guanambi,'BA',2911709,7854.0,7854,654.5,654.5,2,430.0,430.0,Médio
1966,1970,291180,16994,14315,504,12303,12807,1508,16311.75,13803.92,475.42,11749.67,12225.08,1578.83,195741,165647,5705,140996,146701,18946,2022,'GUARATINGA',Guaratinga,'BA',2911808,3095.0,3095,257.9,257.9,2,76.0,76.0,Pequeno II
1967,1971,291185,9163,8443,450,6726,7176,1267,8853.17,8204.33,438.33,6481.92,6920.25,1284.08,106238,98452,5260,77783,83043,15409,2022,'HELIOPOLIS',Heliópolis,'BA',2911857,2674.0,2674,222.8,222.8,1,122.0,122.0,Pequeno I
1968,1972,291190,20192,18143,711,14334,15045,3098,19692.58,17804.58,640.42,14400.0,15040.42,2764.17,236311,213655,7685,172800,180485,33170,2022,'IACU',Iaçu,'BA',2911907,6252.0,6252,521.0,521.0,1,253.0,253.0,Pequeno II
1969,1973,291200,8143,6495,328,4079,4407,2088,8027.58,6482.5,303.75,4067.92,4371.67,2110.83,96331,77790,3645,48815,52460,25330,2022,'IBIASSUCE',Ibiassucê,'BA',2912004,10356.0,10356,863.0,863.0,1,712.0,712.0,Pequeno I
1970,1974,291210,16938,14186,685,10896,11581,2605,16479.33,13943.83,679.33,10664.0,11343.33,2600.5,197752,167326,8152,127968,136120,31206,2022,'IBICARAI',Ibicaraí,'BA',2912103,5979.0,5979,498.2,498.2,2,163.0,163.0,Pequeno II
1971,1975,291220,14076,13063,1200,8812,10012,3051,13338.17,12503.83,1005.42,8969.83,9975.25,2528.58,160058,150046,12065,107638,119703,30343,2022,'IBICOARA',Ibicoara,'BA',2912202,2786.0,2786,232.2,232.2,1,84.0,84.0,Pequeno I
1972,1976,291230,10493,9129,97,8476,8573,556,10273.83,8954.58,103.5,8270.0,8373.5,581.08,123286,107455,1242,99240,100482,6973,2022,'IBICUI',Ibicuí,'BA',2912301,6017.0,6017,668.6,668.6,1,492.0,492.0,Pequeno I
1973,1977,291240,11600,10328,236,8762,8998,1330,11276.5,10085.58,232.08,8521.42,8753.5,1332.08,135318,121027,2785,102257,105042,15985,2022,'IBIPEBA',Ibipeba,'BA',2912400,4808.0,4808,480.8,480.8,1,,,Pequeno I
1974,1978,291250,10407,8774,547,5417,5964,2810,10259.08,8753.0,585.83,5534.0,6119.83,2633.17,123109,105036,7030,66408,73438,31598,2022,'IBIPITANGA',Ibipitanga,'BA',2912509,1561.0,1561,141.9,141.9,1,240.0,240.0,Pequeno I
1975,1979,291260,3620,3194,84,2646,2730,464,3578.17,3188.67,89.08,2654.17,2743.25,445.42,42938,38264,1069,31850,32919,5345,2022,'IBIQUERA',Ibiquera,'BA',2912608,1209.0,1209,100.8,100.8,1,97.0,97.0,Pequeno I
1976,1980,291270,15036,13000,1162,9430,10592,2408,14743.83,12829.75,1012.17,9541.83,10554.0,2275.75,176926,153957,12146,114502,126648,27309,2022,'IBIRAPITANGA',Ibirapitanga,'BA',2912707,5503.0,5503,458.6,458.6,1,345.0,345.0,Pequeno II
1977,1981,291280,7468,6154,436,4093,4529,1625,7215.0,6024.25,404.42,4004.92,4409.33,1614.92,86580,72291,4853,48059,52912,19379,2022,'IBIRAPUA',Ibirapuã,'BA',2912806,1357.0,1357,150.8,150.8,1,,,Pequeno I
1978,1982,291290,16180,13622,1404,8806,10210,3412,15794.58,13452.0,1303.0,8824.5,10127.5,3324.5,189535,161424,15636,105894,121530,39894,2022,'IBIRATAIA',Ibirataia,'BA',2912905,5057.0,15216,421.4,1268.0,1,0.0,1440.0,Pequeno I
1979,1983,291300,11239,9607,489,7036,7525,2082,10956.33,9471.75,432.42,7052.25,7484.67,1987.08,131476,113661,5189,84627,89816,23845,2022,'IBITIARA',Ibitiara,'BA',2913002,3837.0,3837,319.8,319.8,2,147.0,147.0,Pequeno I
1980,1984,291310,14767,13199,378,11147,11525,1674,14409.75,12943.5,412.33,10890.42,11302.75,1640.75,172917,155322,4948,130685,135633,19689,2022,'IBITITA',Ibititá,'BA',2913101,698.0,698,58.2,58.2,1,53.0,53.0,Pequeno I
1981,1985,291320,19171,16133,3259,8643,11902,4231,18687.5,15888.75,3010.0,8730.67,11740.67,4148.08,224250,190665,36120,104768,140888,49777,2022,'IBOTIRAMA',Ibotirama,'BA',2913200,1085.0,1085,90.4,90.4,1,56.0,56.0,Pequeno II
1982,1986,291330,5146,4446,185,3269,3454,992,5058.83,4438.33,183.58,3324.17,3507.75,930.58,60706,53260,2203,39890,42093,11167,2022,'ICHU',Ichu,'BA',2913309,2021.0,2021,183.7,183.7,1,10.0,10.0,Pequeno I
1983,1987,291340,11724,10006,421,6714,7135,2871,11571.33,9980.42,429.67,6931.83,7361.5,2618.92,138856,119765,5156,83182,88338,31427,2022,'IGAPORA',Igaporã,'BA',2913408,649.0,24196,54.1,2016.3,1,0.0,2644.0,Pequeno I
1984,1988,291345,9021,8422,543,6697,7240,1182,8885.33,8362.83,449.08,6851.83,7300.92,1061.92,106624,100354,5389,82222,87611,12743,2022,'IGRAPIUNA',Igrapiúna,'BA',2913457,1535.0,1535,127.9,127.9,1,62.0,62.0,Pequeno I
1985,1989,291350,18295,15981,472,13248,13720,2261,17933.5,15758.33,327.0,13554.58,13881.58,1876.75,215202,189100,3924,162655,166579,22521,2022,'IGUAI',Iguaí,'BA',2913507,12606.0,22015,1050.5,1834.6,2,2150.0,2150.0,Pequeno II
1986,1990,291360,104519,92012,10797,61734,72531,19481,97627.67,86424.75,9275.25,59332.75,68608.0,17816.75,1171532,1037097,111303,711993,823296,213801,2022,'ILHEUS',Ilhéus,'BA',2913606,51928.0,51928,4327.3,4327.3,6,3688.0,3688.0,Grande
1987,1991,291370,23988,22122,1869,15898,17767,4355,23431.67,21743.0,1707.08,15980.25,17687.33,4055.67,281180,260916,20485,191763,212248,48668,2022,'INHAMBUPE',Inhambupe,'BA',2913705,3796.0,3796,345.1,345.1,1,205.0,205.0,Pequeno II
1988,1992,291380,11428,10614,313,9263,9576,1038,10767.75,10058.67,375.67,8662.33,9038.0,1020.67,129213,120704,4508,103948,108456,12248,2022,'IPECAETA',Ipecaetá,'BA',2913804,1387.0,1387,115.6,115.6,1,109.0,109.0,Pequeno I
1989,1993,291390,30814,26619,1136,22318,23454,3165,29686.67,25807.33,1048.0,21638.83,22686.83,3120.5,356240,309688,12576,259666,272242,37446,2022,'IPIAU',Ipiaú,'BA',2913903,5892.0,5892,841.7,841.7,2,784.0,784.0,Pequeno II
1990,1994,291400,41576,36731,3308,25764,29072,7659,39872.33,35605.08,3219.67,25232.5,28452.17,7152.92,478468,427261,38636,302790,341426,85835,2022,'IPIRA',Ipirá,'BA',2914000,7991.0,7991,665.9,665.9,2,412.0,412.0,Médio
1991,1995,291410,8417,7073,199,5081,5280,1793,8302.5,7056.92,190.67,5154.25,5344.92,1712.0,99630,84683,2288,61851,64139,20544,2022,'IPUPIARA',Ipupiara,'BA',2914109,491.0,491,40.9,40.9,1,28.0,28.0,Pequeno I
1992,1996,291420,4914,4276,70,3704,3774,502,4870.25,4269.42,92.67,3740.92,3833.58,435.83,58443,51233,1112,44891,46003,5230,2022,'IRAJUBA',Irajuba,'BA',2914208,1691.0,1691,140.9,140.9,1,125.0,125.0,Pequeno I
1993,1997,291430,7832,7012,338,5350,5688,1324,7801.67,7072.08,364.75,5411.17,5775.92,1296.17,93620,84865,4377,64934,69311,15554,2022,'IRAMAIA',Iramaia,'BA',2914307,1678.0,1678,152.5,152.5,1,98.0,98.0,Pequeno I
1994,1998,291440,19889,18059,1336,13344,14680,3379,19392.83,17745.08,1207.92,13468.67,14676.58,3068.5,232714,212941,14495,161624,176119,36822,2022,'IRAQUARA',Iraquara,'BA',2914406,7671.0,7671,639.2,639.2,1,266.0,266.0,Pequeno II
1995,1999,291450,25015,22349,444,20210,20654,1695,24557.5,22132.92,354.25,20122.92,20477.17,1655.75,294690,265595,4251,241475,245726,19869,2022,'IRARA',Irará,'BA',2914505,1708.0,1708,155.3,155.3,1,,,Pequeno II
1996,2000,291460,48379,44299,3732,31891,35623,8676,45533.08,42008.25,2689.83,31426.0,34115.83,7892.42,546397,504099,32278,377112,409390,94709,2022,'IRECE',Irecê,'BA',2914604,1698.0,1698,141.5,141.5,1,45.0,45.0,Médio
1997,2001,291465,23315,20709,902,17201,18103,2606,23135.08,20669.83,804.83,17499.75,18304.58,2365.25,277621,248038,9658,209997,219655,28383,2022,'ITABELA',Itabela,'BA',2914653,1059.0,1059,264.8,264.8,2,90.0,90.0,Pequeno II
1998,2002,291470,46608,42323,2082,33573,35655,6668,44104.17,40225.25,2104.67,31643.67,33748.33,6476.92,529250,482703,25256,379724,404980,77723,2022,'ITABERABA',Itaberaba,'BA',2914703,5020.0,5020,418.3,418.3,3,195.0,195.0,Médio
1999,2003,291480,114337,95983,10822,55755,66577,29406,108788.42,92166.17,9286.08,55349.33,64635.42,27530.75,1305461,1105994,111433,664192,775625,330369,2022,'ITABUNA',Itabuna,'BA',2914802,24671.0,24671,2055.9,2055.9,4,1748.0,1748.0,Grande
2000,2004,291490,17553,16453,568,14817,15385,1068,16199.33,15213.67,464.75,13822.17,14286.92,926.75,194392,182564,5577,165866,171443,11121,2022,'ITACARE',Itacaré,'BA',2914901,3697.0,3697,336.1,336.1,1,31.0,31.0,Pequeno II
2001,2005,291500,12982,11649,418,10561,10979,670,12797.58,11546.08,296.75,10593.17,10889.92,656.17,153571,138553,3561,127118,130679,7874,2022,'ITAETE',Itaeté,'BA',2915007,2311.0,2311,210.1,210.1,1,34.0,34.0,Pequeno I
2002,2006,291510,11421,9667,215,8332,8547,1120,11224.92,9577.42,235.67,8168.58,8404.25,1173.17,134699,114929,2828,98023,100851,14078,2022,'ITAGI',Itagi,'BA',2915106,677.0,677,56.4,56.4,1,82.0,82.0,Pequeno I
2003,2007,291520,11289,9627,633,7632,8265,1362,10941.5,9368.67,676.25,7281.5,7957.75,1410.92,131298,112424,8115,87378,95493,16931,2022,'ITAGIBA',Itagibá,'BA',2915205,6677.0,11747,556.4,978.9,1,0.0,1951.0,Pequeno I
2004,2008,291530,5812,4804,518,3296,3814,990,5681.17,4746.83,470.33,3329.33,3799.67,947.17,68174,56962,5644,39952,45596,11366,2022,'ITAGIMIRIM',Itagimirim,'BA',2915304,771.0,771,154.2,154.2,1,,,Pequeno I
2005,2009,291535,11334,10030,474,8001,8475,1555,10909.17,9793.33,484.08,7836.92,8321.0,1472.33,130910,117520,5809,94043,99852,17668,2022,'ITAGUACU DA BAHIA',Itaguaçu da Bahia,'BA',2915353,7783.0,7783,648.6,648.6,1,170.0,170.0,Pequeno I
2006,2010,291540,5153,4203,140,3562,3702,501,5099.75,4201.5,162.67,3522.08,3684.75,516.75,61197,50418,1952,42265,44217,6201,2022,'ITAJU DO COLONIA',Itaju do Colônia,'BA',2915403,9884.0,10911,823.7,909.2,1,901.0,901.0,Pequeno I
2007,2011,291550,15137,12980,924,9492,10416,2564,14543.33,12537.67,960.75,9007.5,9968.25,2569.42,174520,150452,11529,108090,119619,30833,2022,'ITAJUIPE',Itajuípe,'BA',2915502,8396.0,14357,699.7,1196.4,1,177.0,177.0,Pequeno II
2008,2012,291560,47956,40563,8489,19890,28379,12184,46162.92,39189.25,6309.42,21859.42,28168.83,11020.42,553955,470271,75713,262313,338026,132245,2022,'ITAMARAJU',Itamaraju,'BA',2915601,14123.0,14123,1176.9,1176.9,2,884.0,884.0,Médio
2009,2013,291570,5816,5043,170,4434,4604,439,5724.25,4998.25,207.75,4319.67,4527.42,470.83,68691,59979,2493,51836,54329,5650,2022,'ITAMARI',Itamari,'BA',2915700,5786.0,10883,526.0,989.4,1,,,Pequeno I
2010,2014,291580,17415,15245,916,11235,12151,3094,17263.58,15214.67,917.08,11208.5,12125.58,3089.08,207163,182576,11005,134502,145507,37069,2022,'ITAMBE',Itambé,'BA',2915809,10396.0,10396,866.3,866.3,3,603.0,603.0,Pequeno II
2011,2015,291590,6311,5864,188,5233,5421,443,5924.5,5540.58,205.42,4914.08,5119.5,421.08,71094,66487,2465,58969,61434,5053,2022,'ITANAGRA',Itanagra,'BA',2915908,3103.0,3103,258.6,258.6,1,149.0,149.0,Pequeno I
2012,2016,291600,13950,11616,1191,7591,8782,2834,13554.67,11405.75,1088.5,7579.08,8667.58,2738.17,162656,136869,13062,90949,104011,32858,2022,'ITANHEM',Itanhém,'BA',2916005,11800.0,11800,983.3,983.3,1,755.0,755.0,Pequeno II
2013,2017,291610,16750,15670,993,12851,13844,1826,16020.0,15132.0,633.83,13073.58,13707.42,1424.58,192240,181584,7606,156883,164489,17095,2022,'ITAPARICA',Itaparica,'BA',2916104,1438.0,1438,119.8,119.8,1,180.0,180.0,Pequeno II
2014,2018,291620,7217,6234,400,4742,5142,1092,7190.25,6271.83,397.5,4883.17,5280.67,991.17,86283,75262,4770,58598,63368,11894,2022,'ITAPE',Itapé,'BA',2916203,1518.0,1518,138.0,138.0,1,229.0,229.0,Pequeno I
2015,2019,291630,8004,6763,842,5019,5861,902,7859.92,6676.67,607.5,5170.0,5777.5,899.17,94319,80120,7290,62040,69330,10790,2022,'ITAPEBI',Itapebi,'BA',2916302,3538.0,3538,393.1,393.1,1,634.0,634.0,Pequeno I
2016,2020,291640,45800,38913,3553,23414,26967,11946,43896.67,37501.67,3815.83,21559.17,25375.0,12126.67,526760,450020,45790,258710,304500,145520,2022,'ITAPETINGA',Itapetinga,'BA',2916401,13562.0,13562,1130.2,1130.2,5,1995.0,1995.0,Médio
2017,2021,291650,25520,23801,1307,20108,21415,2386,24370.08,22837.67,1229.75,19445.5,20675.25,2162.42,292441,274052,14757,233346,248103,25949,2022,'ITAPICURU',Itapicuru,'BA',2916500,6380.0,6380,531.7,531.7,1,418.0,418.0,Pequeno II
2018,2022,291660,5296,4326,355,2761,3116,1210,5194.5,4282.25,389.58,2699.58,3089.17,1193.08,62334,51387,4675,32395,37070,14317,2022,'ITAPITANGA',Itapitanga,'BA',2916609,2067.0,2067,172.2,172.2,1,107.0,107.0,Pequeno I
2019,2023,291670,5758,5117,458,3558,4016,1101,5621.67,5044.25,428.75,3608.83,4037.58,1006.67,67460,60531,5145,43306,48451,12080,2022,'ITAQUARA',Itaquara,'BA',2916708,5421.0,5421,451.8,451.8,1,410.0,410.0,Pequeno I
2020,2024,291680,10826,9517,1293,5947,7240,2277,10546.75,9314.0,1051.58,6140.75,7192.33,2121.67,126561,111768,12619,73689,86308,25460,2022,'ITARANTIM',Itarantim,'BA',2916807,1188.0,1188,132.0,132.0,1,123.0,123.0,Pequeno I
2021,2025,291685,12667,11030,392,8505,8897,2133,12343.58,10854.5,409.33,8500.25,8909.58,1944.92,148123,130254,4912,102003,106915,23339,2022,'ITATIM',Itatim,'BA',2916856,2924.0,2924,243.7,243.7,1,151.0,151.0,Pequeno I
2022,2026,291690,9882,7791,295,6630,6925,866,9564.75,7549.75,427.17,6126.17,6553.33,996.42,114777,90597,5126,73514,78640,11957,2022,'ITIRUCU',Itiruçu,'BA',2916906,5931.0,5931,494.2,494.2,1,441.0,441.0,Pequeno I
2023,2027,291700,27551,25289,1043,21051,22094,3195,26790.75,24721.75,1089.67,20411.67,21501.33,3220.42,321489,296661,13076,244940,258016,38645,2022,'ITIUBA',Itiúba,'BA',2917003,3077.0,3077,256.4,256.4,2,137.0,137.0,Pequeno II
2024,2028,291710,13549,11377,786,8288,9074,2303,13257.67,11242.92,795.42,8195.42,8990.83,2252.08,159092,134915,9545,98345,107890,27025,2022,'ITORORO',Itororó,'BA',2917102,1189.0,1189,99.1,99.1,1,19.0,19.0,Pequeno I
2025,2029,291720,14374,12557,2609,6470,9079,3478,13982.33,12325.58,2515.75,6538.83,9054.58,3271.0,167788,147907,30189,78466,108655,39252,2022,'ITUACU',Ituaçu,'BA',2917201,1156.0,1156,96.3,96.3,1,81.0,81.0,Pequeno I
2026,2030,291730,18404,16688,816,14059,14875,1813,17455.67,15970.5,819.08,13410.92,14230.0,1740.5,209468,191646,9829,160931,170760,20886,2022,'ITUBERA',Ituberá,'BA',2917300,1935.0,1935,161.2,161.2,1,122.0,122.0,Pequeno II
2027,2031,291733,8018,7152,229,5478,5707,1445,7768.92,7044.83,247.08,5456.0,5703.08,1341.75,93227,84538,2965,65472,68437,16101,2022,'IUIU',Iuiú,'BA',2917334,2260.0,2260,188.3,188.3,1,184.0,184.0,Pequeno I
2028,2032,291735,8004,6658,208,4681,4889,1769,7985.83,6779.67,189.08,4950.42,5139.5,1640.17,95830,81356,2269,59405,61674,19682,2022,'JABORANDI',Jaborandi,'BA',2917359,5706.0,6814,475.5,567.8,1,460.0,460.0,Pequeno I
2029,2033,291740,11082,8404,255,5850,6105,2299,10849.92,8467.17,258.83,5839.75,6098.58,2368.58,130199,101606,3106,70077,73183,28423,2022,'JACARACI',Jacaraci,'BA',2917409,3157.0,3157,263.1,263.1,1,245.0,245.0,Pequeno I
2030,2034,291750,56010,49168,5834,32770,38604,10564,53285.42,47038.67,5403.58,31397.17,36800.75,10237.92,639425,564464,64843,376766,441609,122855,2022,'JACOBINA',Jacobina,'BA',2917508,19396.0,22517,1616.3,1876.4,4,1263.0,1263.0,Médio
2031,2035,291760,34497,29859,10588,7329,17917,11942,33180.08,29010.33,9965.33,8018.75,17984.08,11026.25,398161,348124,119584,96225,215809,132315,2022,'JAGUAQUARA',Jaguaquara,'BA',2917607,4671.0,4671,389.2,389.2,2,426.0,426.0,Médio
2032,2036,291770,21791,19050,1178,13817,14995,4055,21132.67,18711.0,1111.5,13737.83,14849.33,3861.67,253592,224532,13338,164854,178192,46340,2022,'JAGUARARI',Jaguarari,'BA',2917706,12488.0,16982,1040.7,1415.2,2,1762.0,1762.0,Pequeno II
2033,2037,291780,14596,13714,447,11573,12020,1694,14275.25,13470.5,390.92,11503.58,11894.5,1576.0,171303,161646,4691,138043,142734,18912,2022,'JAGUARIPE',Jaguaripe,'BA',2917805,3791.0,3791,315.9,315.9,1,172.0,172.0,Pequeno I
2034,2038,291790,8199,7791,604,6059,6663,1128,8023.5,7645.75,586.83,6031.5,6618.33,1027.42,96282,91749,7042,72378,79420,12329,2022,'JANDAIRA',Jandaíra,'BA',2917904,7787.0,7787,648.9,648.9,1,540.0,540.0,Pequeno I
2035,2039,291800,92631,80350,10273,48347,58620,21730,87446.58,75863.75,10225.83,44172.42,54398.25,21465.5,1049359,910365,122710,530069,652779,257586,2022,'JEQUIE',Jequié,'BA',2918001,39172.0,39172,3264.3,3264.3,6,3016.0,3016.0,Grande
2036,2040,291810,27493,25115,885,21099,21984,3131,26551.08,24322.75,941.0,20452.42,21393.42,2929.33,318613,291873,11292,245429,256721,35152,2022,'JEREMOABO',Jeremoabo,'BA',2918100,3157.0,3157,263.1,263.1,1,123.0,123.0,Pequeno II
2037,2041,291820,11042,10177,367,8208,8575,1602,10716.58,9956.75,346.5,8039.33,8385.83,1570.92,128599,119481,4158,96472,100630,18851,2022,'JIQUIRICA',Jiquiriçá,'BA',2918209,3702.0,10598,308.5,883.2,1,177.0,177.0,Pequeno I
2038,2042,291830,11472,10057,518,7949,8467,1590,11154.25,9840.83,421.75,7882.5,8304.25,1536.58,133851,118090,5061,94590,99651,18439,2022,'JITAUNA',Jitaúna,'BA',2918308,1160.0,1160,96.7,96.7,1,40.0,40.0,Pequeno I
2039,2043,291835,21101,18175,2040,11842,13882,4293,20645.42,17952.92,1811.75,12108.5,13920.25,4032.67,247745,215435,21741,145302,167043,48392,2022,'JOAO DOURADO',João Dourado,'BA',2918357,24252.0,28591,2021.0,2382.6,2,3067.0,3067.0,Pequeno II
2040,2044,291840,150691,138044,15489,96481,111970,26074,141639.67,130779.58,13369.08,94149.92,107519.0,23260.58,1699676,1569355,160429,1129799,1290228,279127,2022,'JUAZEIRO',Juazeiro,'BA',2918407,34769.0,34769,2897.4,2897.4,5,3388.0,3388.0,Grande
2041,2045,291845,8126,7261,421,6039,6460,801,7683.25,6911.58,336.0,5894.58,6230.58,681.0,92199,82939,4032,70735,74767,8172,2022,'JUCURUCU',Jucuruçu,'BA',2918456,1257.0,1257,104.8,104.8,1,79.0,79.0,Pequeno I
2042,2046,291850,12912,11565,346,9834,10180,1385,12498.67,11226.42,340.08,9476.5,9816.58,1409.83,149984,134717,4081,113718,117799,16918,2022,'JUSSARA',Jussara,'BA',2918506,492.0,492,49.2,49.2,1,,,Pequeno I
2043,2047,291855,4739,4124,74,3855,3929,195,4610.92,4019.58,58.5,3749.67,3808.17,211.42,55331,48235,702,44996,45698,2537,2022,'JUSSARI',Jussari,'BA',2918555,1271.0,1271,105.9,105.9,1,74.0,74.0,Pequeno I
2044,2048,291860,6222,4668,119,3056,3175,1493,6143.5,4669.17,116.5,3021.25,3137.75,1531.42,73722,56030,1398,36255,37653,18377,2022,'JUSSIAPE',Jussiape,'BA',2918605,4434.0,4434,369.5,369.5,1,84.0,84.0,Pequeno I
2045,2049,291870,3496,2615,164,1685,1849,766,3409.42,2603.83,123.33,1774.0,1897.33,706.5,40913,31246,1480,21288,22768,8478,2022,'LAFAIETE COUTINHO',Lafaiete Coutinho,'BA',2918704,2661.0,2661,221.8,221.8,1,304.0,304.0,Pequeno I
2046,2050,291875,9510,8440,275,5988,6263,2177,9380.75,8409.25,297.92,6000.42,6298.33,2110.92,112569,100911,3575,72005,75580,25331,2022,'LAGOA REAL',Lagoa Real,'BA',2918753,2888.0,2888,240.7,240.7,1,55.0,55.0,Pequeno I
2047,2051,291880,16364,14601,826,11151,11977,2624,16186.33,14678.5,764.25,11211.25,11975.5,2703.0,194236,176142,9171,134535,143706,32436,2022,'LAJE',Laje,'BA',2918803,2487.0,2487,207.2,207.2,1,121.0,121.0,Pequeno II
2048,2052,291890,3837,3012,426,1882,2308,704,3682.58,2920.08,426.92,1788.75,2215.67,704.42,44191,35041,5123,21465,26588,8453,2022,'LAJEDAO',Lajedão,'BA',2918902,1123.0,1123,93.6,93.6,1,60.0,60.0,Pequeno I
2049,2053,291900,3409,2843,88,2177,2265,578,3340.0,2808.25,89.92,2159.67,2249.58,558.67,40080,33699,1079,25916,26995,6704,2022,'LAJEDINHO',Lajedinho,'BA',2919009,3221.0,3221,268.4,268.4,1,255.0,255.0,Pequeno I
2050,2054,291905,6460,5616,330,4058,4388,1228,6433.75,5687.33,330.08,4191.67,4521.75,1165.58,77205,68248,3961,50300,54261,13987,2022,'LAJEDO DO TABOCAL',Lajedo do Tabocal,'BA',2919058,1925.0,20290,160.4,1690.8,1,0.0,1595.0,Pequeno I
2051,2055,291910,8399,7656,173,6782,6955,701,8249.92,7577.67,174.92,6788.17,6963.08,614.58,98999,90932,2099,81458,83557,7375,2022,'LAMARAO',Lamarão,'BA',2919108,698.0,698,58.2,58.2,1,45.0,45.0,Pequeno I
2052,2056,291915,22388,19456,706,14593,15299,4157,21882.42,19234.67,726.83,14546.5,15273.33,3961.33,262589,230816,8722,174558,183280,47536,2022,'LAPAO',Lapão,'BA',2919157,841.0,841,84.1,84.1,1,64.0,64.0,Pequeno II
2053,2057,291920,93639,86636,5465,66721,72186,14450,84096.25,77807.83,5445.83,59185.0,64630.83,13177.0,1009155,933694,65350,710220,775570,158124,2022,'LAURO DE FREITAS',Lauro de Freitas,'BA',2919207,17234.0,17234,1436.2,1436.2,6,1251.0,1251.0,Grande
2054,2058,291930,7471,6740,662,4953,5615,1125,7085.0,6475.92,605.67,4816.0,5421.67,1054.25,85020,77711,7268,57792,65060,12651,2022,'LENCOIS',Lençóis,'BA',2919306,1081.0,1081,135.1,135.1,1,,,Pequeno I
2055,2059,291940,10355,7945,677,4714,5391,2554,10273.67,7976.67,655.83,4744.0,5399.83,2576.83,123284,95720,7870,56928,64798,30922,2022,'LICINIO DE ALMEIDA',Licínio de Almeida,'BA',2919405,781.0,781,65.1,65.1,1,64.0,64.0,Pequeno I
2056,2060,291950,30643,27240,1583,18017,19600,7640,29820.17,26666.17,1454.08,17993.25,19447.33,7218.83,357842,319994,17449,215919,233368,86626,2022,'LIVRAMENTO DE NOSSA SENHOR,Livramento de Nossa Senhora,'BA',2919504,1979.0,1979,164.9,164.9,2,219.0,219.0,Pequeno II
2057,2061,291955,52848,49480,3494,39039,42533,6947,47061.17,44310.75,3103.17,35936.08,39039.25,5271.5,564734,531729,37238,431233,468471,63258,2022,'LUIS EDUARDO MAGALHAES',Luís Eduardo Magalhães,'BA',2919553,0.0,52838,0.0,4403.2,1,0.0,3137.0,Médio
2058,2062,291960,9386,8425,486,6928,7414,1011,9066.67,8207.67,447.67,6740.5,7188.17,1019.5,108800,98492,5372,80886,86258,12234,2022,'MACAJUBA',Macajuba,'BA',2919603,1713.0,1713,142.8,142.8,1,84.0,84.0,Pequeno I
2059,2063,291970,12625,11477,478,9111,9589,1888,12241.92,11178.75,467.92,8789.67,9257.58,1921.17,146903,134145,5615,105476,111091,23054,2022,'MACARANI',Macarani,'BA',2919702,3338.0,3338,333.8,333.8,1,,,Pequeno I
2060,2064,291980,30868,27025,2350,18309,20659,6366,29981.0,26356.67,2271.0,18157.67,20428.67,5928.0,359772,316280,27252,217892,245144,71136,2022,'MACAUBAS',Macaúbas,'BA',2919801,3191.0,3191,265.9,265.9,1,131.0,131.0,Pequeno II
2061,2065,291990,6220,5665,113,5156,5269,396,6193.42,5643.67,101.42,5176.08,5277.5,366.17,74321,67724,1217,62113,63330,4394,2022,'MACURURE',Macururé,'BA',2919900,776.0,776,70.5,70.5,1,35.0,35.0,Pequeno I
2062,2066,291992,11572,10450,480,8459,8939,1511,10779.58,9767.25,545.33,7919.58,8464.92,1302.33,129355,117207,6544,95035,101579,15628,2022,'MADRE DE DEUS',Madre de Deus,'BA',2919926,2730.0,2730,227.5,227.5,1,118.0,118.0,Pequeno I
2063,2067,291995,6261,5518,253,4404,4657,861,6158.92,5462.08,269.83,4274.5,4544.33,917.75,73907,65545,3238,51294,54532,11013,2022,'MAETINGA',Maetinga,'BA',2919959,1129.0,1129,94.1,94.1,1,104.0,104.0,Pequeno I
2064,2068,292000,6714,6019,230,4976,5206,813,6534.67,5887.08,221.42,4839.58,5061.0,826.08,78416,70645,2657,58075,60732,9913,2022,'MAIQUINIQUE',Maiquinique,'BA',2920007,1210.0,1210,134.4,134.4,1,81.0,81.0,Pequeno I
2065,2069,292010,14248,12360,367,10243,10610,1750,14033.42,12272.75,356.67,10175.0,10531.67,1741.08,168401,147273,4280,122100,126380,20893,2022,'MAIRI',Mairi,'BA',2920106,4694.0,4694,391.2,391.2,1,302.0,302.0,Pequeno I
2066,2070,292020,13998,12514,527,9870,10397,2117,13835.08,12433.5,578.17,9720.5,10298.67,2134.83,166021,149202,6938,116646,123584,25618,2022,'MALHADA',Malhada,'BA',2920205,1955.0,1955,162.9,162.9,1,347.0,347.0,Pequeno I
2067,2071,292030,6556,5945,426,3826,4252,1693,6354.67,5829.67,421.92,3727.08,4149.0,1680.67,76256,69956,5063,44725,49788,20168,2022,'MALHADA DE PEDRAS',Malhada de Pedras,'BA',2920304,4783.0,4783,398.6,398.6,1,392.0,392.0,Pequeno I
2068,2072,292040,12244,10582,416,8660,9076,1506,12017.33,10434.83,451.17,8442.5,8893.67,1541.17,144208,125218,5414,101310,106724,18494,2022,'MANOEL VITORINO',Manoel Vitorino,'BA',2920403,1938.0,4008,161.5,334.0,1,0.0,2070.0,Pequeno I
2069,2073,292045,11083,9435,72,8816,8888,547,10952.92,9348.58,84.67,8669.67,8754.33,594.25,131435,112183,1016,104036,105052,7131,2022,'MANSIDAO',Mansidão,'BA',2920452,6185.0,6185,562.3,562.3,1,545.0,545.0,Pequeno I
2070,2074,292050,19268,16676,870,11075,11945,4731,18988.83,16625.5,946.67,10962.67,11909.33,4716.17,227866,199506,11360,131552,142912,56594,2022,'MARACAS',Maracás,'BA',2920502,2966.0,2966,247.2,247.2,1,166.0,166.0,Pequeno II
2071,2075,292060,30776,29291,894,25662,26556,2735,29013.75,27732.92,798.33,24461.58,25259.92,2473.0,348165,332795,9580,293539,303119,29676,2022,'MARAGOGIPE',Maragogipe,'BA',2920601,1262.0,1262,114.7,114.7,1,108.0,108.0,Pequeno II
2072,2076,292070,17154,15935,1061,13419,14480,1455,16066.67,15006.0,899.25,12815.5,13714.75,1291.25,192800,180072,10791,153786,164577,15495,2022,'MARAU',Maraú,'BA',2920700,14777.0,14777,1231.4,1231.4,5,855.0,855.0,Pequeno I
2073,2077,292080,8785,7800,146,7125,7271,529,8539.92,7647.17,139.42,7012.58,7152.0,495.17,102479,91766,1673,84151,85824,5942,2022,'MARCIONILIO SOUZA',Marcionílio Souza,'BA',2920809,2211.0,2211,201.0,201.0,1,151.0,151.0,Pequeno I
2074,2078,292090,10185,8326,533,6525,7058,1268,10194.75,8416.0,497.92,6631.42,7129.33,1286.67,122337,100992,5975,79577,85552,15440,2022,'MASCOTE',Mascote,'BA',2920908,1319.0,1319,119.9,119.9,1,30.0,30.0,Pequeno I
2075,2079,292100,34074,31150,4638,19204,23842,7308,32575.5,29928.67,4482.08,18667.83,23149.92,6778.75,390906,359144,53785,224014,277799,81345,2022,'MATA DE SAO JOAO',Mata de São João,'BA',2921005,1433.0,29921,119.4,2493.4,1,0.0,4560.0,Pequeno II
2076,2080,292105,9247,8511,160,7095,7255,1256,9212.33,8513.58,178.83,7139.75,7318.58,1195.0,110548,102163,2146,85677,87823,14340,2022,'MATINA',Matina,'BA',2921054,2156.0,2156,215.6,215.6,1,131.0,131.0,Pequeno I
2077,2081,292110,16468,13318,1731,8540,10271,3047,15765.08,12840.42,1817.33,7948.25,9765.58,3074.83,189181,154085,21808,95379,117187,36898,2022,'MEDEIROS NETO',Medeiros Neto,'BA',2921104,3418.0,3418,284.8,284.8,1,144.0,144.0,Pequeno II
2078,2082,292120,19584,16983,1534,11762,13296,3687,19160.33,16761.75,1335.42,11889.08,13224.5,3537.25,229924,201141,16025,142669,158694,42447,2022,'MIGUEL CALMON',Miguel Calmon,'BA',2921203,3541.0,3541,295.1,295.1,2,356.0,356.0,Pequeno II
2079,2083,292130,8736,7742,520,5619,6139,1603,8638.42,7761.42,503.08,5803.42,6306.5,1454.92,103661,93137,6037,69641,75678,17459,2022,'MILAGRES',Milagres,'BA',2921302,4568.0,5690,380.7,474.2,1,614.0,614.0,Pequeno I
2080,2084,292140,13757,12234,384,10661,11045,1189,13328.08,11952.42,376.0,10406.83,10782.83,1169.58,159937,143429,4512,124882,129394,14035,2022,'MIRANGABA',Mirangaba,'BA',2921401,4290.0,4290,357.5,357.5,2,283.0,283.0,Pequeno I
2081,2085,292145,7605,6732,279,5207,5486,1246,7420.83,6621.67,265.0,5201.75,5466.75,1154.92,89050,79460,3180,62421,65601,13859,2022,'MIRANTE',Mirante,'BA',2921450,784.0,784,65.3,65.3,1,42.0,42.0,Pequeno I
2082,2086,292150,42799,38529,1023,32089,33112,5417,41891.58,38028.67,1209.92,31407.0,32616.92,5411.75,502699,456344,14519,376884,391403,64941,2022,'MONTE SANTO',Monte Santo,'BA',2921500,2247.0,2247,187.2,187.2,3,137.0,137.0,Médio
2083,2087,292160,7524,6455,105,5327,5432,1023,7495.5,6475.5,111.83,5391.58,5503.42,972.08,89946,77706,1342,64699,66041,11665,2022,'MORPARA',Morpará,'BA',2921609,2953.0,2953,246.1,246.1,1,75.0,75.0,Pequeno I
2084,2088,292170,25428,22425,1518,16392,17910,4515,24738.75,22098.92,1377.5,16518.83,17896.33,4202.58,296865,265187,16530,198226,214756,50431,2022,'MORRO DO CHAPEU',Morro do Chapéu,'BA',2921708,12067.0,14810,1005.6,1234.2,2,481.0,481.0,Pequeno II
2085,2089,292180,8688,7063,547,4268,4815,2248,8480.17,6939.08,520.75,4249.17,4769.92,2169.17,101762,83269,6249,50990,57239,26030,2022,'MORTUGABA',Mortugaba,'BA',2921807,1518.0,1518,138.0,138.0,1,73.0,73.0,Pequeno I
2086,2090,292190,8412,7561,719,5248,5967,1594,8165.25,7396.17,712.17,5213.08,5925.25,1470.92,97983,88754,8546,62557,71103,17651,2022,'MUCUGE',Mucugê,'BA',2921906,1059.0,1059,88.2,88.2,1,97.0,97.0,Pequeno I
2087,2091,292200,25481,21424,4552,10462,15014,6410,24306.5,20656.33,4017.08,10605.67,14622.75,6033.58,291678,247876,48205,127268,175473,72403,2022,'MUCURI',Mucuri,'BA',2922003,6389.0,6389,532.4,532.4,1,268.0,268.0,Pequeno II
2088,2092,292205,11252,10261,310,8828,9138,1123,11047.83,10166.17,319.92,8737.58,9057.5,1108.67,132574,121994,3839,104851,108690,13304,2022,'MULUNGU DO MORRO',Mulungu do Morro,'BA',2922052,1716.0,1716,143.0,143.0,1,250.0,250.0,Pequeno I
2089,2093,292210,15831,14096,285,12873,13158,938,15670.83,13981.0,297.92,12722.92,13020.83,960.17,188050,167772,3575,152675,156250,11522,2022,'MUNDO NOVO',Mundo Novo,'BA',2922102,16525.0,16525,1377.1,1377.1,1,1332.0,1332.0,Pequeno II
2090,2094,292220,5579,4951,377,3497,3874,1077,5461.58,4924.67,246.67,3670.0,3916.67,1008.0,65539,59096,2960,44040,47000,12096,2022,'MUNIZ FERREIRA',Muniz Ferreira,'BA',2922201,5088.0,6231,424.0,519.2,1,370.0,370.0,Pequeno I
2091,2095,292225,9822,9069,272,7690,7962,1107,9752.42,9075.42,277.67,7806.58,8084.25,991.17,117029,108905,3332,93679,97011,11894,2022,'MUQUEM DE SAO FRANCISCO',Muquém de São Francisco,'BA',2922250,6414.0,6414,641.4,641.4,1,599.0,599.0,Pequeno I
2092,2096,292230,22469,20708,826,16966,17792,2916,21981.17,20522.42,719.33,17161.25,17880.58,2641.83,263774,246269,8632,205935,214567,31702,2022,'MURITIBA',Muritiba,'BA',2922300,2520.0,2520,210.0,210.0,2,207.0,207.0,Pequeno II
2093,2097,292240,15450,13784,787,9810,10597,3187,14851.33,13497.17,786.58,9698.83,10485.42,3011.75,178216,161966,9439,116386,125825,36141,2022,'MUTUIPE',Mutuípe,'BA',2922409,9489.0,9489,790.8,790.8,3,264.0,264.0,Pequeno II
2094,2098,292250,16878,15638,795,12214,13009,2629,16211.0,15145.25,765.75,11883.75,12649.5,2495.75,194532,181743,9189,142605,151794,29949,2022,'NAZARE',Nazaré,'BA',2922508,983.0,983,109.2,109.2,1,87.0,87.0,Pequeno II
2095,2099,292260,9521,8895,186,7846,8032,863,9184.58,8630.08,217.0,7560.33,7777.33,852.75,110215,103561,2604,90724,93328,10233,2022,'NILO PECANHA',Nilo Peçanha,'BA',2922607,932.0,14041,84.7,1276.5,1,0.0,1562.0,Pequeno I
2096,2100,292265,10342,9132,249,7524,7773,1359,10089.33,8961.83,279.75,7316.0,7595.75,1366.08,121072,107542,3357,87792,91149,16393,2022,'NORDESTINA',Nordestina,'BA',2922656,3278.0,3278,273.2,273.2,1,223.0,223.0,Pequeno I
2097,2101,292270,11224,9904,305,8256,8561,1343,10680.33,9450.58,314.58,7845.17,8159.75,1290.83,128164,113407,3775,94142,97917,15490,2022,'NOVA CANAA',Nova Canaã,'BA',2922706,8597.0,35498,716.4,2958.2,3,1145.0,5864.0,Pequeno I
2098,2102,292273,6562,5696,267,4323,4590,1106,6432.58,5622.83,232.83,4299.42,4532.25,1090.58,77191,67474,2794,51593,54387,13087,2022,'NOVA FATIMA',Nova Fátima,'BA',2922730,610.0,610,67.8,67.8,1,45.0,45.0,Pequeno I
2099,2103,292275,5119,4554,159,3725,3884,670,4824.08,4308.92,163.83,3457.67,3621.5,687.42,57889,51707,1966,41492,43458,8249,2022,'NOVA IBIA',Nova Ibiá,'BA',2922755,1899.0,1899,189.9,189.9,1,60.0,60.0,Pequeno I
2100,2104,292280,6807,6016,205,5187,5392,624,6619.25,5899.42,207.83,5092.42,5300.25,599.17,79431,70793,2494,61109,63603,7190,2022,'NOVA ITARANA',Nova Itarana,'BA',2922805,944.0,944,78.7,78.7,1,76.0,76.0,Pequeno I
2101,2105,292285,6550,5648,195,4656,4851,797,6461.17,5635.42,178.92,4665.42,4844.33,791.08,77534,67625,2147,55985,58132,9493,2022,'NOVA REDENCAO',Nova Redenção,'BA',2922854,579.0,579,52.6,52.6,1,48.0,48.0,Pequeno I
2102,2106,292290,20588,17982,512,14908,15420,2562,20349.33,17867.08,523.92,14809.5,15333.42,2533.67,244192,214405,6287,177714,184001,30404,2022,'NOVA SOURE',Nova Soure,'BA',2922904,6639.0,6639,553.2,553.2,1,138.0,138.0,Pequeno II
2103,2107,292300,28844,25055,3573,15448,19021,6034,27851.17,24455.67,3025.42,16115.92,19141.33,5314.33,334214,293468,36305,193391,229696,63772,2022,'NOVA VICOSA',Nova Viçosa,'BA',2923001,5085.0,5085,423.8,423.8,1,250.0,250.0,Pequeno II
2104,2108,292303,9278,8442,139,7446,7585,857,8986.17,8233.67,200.5,7155.0,7355.5,878.17,107834,98804,2406,85860,88266,10538,2022,'NOVO HORIZONTE',Novo Horizonte,'BA',2923035,5366.0,5366,447.2,447.2,1,277.0,277.0,Pequeno I
2105,2109,292305,6679,6322,174,5582,5756,566,6503.92,6182.92,194.58,5454.58,5649.17,533.75,78047,74195,2335,65455,67790,6405,2022,'NOVO TRIUNFO',Novo Triunfo,'BA',2923050,656.0,656,54.7,54.7,1,63.0,63.0,Pequeno I
2106,2110,292310,18237,16773,445,14391,14836,1937,17972.83,16641.5,380.5,14462.92,14843.42,1798.08,215674,199698,4566,173555,178121,21577,2022,'OLINDINA',Olindina,'BA',2923100,1297.0,1297,108.1,108.1,1,36.0,36.0,Pequeno II
2107,2111,292320,16883,14413,532,10961,11493,2920,16796.58,14429.08,609.33,10841.25,11450.58,2978.5,201559,173149,7312,130095,137407,35742,2022,'OLIVEIRA DOS BREJINHOS',Oliveira Dos Brejinhos,'BA',2923209,2618.0,2618,238.0,238.0,1,120.0,120.0,Pequeno II
2108,2112,292330,6725,6012,231,5123,5354,658,6456.92,5796.83,272.67,4811.92,5084.58,712.25,77483,69562,3272,57743,61015,8547,2022,'OURICANGAS',Ouriçangas,'BA',2923308,2344.0,2344,195.3,195.3,1,135.0,135.0,Pequeno I
2109,2113,292335,14122,12986,585,10840,11425,1561,13620.33,12631.42,519.42,10711.33,11230.75,1400.67,163444,151577,6233,128536,134769,16808,2022,'OUROLANDIA',Ourolândia,'BA',2923357,6148.0,6148,558.9,558.9,1,,,Pequeno I
2110,2114,292340,15805,13647,932,9548,10480,3167,16100.0,13998.33,791.67,9936.67,10728.33,3270.0,193200,167980,9500,119240,128740,39240,2022,'PALMAS DE MONTE ALTO',Palmas de Monte Alto,'BA',2923407,3139.0,3139,261.6,261.6,1,51.0,51.0,Pequeno II
2111,2115,292350,7728,7011,393,5731,6124,887,7419.25,6768.83,378.0,5523.83,5901.83,867.0,89031,81226,4536,66286,70822,10404,2022,'PALMEIRAS',Palmeiras,'BA',2923506,1038.0,1038,86.5,86.5,1,35.0,35.0,Pequeno I
2112,2116,292360,14251,12568,734,9012,9746,2822,13978.83,12414.92,672.25,8942.67,9614.92,2800.0,167746,148979,8067,107312,115379,33600,2022,'PARAMIRIM',Paramirim,'BA',2923605,1884.0,1884,157.0,157.0,1,76.0,76.0,Pequeno II
2113,2117,292370,27126,24643,338,22909,23247,1396,26195.33,23907.83,361.25,22151.42,22512.67,1395.17,314344,286894,4335,265817,270152,16742,2022,'PARATINGA',Paratinga,'BA',2923704,1406.0,1406,127.8,127.8,1,93.0,93.0,Pequeno II
2114,2118,292380,20550,18837,1186,14395,15581,3256,20192.0,18681.83,1187.83,14286.08,15473.92,3207.92,242304,224182,14254,171433,185687,38495,2022,'PARIPIRANGA',Paripiranga,'BA',2923803,1331.0,1331,121.0,121.0,1,43.0,43.0,Pequeno II
2115,2119,292390,9664,8063,190,7280,7470,593,9505.75,7980.67,151.92,7242.17,7394.08,586.58,114069,95768,1823,86906,88729,7039,2022,'PAU BRASIL',Pau Brasil,'BA',2923902,2552.0,2552,212.7,212.7,1,450.0,450.0,Pequeno I
2116,2120,292400,69746,63632,5925,44228,50153,13479,67492.75,62023.42,5736.0,43577.42,49313.42,12710.0,809913,744281,68832,522929,591761,152520,2022,'PAULO AFONSO',Paulo Afonso,'BA',2924009,26149.0,26149,2179.1,2179.1,5,2329.0,2329.0,Grande
2117,2121,292405,11827,10367,328,8261,8589,1778,11623.83,10298.17,325.5,8324.42,8649.92,1648.25,139486,123578,3906,99893,103799,19779,2022,'PE DE SERRA',pé de Serra,'BA',2924058,1020.0,1020,85.0,85.0,1,64.0,64.0,Pequeno I
2118,2122,292410,5682,5169,159,4595,4754,415,5535.5,5043.75,169.75,4473.33,4643.08,400.67,66426,60525,2037,53680,55717,4808,2022,'PEDRAO',Pedrão,'BA',2924108,454.0,454,37.8,37.8,1,14.0,14.0,Pequeno I
2119,2123,292420,11914,11067,254,9816,10070,997,11556.42,10812.42,278.08,9559.0,9837.08,975.33,138677,129749,3337,114708,118045,11704,2022,'PEDRO ALEXANDRE',Pedro Alexandre,'BA',2924207,3613.0,3613,328.5,328.5,1,780.0,780.0,Pequeno I
2120,2124,292430,15960,13173,1086,8670,9756,3417,15550.25,13061.83,1097.83,8662.5,9760.33,3301.5,186603,156742,13174,103950,117124,39618,2022,'PIATA',Piatã,'BA',2924306,1698.0,1698,141.5,141.5,1,96.0,96.0,Pequeno I
2121,2125,292440,29319,27927,604,24967,25571,2356,28575.33,27343.0,646.83,24432.25,25079.08,2263.92,342904,328116,7762,293187,300949,27167,2022,'PILAO ARCADO',Pilão Arcado,'BA',2924405,582.0,582,64.7,64.7,1,,,Pequeno II
2122,2126,292450,12389,10095,301,7732,8033,2062,12146.5,10078.5,337.0,7726.67,8063.67,2014.83,145758,120942,4044,92720,96764,24178,2022,'PINDAI',Pindaí,'BA',2924504,1302.0,1302,108.5,108.5,1,77.0,77.0,Pequeno I
2123,2127,292460,16079,14316,447,12078,12525,1791,15338.33,13698.08,470.58,11328.08,11798.67,1899.42,184060,164377,5647,135937,141584,22793,2022,'PINDOBACU',Pindobaçu,'BA',2924603,1497.0,1497,124.8,124.8,1,79.0,79.0,Pequeno II
2124,2128,292465,7018,6352,268,4548,4816,1536,7014.0,6422.5,299.92,4633.42,4933.33,1489.17,84168,77070,3599,55601,59200,17870,2022,'PINTADAS',Pintadas,'BA',2924652,1391.0,1391,115.9,115.9,1,100.0,100.0,Pequeno I
2125,2129,292467,6140,5748,675,4208,4883,865,5873.17,5513.67,645.58,4062.42,4708.0,805.67,70478,66164,7747,48749,56496,9668,2022,'PIRAI DO NORTE',Piraí do Norte,'BA',2924678,1079.0,1079,119.9,119.9,1,,,Pequeno I
2126,2130,292470,8025,6704,346,4783,5129,1575,7925.17,6686.0,305.17,4867.25,5172.42,1513.58,95102,80232,3662,58407,62069,18163,2022,'PIRIPA',Piripá,'BA',2924702,3371.0,3371,374.6,374.6,1,330.0,330.0,Pequeno I
2127,2131,292480,15518,13776,330,12363,12693,1083,15373.08,13757.83,322.33,12388.75,12711.08,1046.75,184477,165094,3868,148665,152533,12561,2022,'PIRITIBA',Piritiba,'BA',2924801,1673.0,1673,167.3,167.3,1,94.0,94.0,Pequeno II
2128,2132,292490,6578,5804,167,4688,4855,949,6357.42,5685.92,175.42,4632.58,4808.0,877.92,76289,68231,2105,55591,57696,10535,2022,'PLANALTINO',Planaltino,'BA',2924900,3112.0,3112,259.3,259.3,1,78.0,78.0,Pequeno I
2129,2133,292500,19939,17116,899,12362,13261,3855,19485.42,16841.25,949.75,11977.42,12927.17,3914.08,233825,202095,11397,143729,155126,46969,2022,'PLANALTO',Planalto,'BA',2925006,1840.0,1840,167.3,167.3,1,75.0,75.0,Pequeno II
2130,2134,292510,39407,33672,2554,23573,26127,7545,38249.83,32938.58,2279.42,23379.75,25659.17,7279.42,458998,395263,27353,280557,307910,87353,2022,'POCOES',Poções,'BA',2925105,9346.0,9346,778.8,778.8,1,117.0,117.0,Pequeno II
2131,2135,292520,20501,18882,1129,14815,15944,2938,19664.92,18194.33,1006.42,14516.33,15522.75,2671.58,235979,218332,12077,174196,186273,32059,2022,'POJUCA',Pojuca,'BA',2925204,11443.0,11443,953.6,953.6,2,940.0,940.0,Pequeno II
2132,2136,292525,16138,14509,318,13029,13347,1162,15636.25,14117.25,276.83,12735.92,13012.75,1104.5,187635,169407,3322,152831,156153,13254,2022,'PONTO NOVO',Ponto Novo,'BA',2925253,3013.0,3013,251.1,251.1,1,180.0,180.0,Pequeno I
2133,2137,292530,100660,86694,17956,43295,61251,25443,91299.67,79305.42,15750.08,40770.92,56521.0,22784.42,1095596,951665,189001,489251,678252,273413,2022,'PORTO SEGURO',Porto Seguro,'BA',2925303,59041.0,59041,4920.1,4920.1,8,3848.0,3848.0,Grande
2134,2138,292540,8827,7656,214,6969,7183,473,8699.25,7592.42,190.42,6961.58,7152.0,440.42,104391,91109,2285,83539,85824,5285,2022,'POTIRAGUA',Potiraguá,'BA',2925402,579.0,579,52.6,52.6,1,7.0,7.0,Pequeno I
2135,2139,292550,24784,21929,1636,15781,17417,4512,23212.17,20623.25,1472.08,15360.42,16832.5,3790.75,278546,247479,17665,184325,201990,45489,2022,'PRADO',Prado,'BA',2925501,2444.0,2444,222.2,222.2,2,133.0,133.0,Pequeno II
2136,2140,292560,12234,10925,510,8064,8574,2351,11889.92,10736.75,496.0,7951.67,8447.67,2289.08,142679,128841,5952,95420,101372,27469,2022,'PRESIDENTE DUTRA',Presidente Dutra,'BA',2925600,3688.0,3688,307.3,307.3,1,185.0,185.0,Pequeno I
2137,2141,292570,10388,9078,189,7478,7667,1411,10221.92,8996.75,213.08,7412.5,7625.58,1371.17,122663,107961,2557,88950,91507,16454,2022,'PRESIDENTE JANIO QUADROS',Presidente Jânio Quadros,'BA',2925709,3902.0,3902,325.2,325.2,1,225.0,225.0,Pequeno I
2138,2142,292575,21221,20156,2294,14809,17103,3053,20689.83,19771.83,1960.33,15019.33,16979.67,2792.17,248278,237262,23524,180232,203756,33506,2022,'PRESIDENTE TANCREDO NEVES',Presidente Tancredo Neves,'BA',2925758,2590.0,2590,215.8,215.8,1,60.0,60.0,Pequeno II
2139,2143,292580,20390,17974,759,14918,15677,2297,19965.0,17724.75,562.08,14920.17,15482.25,2242.5,239580,212697,6745,179042,185787,26910,2022,'QUEIMADAS',Queimadas,'BA',2925808,4407.0,4407,367.2,367.2,1,434.0,434.0,Pequeno II
2140,2144,292590,20966,18442,1024,14669,15693,2749,20605.58,18221.0,1037.33,14404.42,15441.75,2779.25,247267,218652,12448,172853,185301,33351,2022,'QUIJINGUE',Quijingue,'BA',2925907,25521.0,25521,2126.8,2126.8,2,1539.0,1539.0,Pequeno II
2141,2145,292593,7819,6556,194,5347,5541,1015,7607.5,6536.75,202.75,5384.75,5587.5,949.25,91290,78441,2433,64617,67050,11391,2022,'QUIXABEIRA',Quixabeira,'BA',2925931,462.0,462,38.5,38.5,1,19.0,19.0,Pequeno I
2142,2146,292595,15835,14664,668,12230,12898,1766,15375.58,14296.58,592.33,12120.08,12712.42,1584.17,184507,171559,7108,145441,152549,19010,2022,'RAFAEL JAMBEIRO',Rafael Jambeiro,'BA',2925956,3564.0,3564,297.0,297.0,1,204.0,204.0,Pequeno II
2143,2147,292600,32473,29632,1493,23403,24896,4736,31804.67,29197.42,1418.17,23308.5,24726.67,4470.75,381656,350369,17018,279702,296720,53649,2022,'REMANSO',Remanso,'BA',2926004,2604.0,2604,217.0,217.0,2,67.0,67.0,Pequeno II
2144,2148,292610,12133,10697,356,8516,8872,1825,11866.17,10576.42,348.17,8424.83,8773.0,1803.42,142394,126917,4178,101098,105276,21641,2022,'RETIROLANDIA',Retirolândia,'BA',2926103,2306.0,2306,192.2,192.2,1,81.0,81.0,Pequeno I
2145,2149,292620,18814,17036,283,15627,15910,1126,18532.5,16879.92,322.58,15540.25,15862.83,1017.08,222390,202559,3871,186483,190354,12205,2022,'RIACHAO DAS NEVES',Riachão Das Neves,'BA',2926202,4364.0,4364,436.4,436.4,1,630.0,630.0,Pequeno II
2146,2150,292630,23953,20452,2325,13497,15822,4630,23245.83,20063.17,2180.0,13166.17,15346.17,4717.0,278950,240758,26160,157994,184154,56604,2022,'RIACHAO DO JACUIPE',Riachão do Jacuípe,'BA',2926301,1627.0,1627,135.6,135.6,1,89.0,89.0,Pequeno II
2147,2151,292640,24932,22247,1337,15246,16583,5664,24659.5,22330.17,1229.0,15758.17,16987.17,5343.0,295914,267962,14748,189098,203846,64116,2022,'RIACHO DE SANTANA',Riacho de Santana,'BA',2926400,7073.0,7073,589.4,589.4,2,317.0,317.0,Pequeno II
2148,2152,292650,11460,10660,200,9633,9833,827,11346.42,10617.5,215.75,9610.5,9826.25,791.25,136157,127410,2589,115326,117915,9495,2022,'RIBEIRA DO AMPARO',Ribeira do Amparo,'BA',2926509,440.0,440,36.7,36.7,1,35.0,35.0,Pequeno I
2149,2153,292660,32701,29723,1578,22598,24176,5547,32097.75,29290.08,1699.75,22226.08,23925.83,5364.25,385173,351481,20397,266713,287110,64371,2022,'RIBEIRA DO POMBAL',Ribeira do Pombal,'BA',2926608,6769.0,6769,564.1,564.1,2,291.0,291.0,Pequeno II
2150,2154,292665,6449,5901,292,4717,5009,892,6464.67,5978.92,245.83,4901.58,5147.42,831.5,77576,71747,2950,58819,61769,9978,2022,'RIBEIRAO DO LARGO',Ribeirão do Largo,'BA',2926657,2013.0,2013,167.8,167.8,1,52.0,52.0,Pequeno I
2151,2155,292670,10434,8686,819,5379,6198,2488,10233.33,8608.42,686.33,5495.33,6181.67,2426.75,122800,103301,8236,65944,74180,29121,2022,'RIO DE CONTAS',Rio de Contas,'BA',2926707,1863.0,1863,155.2,155.2,1,31.0,31.0,Pequeno I
2152,2156,292680,11215,9514,276,7146,7422,2092,11012.42,9404.67,328.33,7026.92,7355.25,2049.42,132149,112856,3940,84323,88263,24593,2022,'RIO DO ANTONIO',Rio do Antônio,'BA',2926806,2972.0,2972,270.2,270.2,1,129.0,129.0,Pequeno I
2153,2157,292690,7180,5648,558,3562,4120,1528,7118.0,5656.17,543.58,3619.42,4163.0,1493.17,85416,67874,6523,43433,49956,17918,2022,'RIO DO PIRES',Rio do Pires,'BA',2926905,996.0,996,90.5,90.5,1,42.0,42.0,Pequeno I
2154,2158,292700,29677,26917,1445,19980,21425,5492,28990.67,26590.17,1577.83,19693.67,21271.5,5318.67,347888,319082,18934,236324,255258,63824,2022,'RIO REAL',Rio Real,'BA',2927002,6115.0,6115,509.6,509.6,1,260.0,260.0,Pequeno II
2155,2159,292710,8856,8532,154,8066,8220,312,8507.92,8217.58,166.0,7666.92,7832.92,384.67,102095,98611,1992,92003,93995,4616,2022,'RODELAS',Rodelas,'BA',2927101,646.0,646,53.8,53.8,1,26.0,26.0,Pequeno I
2156,2160,292720,22180,20159,916,15924,16840,3319,22040.17,20180.75,894.67,16193.0,17087.67,3093.08,264482,242169,10736,194316,205052,37117,2022,'RUY BARBOSA',Ruy Barbosa,'BA',2927200,16393.0,16393,1366.1,1366.1,2,1251.0,1251.0,Pequeno II
2157,2161,292730,13032,12049,586,10105,10691,1358,12416.67,11589.42,607.42,9662.08,10269.5,1319.92,149000,139073,7289,115945,123234,15839,2022,'SALINAS DA MARGARIDA',Salinas da Margarida,'BA',2927309,3385.0,3385,282.1,282.1,1,126.0,126.0,Pequeno I
2158,2162,292740,1011969,935692,102624,652736,755360,180332,914845.83,846574.33,95309.25,584136.58,679445.83,167128.5,10978150,10158892,1143711,7009639,8153350,2005542,2022,'SALVADOR',Salvador,'BA',2927408,102224.0,102224,8518.7,8518.7,28,14960.0,14960.0,Metrópole
2159,2163,292750,18246,16825,626,14194,14820,2005,17662.42,16398.92,602.08,13801.0,14403.08,1995.83,211949,196787,7225,165612,172837,23950,2022,'SANTA BARBARA',Santa Bárbara,'BA',2927507,2156.0,2156,179.7,179.7,1,60.0,60.0,Pequeno I
2160,2164,292760,11933,10798,577,8030,8607,2191,11793.25,10752.67,593.5,8087.42,8680.92,2071.75,141519,129032,7122,97049,104171,24861,2022,'SANTA BRIGIDA',Santa Brígida,'BA',2927606,917.0,917,83.4,83.4,1,,,Pequeno I
2161,2165,292770,20698,18409,2310,12891,15201,3208,19193.92,17184.83,2120.42,12220.67,14341.08,2843.75,230327,206218,25445,146648,172093,34125,2022,'SANTA CRUZ CABRALIA',Santa Cruz Cabrália,'BA',2927705,3087.0,3087,257.2,257.2,1,156.0,156.0,Pequeno II
2162,2166,292780,4455,3661,107,2972,3079,582,4381.25,3644.0,120.08,2905.25,3025.33,618.67,52575,43728,1441,34863,36304,7424,2022,'SANTA CRUZ DA VITORIA',Santa Cruz da Vitória,'BA',2927804,363.0,363,30.2,30.2,1,25.0,25.0,Pequeno I
2163,2167,292790,8694,7482,573,5931,6504,978,8638.58,7467.67,448.75,6108.67,6557.42,910.25,103663,89612,5385,73304,78689,10923,2022,'SANTA INES',Santa Inês,'BA',2927903,2405.0,2405,343.6,343.6,1,642.0,642.0,Pequeno I
2164,2168,292800,31410,28188,1828,21996,23824,4364,30293.0,27389.42,1469.75,21923.42,23393.17,3996.25,363516,328673,17637,263081,280718,47955,2022,'SANTALUZ',Santaluz,'BA',2928000,5947.0,5947,540.6,540.6,2,464.0,464.0,Pequeno II
2165,2169,292805,9332,8158,345,6728,7073,1085,9193.0,8080.5,328.5,6563.17,6891.67,1188.83,110316,96966,3942,78758,82700,14266,2022,'SANTA LUZIA',Santa Luzia,'BA',2928059,790.0,15206,65.8,1267.2,1,790.0,790.0,Pequeno I
2166,2170,292810,32562,28232,1260,22631,23891,4341,31078.83,27053.0,1449.83,21121.33,22571.17,4481.83,372946,324636,17398,253456,270854,53782,2022,'SANTA MARIA DA VITORIA',Santa Maria da Vitória,'BA',2928109,3724.0,3724,310.3,310.3,2,224.0,224.0,Pequeno II
2167,2171,292820,21083,17261,1571,11534,13105,4156,20878.0,17266.0,1430.33,11798.92,13229.25,4036.75,250536,207192,17164,141587,158751,48441,2022,'SANTANA',Santana,'BA',2928208,2227.0,2227,185.6,185.6,1,133.0,133.0,Pequeno II
2168,2172,292830,7410,6793,307,5642,5949,844,7232.58,6648.67,260.58,5635.08,5895.67,753.0,86791,79784,3127,67621,70748,9036,2022,'SANTANOPOLIS',Santanópolis,'BA',2928307,1908.0,1908,159.0,159.0,1,40.0,40.0,Pequeno I
2169,2173,292840,25474,23146,470,20577,21047,2099,24795.75,22653.67,534.33,20011.67,20546.0,2107.67,297549,271844,6412,240140,246552,25292,2022,'SANTA RITA DE CASSIA',Santa Rita de Cássia,'BA',2928406,2456.0,2456,204.7,204.7,1,98.0,98.0,Pequeno II
2170,2174,292850,7320,6628,560,4556,5116,1512,7102.17,6462.58,556.75,4482.83,5039.58,1423.0,85226,77551,6681,53794,60475,17076,2022,'SANTA TERESINHA',Santa Teresinha,'BA',2928505,1025.0,1025,85.4,85.4,1,53.0,53.0,Pequeno I
2171,2175,292860,42952,39991,1007,34510,35517,4474,40638.83,38252.17,1110.58,33124.17,34234.75,4017.42,487666,459026,13327,397490,410817,48209,2022,'SANTO AMARO',Santo Amaro,'BA',2928604,16905.0,16905,1408.8,1408.8,4,791.0,791.0,Médio
2172,2176,292870,59000,53517,3617,37045,40662,12855,54246.75,49687.33,3168.5,35120.42,38288.92,11398.42,650961,596248,38022,421445,459467,136781,2022,'SANTO ANTONIO DE JESUS',Santo Antônio de Jesus,'BA',2928703,41920.0,41920,3493.3,3493.3,4,2551.0,2551.0,Médio
2173,2177,292880,33901,30252,1529,20839,22368,7884,33173.75,30086.5,1430.08,21905.92,23336.0,6750.5,398085,361038,17161,262871,280032,81006,2022,'SANTO ESTEVAO',Santo Estêvão,'BA',2928802,4370.0,4370,364.2,364.2,2,172.0,172.0,Pequeno II
2174,2178,292890,23224,21517,658,18387,19045,2472,21969.17,20463.0,587.0,17814.0,18401.0,2062.0,263630,245556,7044,213768,220812,24744,2022,'SAO DESIDERIO',São Desidério,'BA',2928901,4624.0,4624,385.3,385.3,1,242.0,242.0,Pequeno II
2175,2179,292895,7605,6244,387,5005,5392,852,7332.0,6022.5,352.42,4765.5,5117.92,904.58,87984,72270,4229,57186,61415,10855,2022,'SAO DOMINGOS',São Domingos,'BA',2928950,1018.0,1018,84.8,84.8,1,48.0,48.0,Pequeno I
2176,2180,292900,8054,7534,201,6134,6335,1199,7751.58,7304.17,206.0,5989.0,6195.0,1109.17,93019,87650,2472,71868,74340,13310,2022,'SAO FELIX',São Félix,'BA',2929008,982.0,982,89.3,89.3,1,81.0,81.0,Pequeno I
2177,2181,292905,12232,10546,414,7931,8345,2201,11965.25,10405.17,369.5,7961.83,8331.33,2073.83,143583,124862,4434,95542,99976,24886,2022,'SAO FELIX DO CORIBE',São Félix do Coribe,'BA',2929057,2625.0,2625,218.8,218.8,1,56.0,56.0,Pequeno I
2178,2182,292910,15102,13994,390,11142,11532,2462,14272.42,13410.75,440.42,10581.75,11022.17,2388.58,171269,160929,5285,126981,132266,28663,2022,'SAO FELIPE',São Felipe,'BA',2929107,1727.0,1727,143.9,143.9,1,216.0,216.0,Pequeno II
2179,2183,292920,28885,27438,1010,23109,24119,3319,28324.75,27181.42,986.42,23298.5,24284.92,2896.5,339897,326177,11837,279582,291419,34758,2022,'SAO FRANCISCO DO CONDE',São Francisco do Conde,'BA',2929206,7635.0,7635,636.2,636.2,3,742.0,742.0,Pequeno II
2180,2184,292925,16284,14082,1030,9573,10603,3479,15962.08,14009.5,950.58,9838.33,10788.92,3220.58,191545,168114,11407,118060,129467,38647,2022,'SAO GABRIEL',São Gabriel,'BA',2929255,905.0,905,75.4,75.4,2,52.0,52.0,Pequeno I
2181,2185,292930,21769,19600,2638,10955,13593,6007,20589.83,18774.75,2335.33,11149.33,13484.67,5290.08,247078,225297,28024,133792,161816,63481,2022,'SAO GONCALO DOS CAMPOS',São Gonçalo Dos Campos,'BA',2929305,2645.0,2645,240.5,240.5,1,170.0,170.0,Pequeno II
2182,2186,292935,6358,5633,58,5153,5211,422,6326.0,5646.5,72.67,5149.75,5222.42,424.08,75912,67758,872,61797,62669,5089,2022,'SAO JOSE DA VITORIA',São José da Vitória,'BA',2929354,701.0,701,58.4,58.4,1,27.0,27.0,Pequeno I
2183,2187,292937,7735,6892,716,4281,4997,1895,7546.33,6938.25,509.58,5083.0,5592.58,1345.67,90556,83259,6115,60996,67111,16148,2022,'SAO JOSE DO JACUIPE',São José do Jacuípe,'BA',2929370,1471.0,1471,133.7,133.7,1,98.0,98.0,Pequeno I
2184,2188,292940,8137,7018,1043,4395,5438,1580,7936.67,6894.42,812.0,4602.83,5414.83,1479.58,95240,82733,9744,55234,64978,17755,2022,'SAO MIGUEL DAS MATAS',São Miguel Das Matas,'BA',2929404,4973.0,7473,452.1,679.4,1,254.0,254.0,Pequeno I
2185,2189,292950,26134,23981,1353,17663,19016,4965,25612.67,23658.0,1209.08,17882.67,19091.75,4566.25,307352,283896,14509,214592,229101,54795,2022,'SAO SEBASTIAO DO PASSE',São Sebastião do Passé,'BA',2929503,5371.0,5371,488.3,488.3,2,,,Pequeno II
2186,2190,292960,14088,12583,386,10050,10436,2147,13657.92,12269.17,363.83,9796.75,10160.58,2108.58,163895,147230,4366,117561,121927,25303,2022,'SAPEACU',Sapeaçu,'BA',2929602,662.0,662,55.2,55.2,1,55.0,55.0,Pequeno I
2187,2191,292970,11893,11058,329,9207,9536,1522,11527.5,10782.58,338.5,9049.75,9388.25,1394.33,138330,129391,4062,108597,112659,16732,2022,'SATIRO DIAS',Sátiro Dias,'BA',2929701,3054.0,3054,254.5,254.5,1,224.0,224.0,Pequeno I
2188,2192,292975,10337,9662,230,8794,9024,638,10069.17,9447.75,253.25,8608.42,8861.67,586.08,120830,113373,3039,103301,106340,7033,2022,'SAUBARA',Saubara,'BA',2929750,1279.0,1279,106.6,106.6,1,54.0,54.0,Pequeno I
2189,2193,292980,9097,8014,190,7002,7192,822,8872.83,7837.0,196.83,6771.83,6968.67,868.33,106474,94044,2362,81262,83624,10420,2022,'SAUDE',Saúde,'BA',2929800,883.0,883,73.6,73.6,1,78.0,78.0,Pequeno I
2190,2194,292990,34328,30255,1282,22900,24182,6073,33636.17,29962.0,1352.25,22703.5,24055.75,5906.25,403634,359544,16227,272442,288669,70875,2022,'SEABRA',Seabra,'BA',2929909,5415.0,5415,451.2,451.2,1,420.0,420.0,Pequeno II
2191,2195,293000,7093,6261,317,4746,5063,1198,6937.75,6220.42,281.92,4821.17,5103.08,1117.33,83253,74645,3383,57854,61237,13408,2022,'SEBASTIAO LARANJEIRAS',Sebastião Laranjeiras,'BA',2930006,1256.0,1256,104.7,104.7,1,139.0,139.0,Pequeno I
2192,2196,293010,51538,44942,5917,28412,34329,10613,50033.67,44000.0,5242.42,28514.67,33757.08,10242.92,600404,528000,62909,342176,405085,122915,2022,'SENHOR DO BONFIM',Senhor do Bonfim,'BA',2930105,22992.0,41527,1916.0,3460.6,4,5044.0,10183.0,Médio
2193,2197,293015,28175,23871,2078,16093,18171,5700,27745.58,23781.17,1959.08,16423.25,18382.33,5398.83,332947,285374,23509,197079,220588,64786,2022,'SERRA DO RAMALHO',Serra do Ramalho,'BA',2930154,3758.0,3758,313.2,313.2,1,93.0,93.0,Pequeno II
2194,2198,293020,30264,28550,595,25743,26338,2212,29739.42,28159.92,594.33,25400.42,25994.75,2165.17,356873,337919,7132,304805,311937,25982,2022,'SENTO SE',Sento sé,'BA',2930204,4693.0,4693,391.1,391.1,1,225.0,225.0,Pequeno II
2195,2199,293030,14688,12537,764,8626,9390,3147,14451.58,12397.58,638.17,8664.42,9302.58,3095.0,173419,148771,7658,103973,111631,37140,2022,'SERRA DOURADA',Serra Dourada,'BA',2930303,3738.0,3738,311.5,311.5,2,214.0,214.0,Pequeno I
2196,2200,293040,11985,10554,346,8799,9145,1409,11827.0,10561.42,315.83,9018.58,9334.42,1227.0,141924,126737,3790,108223,112013,14724,2022,'SERRA PRETA',Serra Preta,'BA',2930402,8954.0,8954,814.0,814.0,1,405.0,405.0,Pequeno I
2197,2201,293050,62372,56853,3840,42625,46465,10388,59971.5,55047.25,3467.33,41360.0,44827.33,10219.92,719658,660567,41608,496320,537928,122639,2022,'SERRINHA',Serrinha,'BA',2930501,2944.0,2944,245.3,245.3,4,56.0,56.0,Médio
2198,2202,293060,10890,9168,590,6455,7045,2123,10529.33,8973.42,602.42,6304.25,6906.67,2066.75,126352,107681,7229,75651,82880,24801,2022,'SERROLANDIA',Serrolândia,'BA',2930600,1396.0,1396,116.3,116.3,1,305.0,305.0,Pequeno I
2199,2203,293070,79831,74212,4771,58114,62885,11327,71883.0,67249.0,4665.42,52526.75,57192.17,10056.83,862596,806988,55985,630321,686306,120682,2022,'SIMOES FILHO',Simões Filho,'BA',2930709,14832.0,14832,1236.0,1236.0,3,493.0,493.0,Grande
2200,2204,293075,11761,10796,350,9215,9565,1231,11735.5,10828.83,404.5,9201.58,9606.08,1222.75,140826,129946,4854,110419,115273,14673,2022,'SITIO DO MATO',Sítio do Mato,'BA',2930758,2448.0,2448,244.8,244.8,1,,,Pequeno I
2201,2205,293076,8999,8529,210,7588,7798,731,8913.33,8464.92,182.25,7578.42,7760.67,704.25,106960,101579,2187,90941,93128,8451,2022,'SITIO DO QUINTO',Sítio do Quinto,'BA',2930766,972.0,972,81.0,81.0,1,105.0,105.0,Pequeno I
2202,2206,293077,18942,16514,2157,10108,12265,4249,18599.25,16393.25,1979.58,10354.75,12334.33,4058.92,223191,196719,23755,124257,148012,48707,2022,'SOBRADINHO',Sobradinho,'BA',2930774,2227.0,2227,222.7,222.7,1,97.0,97.0,Pequeno II
2203,2207,293080,14376,12846,366,10299,10665,2181,14367.08,12923.92,405.75,10375.17,10780.92,2143.0,172405,155087,4869,124502,129371,25716,2022,'SOUTO SOARES',Souto Soares,'BA',2930808,2302.0,2302,191.8,191.8,1,188.0,188.0,Pequeno I
2204,2208,293090,9930,8424,611,5762,6373,2051,9823.08,8436.17,630.83,5818.83,6449.67,1986.5,117877,101234,7570,69826,77396,23838,2022,'TABOCAS DO BREJO VELHO',Tabocas do Brejo Velho,'BA',2930907,801.0,801,66.8,66.8,1,50.0,50.0,Pequeno I
2205,2209,293100,16746,14333,720,10903,11623,2710,16304.92,14174.5,643.67,11035.17,11678.83,2495.67,195659,170094,7724,132422,140146,29948,2022,'TANHACU',Tanhaçu,'BA',2931004,2194.0,2194,182.8,182.8,2,92.0,92.0,Pequeno II
2206,2210,293105,13074,11620,754,7994,8748,2872,12772.67,11513.25,765.08,7996.67,8761.75,2751.5,153272,138159,9181,95960,105141,33018,2022,'TANQUE NOVO',Tanque Novo,'BA',2931053,1489.0,1489,124.1,124.1,1,97.0,97.0,Pequeno I
2207,2211,293110,6480,5765,282,4523,4805,960,6317.17,5671.67,232.5,4543.42,4775.92,895.75,75806,68060,2790,54521,57311,10749,2022,'TANQUINHO',Tanquinho,'BA',2931103,2686.0,2686,223.8,223.8,1,333.0,333.0,Pequeno I
2208,2212,293120,13518,12691,723,10624,11347,1344,13177.75,12412.67,661.75,10434.67,11096.42,1316.25,158133,148952,7941,125216,133157,15795,2022,'TAPEROA',Taperoá,'BA',2931202,1918.0,14494,159.8,1207.8,1,0.0,1110.0,Pequeno I
2209,2213,293130,10552,9749,409,8241,8650,1099,10468.75,9733.25,397.0,8326.08,8723.08,1010.17,125625,116799,4764,99913,104677,12122,2022,'TAPIRAMUTA',Tapiramutá,'BA',2931301,504.0,504,56.0,56.0,1,56.0,56.0,Pequeno I
2210,2214,293135,84748,70607,14419,27963,42382,28225,80418.17,67818.67,12746.17,29275.25,42021.42,25797.25,965018,813824,152954,351303,504257,309567,2022,'TEIXEIRA DE FREITAS',Teixeira de Freitas,'BA',2931350,19192.0,19192,1599.3,1599.3,4,1000.0,1000.0,Grande
2211,2215,293140,6053,5540,143,4874,5017,523,5819.83,5368.67,125.5,4727.33,4852.83,515.83,69838,64424,1506,56728,58234,6190,2022,'TEODORO SAMPAIO',Teodoro Sampaio,'BA',2931400,7123.0,7123,593.6,593.6,2,613.0,613.0,Pequeno I
2212,2216,293150,16474,14394,1262,9495,10757,3637,16318.42,14431.75,1219.5,9775.58,10995.08,3436.67,195821,173181,14634,117307,131941,41240,2022,'TEOFILANDIA',Teofilândia,'BA',2931509,1061.0,1061,88.4,88.4,1,46.0,46.0,Pequeno II
2213,2217,293160,10463,9764,755,8172,8927,837,10275.5,9614.92,727.0,8105.83,8832.83,782.08,123306,115379,8724,97270,105994,9385,2022,'TEOLANDIA',Teolândia,'BA',2931608,877.0,877,79.7,79.7,1,25.0,25.0,Pequeno I
2214,2218,293170,11102,9946,241,8587,8828,1118,10880.5,9880.75,230.0,8624.83,8854.83,1025.92,130566,118569,2760,103498,106258,12311,2022,'TERRA NOVA',Terra Nova,'BA',2931707,2702.0,2702,225.2,225.2,1,95.0,95.0,Pequeno I
2215,2219,293180,13564,11853,345,9365,9710,2143,13220.42,11646.17,355.58,9192.5,9548.08,2098.08,158645,139754,4267,110310,114577,25177,2022,'TREMEDAL',Tremedal,'BA',2931806,1612.0,1612,134.3,134.3,1,53.0,53.0,Pequeno I
2216,2220,293190,42208,38886,515,34849,35364,3522,41207.08,38148.58,557.0,34098.58,34655.58,3493.0,494485,457783,6684,409183,415867,41916,2022,'TUCANO',Tucano,'BA',2931905,3459.0,3459,288.2,288.2,3,282.0,282.0,Médio
2217,2221,293200,23086,19985,896,16364,17260,2725,22635.17,19701.0,724.17,16252.33,16976.5,2724.5,271622,236412,8690,195028,203718,32694,2022,'UAUA',Uauá,'BA',2932002,3041.0,3041,253.4,253.4,2,56.0,56.0,Pequeno II
2218,2222,293210,14732,13195,1176,9699,10875,2320,14280.5,12913.75,986.83,9757.42,10744.25,2169.5,171366,154965,11842,117089,128931,26034,2022,'UBAIRA',Ubaíra,'BA',2932101,3989.0,14262,332.4,1188.5,1,0.0,2300.0,Pequeno I
2219,2223,293220,15185,12321,1595,7912,9507,2814,14633.25,12012.75,1709.83,7283.42,8993.25,3019.5,175599,144153,20518,87401,107919,36234,2022,'UBAITABA',Ubaitaba,'BA',2932200,11701.0,11701,975.1,975.1,1,904.0,904.0,Pequeno II
2220,2224,293230,11730,9939,699,7555,8254,1685,11106.75,9447.33,631.08,7135.75,7766.83,1680.5,133281,113368,7573,85629,93202,20166,2022,'UBATA',Ubatã,'BA',2932309,4778.0,4778,398.2,398.2,1,322.0,322.0,Pequeno II
2221,2225,293240,12472,10778,376,8322,8698,2080,12324.25,10743.92,354.33,8345.92,8700.25,2043.67,147891,128927,4252,100151,104403,24524,2022,'UIBAI',Uibaí,'BA',2932408,349.0,349,29.1,29.1,1,35.0,35.0,Pequeno I
2222,2226,293245,11513,10815,651,8730,9381,1434,11188.17,10558.42,489.08,8802.92,9292.0,1266.42,134258,126701,5869,105635,111504,15197,2022,'UMBURANAS',Umburanas,'BA',2932457,686.0,686,57.2,57.2,1,60.0,60.0,Pequeno I
2223,2227,293250,15137,13186,977,9809,10786,2400,14819.0,13074.17,797.17,10116.83,10914.0,2160.17,177828,156890,9566,121402,130968,25922,2022,'UNA',Una,'BA',2932507,3110.0,3110,259.2,259.2,1,111.0,111.0,Pequeno II
2224,2228,293260,13281,11584,354,8500,8854,2730,13016.67,11479.83,375.75,8320.42,8696.17,2783.67,156200,137758,4509,99845,104354,33404,2022,'URANDI',Urandi,'BA',2932606,4106.0,4106,456.2,456.2,1,432.0,432.0,Pequeno I
2225,2229,293270,17727,15676,784,13336,14120,1556,17192.0,15283.0,768.25,12994.67,13762.92,1520.08,206304,183396,9219,155936,165155,18241,2022,'URUCUCA',Uruçuca,'BA',2932705,3336.0,3336,278.0,278.0,1,178.0,178.0,Pequeno I
2226,2231,293290,50680,46691,4440,33156,37596,9095,48485.5,45058.33,4259.42,32338.92,36598.33,8460.0,581826,540700,51113,388067,439180,101520,2022,'VALENCA',Valença,'BA',2932903,8541.0,8541,711.8,711.8,4,571.0,571.0,Médio
2227,2232,293300,16771,15011,1139,11154,12293,2718,15933.42,14409.42,1029.0,10753.92,11782.92,2626.5,191201,172913,12348,129047,141395,31518,2022,'VALENTE',Valente,'BA',2933000,3516.0,3516,351.6,351.6,2,182.0,182.0,Pequeno II
2228,2233,293305,10903,9824,109,8944,9053,771,10726.5,9773.83,112.5,8936.33,9048.83,725.0,128718,117286,1350,107236,108586,8700,2022,'VARZEA DA ROCA',Várzea da Roça,'BA',2933059,343.0,343,68.6,68.6,1,42.0,42.0,Pequeno I
2229,2234,293310,6016,5350,115,4301,4416,934,5856.83,5256.08,126.92,4203.67,4330.58,925.5,70282,63073,1523,50444,51967,11106,2022,'VARZEA DO POCO',Várzea do Poço,'BA',2933109,4883.0,4883,406.9,406.9,1,561.0,561.0,Pequeno I
2230,2235,293315,11086,9721,671,7839,8510,1211,10772.25,9507.42,591.75,7715.75,8307.5,1199.92,129267,114089,7101,92589,99690,14399,2022,'VARZEA NOVA',Várzea Nova,'BA',2933158,7085.0,7085,590.4,590.4,1,806.0,806.0,Pequeno I
2231,2236,293317,7124,6547,472,4872,5344,1203,6913.0,6395.25,446.42,4852.25,5298.67,1096.58,82956,76743,5357,58227,63584,13159,2022,'VARZEDO',Varzedo,'BA',2933174,1554.0,13159,129.5,1096.6,1,763.0,763.0,Pequeno I
2232,2237,293320,33837,31725,548,28499,29047,2678,31980.08,30157.33,534.58,27296.5,27831.08,2326.25,383761,361888,6415,327558,333973,27915,2022,'VERA CRUZ',Vera Cruz,'BA',2933208,976.0,976,81.3,81.3,1,84.0,84.0,Pequeno II
2233,2238,293325,4899,4259,466,2798,3264,995,4772.0,4209.08,496.25,2796.25,3292.5,916.58,57264,50509,5955,33555,39510,10999,2022,'VEREDA',Vereda,'BA',2933257,1135.0,1135,94.6,94.6,1,85.0,85.0,Pequeno I
2234,2239,293330,221932,194632,26058,110262,136320,58312,206097.58,182274.0,25546.17,101431.17,126977.33,55296.67,2473171,2187288,306554,1217174,1523728,663560,2022,'VITORIA DA CONQUISTA',Vitória da Conquista,'BA',2933307,114918.0,132107,9576.5,11008.9,8,5548.0,5548.0,Grande
2235,2240,293340,6526,5656,448,3785,4233,1423,6410.92,5607.92,438.25,3756.92,4195.17,1412.75,76931,67295,5259,45083,50342,16953,2022,'WAGNER',Wagner,'BA',2933406,446.0,446,44.6,44.6,1,52.0,52.0,Pequeno I
2236,2241,293345,10788,9386,901,6678,7579,1807,10473.5,9189.58,786.08,6651.83,7437.92,1751.67,125682,110275,9433,79822,89255,21020,2022,'WANDERLEY',Wanderley,'BA',2933455,3042.0,3042,253.5,253.5,1,104.0,104.0,Pequeno I
2237,2242,293350,17707,16350,437,14283,14720,1630,18081.5,16831.75,382.25,15024.0,15406.25,1425.5,216978,201981,4587,180288,184875,17106,2022,'WENCESLAU GUIMARAES',Wenceslau Guimarães,'BA',2933505,14918.0,14918,1243.2,1243.2,2,1608.0,1608.0,Pequeno II
2238,2243,293360,40490,36975,1208,32237,33445,3530,40185.92,36918.83,1121.58,32491.17,33612.75,3306.08,482231,443026,13459,389894,403353,39673,2022,'XIQUE-XIQUE',Xique-xique,'BA',2933604,4144.0,4144,345.3,345.3,2,195.0,195.0,Pequeno II
2239,2244,310010,2511,2023,279,766,1045,978,2400.42,1921.83,244.08,721.67,965.75,956.08,28805,23062,2929,8660,11589,11473,2022,'ABADIA DOS DOURADOS',Abadia Dos Dourados,'MG',3100104,1441.0,1441,120.1,120.1,1,80.0,80.0,Pequeno I
2240,2245,310020,9299,7636,1431,2895,4326,3310,8506.42,7114.17,1330.33,2600.08,3930.42,3183.75,102077,85370,15964,31201,47165,38205,2022,'ABAETE',Abaeté,'MG',3100203,6640.0,6640,553.3,553.3,1,702.0,702.0,Pequeno II
2241,2246,310030,6141,5217,784,3243,4027,1190,5862.33,5002.42,731.25,3161.75,3893.0,1109.42,70348,60029,8775,37941,46716,13313,2022,'ABRE CAMPO',Abre Campo,'MG',3100302,1975.0,1975,164.6,164.6,1,30.0,30.0,Pequeno I
2242,2247,310040,2383,1995,228,1000,1228,767,2327.33,1980.0,239.92,973.33,1213.25,766.75,27928,23760,2879,11680,14559,9201,2022,'ACAIACA',Acaiaca,'MG',3100401,2940.0,2940,245.0,245.0,1,150.0,150.0,Pequeno I
2243,2248,310050,5038,4538,481,2954,3435,1103,4812.17,4391.75,415.67,2951.0,3366.67,1025.08,57746,52701,4988,35412,40400,12301,2022,'ACUCENA',Açucena,'MG',3100500,1740.0,1740,145.0,145.0,1,149.0,149.0,Pequeno I
2244,2249,310060,9417,8568,463,6462,6925,1643,9389.17,8657.75,428.25,6814.33,7242.58,1415.17,112670,103893,5139,81772,86911,16982,2022,'AGUA BOA',Água Boa,'MG',3100609,6844.0,11491,570.3,957.6,1,730.0,730.0,Pequeno I
2245,2250,310070,937,787,43,575,618,169,865.83,723.83,33.58,536.17,569.75,154.08,10390,8686,403,6434,6837,1849,2022,'AGUA COMPRIDA',Água Comprida,'MG',3100708,3056.0,3056,254.7,254.7,1,130.0,130.0,Pequeno I
2246,2251,310080,2325,1889,290,885,1175,714,2194.17,1793.5,259.0,864.25,1123.25,670.25,26330,21522,3108,10371,13479,8043,2022,'AGUANIL',Aguanil,'MG',3100807,927.0,927,77.2,77.2,1,75.0,75.0,Pequeno I
2247,2252,310090,13935,12198,598,9480,10078,2120,13359.25,11780.08,603.5,9127.33,9730.83,2049.25,160311,141361,7242,109528,116770,24591,2022,'AGUAS FORMOSAS',Águas Formosas,'MG',3100906,3910.0,12885,325.8,1073.8,1,775.0,775.0,Pequeno I
2248,2253,310100,10375,9220,369,7559,7928,1292,10163.92,9130.58,388.42,7493.83,7882.25,1248.33,121967,109567,4661,89926,94587,14980,2022,'AGUAS VERMELHAS',Águas Vermelhas,'MG',3101003,1719.0,1719,143.2,143.2,1,90.0,90.0,Pequeno I
2249,2254,310110,14034,11872,1792,6703,8495,3377,13425.58,11420.92,1849.83,6342.75,8192.58,3228.33,161107,137051,22198,76113,98311,38740,2022,'AIMORES',Aimorés,'MG',3101102,3157.0,3157,263.1,263.1,1,147.0,147.0,Pequeno II
2250,2255,310120,1876,1459,313,616,929,530,1714.33,1327.58,252.42,596.5,848.92,478.67,20572,15931,3029,7158,10187,5744,2022,'AIURUOCA',Aiuruoca,'MG',3101201,2165.0,2165,180.4,180.4,1,115.0,115.0,Pequeno I
2251,2256,310130,1201,1088,93,795,888,200,1100.5,1001.25,73.83,757.5,831.33,169.92,13206,12015,886,9090,9976,2039,2022,'ALAGOA',Alagoa,'MG',3101300,1194.0,1194,99.5,99.5,1,51.0,51.0,Pequeno I
2252,2257,310140,1084,938,214,433,647,291,955.83,828.75,177.42,376.08,553.5,275.25,11470,9945,2129,4513,6642,3303,2022,'ALBERTINA',Albertina,'MG',3101409,1027.0,1027,85.6,85.6,1,72.0,72.0,Pequeno I
2253,2258,310150,17659,14389,1549,7737,9286,5103,16739.33,13805.0,1515.42,7248.92,8764.33,5040.67,200872,165660,18185,86987,105172,60488,2022,'ALEM PARAIBA',Além Paraíba,'MG',3101508,24606.0,24606,2050.5,2050.5,3,2349.0,2349.0,Pequeno II
2254,2259,310160,28374,23773,4346,10821,15167,8606,25936.0,21859.0,3658.08,10001.5,13659.58,8199.42,311232,262308,43897,120018,163915,98393,2022,'ALFENAS',Alfenas,'MG',3101607,13636.0,13636,1136.3,1136.3,3,1328.0,1328.0,Médio
2255,2260,310163,3920,3253,820,770,1590,1663,3686.08,3117.5,736.83,851.92,1588.75,1528.75,44233,37410,8842,10223,19065,18345,2022,'ALFREDO VASCONCELOS',Alfredo Vasconcelos,'MG',3101631,4890.0,10892,407.5,907.7,1,845.0,845.0,Pequeno I
2256,2261,310170,26714,23289,2254,16189,18443,4846,25726.0,22568.0,2090.33,15875.25,17965.58,4602.42,308712,270816,25084,190503,215587,55229,2022,'ALMENARA',Almenara,'MG',3101706,9214.0,9214,767.8,767.8,2,619.0,619.0,Pequeno II
2257,2262,310180,5431,4352,534,2670,3204,1148,5185.5,4212.92,494.08,2620.17,3114.25,1098.67,62226,50555,5929,31442,37371,13184,2022,'ALPERCATA',Alpercata,'MG',3101805,6052.0,6052,504.3,504.3,2,439.0,439.0,Pequeno I
2258,2263,310190,8680,7520,1847,1417,3264,4256,8464.17,7477.33,1916.83,1545.75,3462.58,4014.75,101570,89728,23002,18549,41551,48177,2022,'ALPINOPOLIS',Alpinópolis,'MG',3101904,3759.0,3759,313.2,313.2,1,274.0,274.0,Pequeno I
2259,2264,310200,6349,5286,1249,2051,3300,1986,6249.83,5241.58,992.58,2320.67,3313.25,1928.33,74998,62899,11911,27848,39759,23140,2022,'ALTEROSA',Alterosa,'MG',3102001,2316.0,2316,193.0,193.0,1,322.0,322.0,Pequeno I
2260,2265,310205,3506,3072,433,1992,2425,647,3332.25,2932.58,392.08,1880.58,2272.67,659.92,39987,35191,4705,22567,27272,7919,2022,'ALTO CAPARAO',Alto Caparaó,'MG',3102050,3759.0,3759,313.2,313.2,1,277.0,277.0,Pequeno I
2261,2266,310210,7203,6201,315,4204,4519,1682,7070.17,6140.67,333.08,4197.25,4530.33,1610.33,84842,73688,3997,50367,54364,19324,2022,'ALTO RIO DOCE',Alto Rio Doce,'MG',3102100,3156.0,3156,350.7,350.7,1,,,Pequeno I
2262,2267,310220,3533,2839,282,1668,1950,889,3471.83,2848.58,242.75,1756.17,1998.92,849.67,41662,34183,2913,21074,23987,10196,2022,'ALVARENGA',Alvarenga,'MG',3102209,642.0,642,53.5,53.5,1,55.0,55.0,Pequeno I
2263,2268,310230,6842,5909,832,3433,4265,1644,6555.5,5686.08,738.83,3411.83,4150.67,1535.42,78666,68233,8866,40942,49808,18425,2022,'ALVINOPOLIS',Alvinópolis,'MG',3102308,4584.0,4584,416.7,416.7,1,,,Pequeno I
2264,2269,310240,3222,2893,203,1871,2074,819,3148.08,2857.92,198.5,1882.83,2081.33,776.58,37777,34295,2382,22594,24976,9319,2022,'ALVORADA DE MINAS',Alvorada de Minas,'MG',3102407,1806.0,1806,150.5,150.5,1,39.0,39.0,Pequeno I
2265,2270,310250,3219,2840,106,2213,2319,521,3058.42,2715.33,106.08,2104.83,2210.92,504.42,36701,32584,1273,25258,26531,6053,2022,'AMPARO DO SERRA',Amparo do Serra,'MG',3102506,678.0,678,56.5,56.5,1,51.0,51.0,Pequeno I
2266,2271,310260,11131,8366,2343,2334,4677,3689,9998.5,7650.92,2230.75,2260.92,4491.67,3159.25,119982,91811,26769,27131,53900,37911,2022,'ANDRADAS',Andradas,'MG',3102605,3932.0,3932,357.5,357.5,1,,,Pequeno II
2267,2272,310270,7020,6117,232,5093,5325,792,6994.17,6157.17,239.5,5159.33,5398.83,758.33,83930,73886,2874,61912,64786,9100,2022,'CACHOEIRA DE PAJEU',Cachoeira de Pajeú,'MG',3102704,1709.0,1709,142.4,142.4,1,63.0,63.0,Pequeno I
2268,2273,310280,6927,5906,369,4154,4523,1383,6503.75,5648.08,395.42,3906.0,4301.42,1346.67,78045,67777,4745,46872,51617,16160,2022,'ANDRELANDIA',Andrelândia,'MG',3102803,200.0,200,200.0,200.0,1,200.0,200.0,Pequeno I
2269,2274,310285,6328,5558,618,3370,3988,1570,6174.75,5523.83,593.17,3436.33,4029.5,1494.33,74097,66286,7118,41236,48354,17932,2022,'ANGELANDIA',Angelândia,'MG',3102852,618.0,618,51.5,51.5,1,40.0,40.0,Pequeno I
2270,2275,310290,4696,4129,581,2342,2923,1206,4193.08,3749.5,516.33,2200.83,2717.17,1032.33,50317,44994,6196,26410,32606,12388,2022,'ANTONIO CARLOS',Antônio Carlos,'MG',3102902,1936.0,1936,161.3,161.3,1,115.0,115.0,Pequeno I
2271,2276,310300,5154,4311,559,2055,2614,1697,4954.5,4343.83,563.42,2241.25,2804.67,1539.17,59454,52126,6761,26895,33656,18470,2022,'ANTONIO DIAS',Antônio Dias,'MG',3103009,5735.0,5735,477.9,477.9,1,281.0,281.0,Pequeno I
2272,2277,310310,881,667,121,318,439,228,844.83,646.42,110.67,328.42,439.08,207.33,10138,7757,1328,3941,5269,2488,2022,'ANTONIO PRADO DE MINAS',Antônio Prado de Minas,'MG',3103108,834.0,834,69.5,69.5,1,55.0,55.0,Pequeno I
2273,2278,310320,1367,1055,73,548,621,434,1357.75,1082.0,65.33,601.67,667.0,415.0,16293,12984,784,7220,8004,4980,2022,'ARACAI',Araçaí,'MG',3103207,616.0,616,51.3,51.3,1,54.0,54.0,Pequeno I
2274,2279,310330,1343,887,149,327,476,411,1289.25,880.5,130.67,339.83,470.5,410.0,15471,10566,1568,4078,5646,4920,2022,'ARACITABA',Aracitaba,'MG',3103306,795.0,795,66.2,66.2,1,39.0,39.0,Pequeno I
2275,2280,310340,23358,19442,2347,10065,12412,7030,22759.58,19360.0,2362.83,10323.83,12686.67,6673.33,273115,232320,28354,123886,152240,80080,2022,'ARACUAI',Araçuaí,'MG',3103405,5436.0,5436,453.0,453.0,2,453.0,453.0,Pequeno II
2276,2281,310350,38146,30363,5035,14926,19961,10402,35685.75,28698.42,4694.17,14231.08,18925.25,9773.17,428229,344381,56330,170773,227103,117278,2022,'ARAGUARI',Araguari,'MG',3103504,68363.0,68363,5696.9,5696.9,5,4476.0,4476.0,Grande
2277,2282,310360,1480,1311,69,844,913,398,1413.33,1255.75,66.08,797.92,864.0,391.75,16960,15069,793,9575,10368,4701,2022,'ARANTINA',Arantina,'MG',3103603,1331.0,1331,121.0,121.0,1,98.0,98.0,Pequeno I
2278,2283,310370,4274,3905,839,1335,2174,1731,4137.92,3812.67,775.5,1339.67,2115.17,1697.5,49655,45752,9306,16076,25382,20370,2022,'ARAPONGA',Araponga,'MG',3103702,3645.0,3645,303.8,303.8,1,228.0,228.0,Pequeno I
2279,2284,310375,2459,1972,581,599,1180,792,2310.75,1892.58,446.58,770.08,1216.67,675.92,27729,22711,5359,9241,14600,8111,2022,'ARAPORA',Araporã,'MG',3103751,2391.0,2391,199.2,199.2,1,120.0,120.0,Pequeno I
2280,2285,310380,997,693,67,354,421,272,960.25,669.42,67.92,336.67,404.58,264.83,11523,8033,815,4040,4855,3178,2022,'ARAPUA',Arapuá,'MG',3103801,1058.0,1058,88.2,88.2,1,77.0,77.0,Pequeno I
2281,2286,310390,2007,1730,339,662,1001,729,1781.08,1540.25,294.83,594.5,889.33,650.92,21373,18483,3538,7134,10672,7811,2022,'ARAUJOS',Araújos,'MG',3103900,2245.0,2245,187.1,187.1,1,196.0,196.0,Pequeno I
2282,2287,310400,34905,29163,2610,18395,21005,8158,32320.75,27177.42,2297.17,17292.17,19589.33,7588.08,387849,326129,27566,207506,235072,91057,2022,'ARAXA',Araxá,'MG',3104007,15993.0,15993,1332.8,1332.8,2,920.0,920.0,Médio
2283,2288,310410,3469,2363,304,868,1172,1191,3353.67,2271.17,283.17,817.67,1100.83,1170.33,40244,27254,3398,9812,13210,14044,2022,'ARCEBURGO',Arceburgo,'MG',3104106,1753.0,1753,146.1,146.1,1,176.0,176.0,Pequeno I
2284,2289,310420,15021,12188,1643,5817,7460,4728,13817.08,11288.42,1565.17,5361.67,6926.83,4361.58,165805,135461,18782,64340,83122,52339,2022,'ARCOS',Arcos,'MG',3104205,2075.0,2075,207.5,207.5,1,224.0,224.0,Pequeno II
2285,2290,310430,5361,4226,748,1560,2308,1918,5064.58,4000.08,681.17,1499.25,2180.42,1819.67,60775,48001,8174,17991,26165,21836,2022,'AREADO',Areado,'MG',3104304,3090.0,3090,257.5,257.5,1,303.0,303.0,Pequeno I
2286,2291,310440,1877,1420,229,616,845,575,1836.0,1439.92,187.5,679.5,867.0,572.92,22032,17279,2250,8154,10404,6875,2022,'ARGIRITA',Argirita,'MG',3104403,2328.0,2328,194.0,194.0,1,389.0,389.0,Pequeno I
2287,2292,310445,4160,3385,217,2314,2531,854,4089.42,3347.83,246.58,2258.0,2504.58,843.25,49073,40174,2959,27096,30055,10119,2022,'ARICANDUVA',Aricanduva,'MG',3104452,821.0,821,74.6,74.6,1,58.0,58.0,Pequeno I
2288,2293,310450,12568,10432,800,7500,8300,2132,12096.42,10191.58,698.58,7550.83,8249.42,1942.17,145157,122299,8383,90610,98993,23306,2022,'ARINOS',Arinos,'MG',3104502,2789.0,2789,232.4,232.4,2,228.0,228.0,Pequeno I
2289,2294,310460,5339,4253,594,1105,1699,2554,5125.83,4268.5,621.33,1405.75,2027.08,2241.42,61510,51222,7456,16869,24325,26897,2022,'ASTOLFO DUTRA',Astolfo Dutra,'MG',3104601,6257.0,6257,521.4,521.4,1,419.0,419.0,Pequeno I
2290,2295,310470,8662,7396,960,4703,5663,1733,8609.33,7403.83,814.92,4980.5,5795.42,1608.42,103312,88846,9779,59766,69545,19301,2022,'ATALEIA',Ataléia,'MG',3104700,2188.0,2188,182.3,182.3,1,539.0,539.0,Pequeno I
2291,2296,310480,2893,2389,354,1271,1625,764,2793.75,2348.17,330.33,1292.5,1622.83,725.33,33525,28178,3964,15510,19474,8704,2022,'AUGUSTO DE LIMA',Augusto de Lima,'MG',3104809,3303.0,3303,275.2,275.2,1,110.0,110.0,Pequeno I
2292,2297,310490,9028,7714,1182,3868,5050,2664,8536.58,7409.17,1078.83,3872.67,4951.5,2457.67,102439,88910,12946,46472,59418,29492,2022,'BAEPENDI',Baependi,'MG',3104908,1651.0,1651,137.6,137.6,2,38.0,38.0,Pequeno I
2293,2298,310500,4469,3834,536,2319,2855,979,4204.75,3606.83,575.33,2080.08,2655.42,951.42,50457,43282,6904,24961,31865,11417,2022,'BALDIM',Baldim,'MG',3105004,6125.0,7202,510.4,600.2,1,279.0,279.0,Pequeno I
2294,2299,310510,6960,5541,1057,2334,3391,2150,6465.17,5140.0,889.0,2276.17,3165.17,1974.83,77582,61680,10668,27314,37982,23698,2022,'BAMBUI',Bambuí,'MG',3105103,1313.0,1313,119.4,119.4,1,66.0,66.0,Pequeno II
2295,2300,310520,3250,2506,404,1152,1556,950,3198.5,2524.25,400.42,1236.5,1636.92,887.33,38382,30291,4805,14838,19643,10648,2022,'BANDEIRA',Bandeira,'MG',3105202,4640.0,4640,386.7,386.7,1,162.0,162.0,Pequeno I
2296,2301,310530,2470,2021,348,669,1017,1004,2229.92,1804.67,334.33,569.0,903.33,901.33,26759,21656,4012,6828,10840,10816,2022,'BANDEIRA DO SUL',Bandeira do Sul,'MG',3105301,2040.0,2040,170.0,170.0,1,137.0,137.0,Pequeno I
2297,2302,310540,9620,8290,1627,3387,5014,3276,9349.75,8161.0,1531.08,3641.75,5172.83,2988.17,112197,97932,18373,43701,62074,35858,2022,'BARAO DE COCAIS',Barão de Cocais,'MG',3105400,1806.0,1806,150.5,150.5,1,95.0,95.0,Pequeno II
2298,2303,310550,3458,2726,245,1582,1827,899,3379.42,2706.58,243.5,1561.17,1804.67,901.92,40553,32479,2922,18734,21656,10823,2022,'BARAO DO MONTE ALTO',Barão de Monte Alto,'MG',3105509,4645.0,4645,387.1,387.1,1,368.0,368.0,Pequeno I
2299,2304,310560,50201,40136,5304,18129,23433,16703,46896.0,37694.92,4978.17,16715.67,21693.83,16001.08,562752,452339,59738,200588,260326,192013,2022,'BARBACENA',Barbacena,'MG',3105608,14646.0,14646,1220.5,1220.5,2,1132.0,1132.0,Grande
2300,2305,310570,3255,2824,177,2263,2440,384,3045.58,2664.42,168.08,2105.0,2273.08,391.33,36547,31973,2017,25260,27277,4696,2022,'BARRA LONGA',Barra Longa,'MG',3105707,5207.0,5207,433.9,433.9,1,435.0,435.0,Pequeno I
2301,2306,310590,12449,10464,800,5859,6659,3805,12058.17,10267.5,729.42,5893.75,6623.17,3644.33,144698,123210,8753,70725,79478,43732,2022,'BARROSO',Barroso,'MG',3105905,1112.0,1112,92.7,92.7,1,52.0,52.0,Pequeno I
2302,2307,310600,4511,3875,521,1894,2415,1460,4332.08,3747.42,517.92,1866.67,2384.58,1362.83,51985,44969,6215,22400,28615,16354,2022,'BELA VISTA DE MINAS',Bela Vista de Minas,'MG',3106002,4248.0,4248,354.0,354.0,2,475.0,475.0,Pequeno I
2303,2308,310610,1533,1108,304,196,500,608,1460.92,1108.83,348.42,221.17,569.58,539.25,17531,13306,4181,2654,6835,6471,2022,'BELMIRO BRAGA',Belmiro Braga,'MG',3106101,1920.0,1920,160.0,160.0,1,61.0,61.0,Pequeno I
2304,2309,310620,651825,531652,63916,284087,348003,183649,587034.33,483430.83,59954.25,253800.0,313754.25,169676.58,7044412,5801170,719451,3045600,3765051,2036119,2022,'BELO HORIZONTE',Belo Horizonte,'MG',3106200,63209.0,63209,5267.4,5267.4,34,3599.0,3599.0,Metrópole
2305,2310,310630,14333,11651,1498,6475,7973,3678,13803.5,11459.92,1397.0,6556.75,7953.75,3506.17,165642,137519,16764,78681,95445,42074,2022,'BELO ORIENTE',Belo Oriente,'MG',3106309,7646.0,7646,637.2,637.2,1,945.0,945.0,Pequeno II
2306,2311,310640,4381,3789,371,2426,2797,992,4085.75,3566.75,430.17,2117.08,2547.25,1019.5,49029,42801,5162,25405,30567,12234,2022,'BELO VALE',Belo Vale,'MG',3106408,6291.0,6291,571.9,571.9,1,,,Pequeno I
2307,2312,310650,7091,5670,445,3186,3631,2039,7035.67,5714.83,487.08,3398.33,3885.42,1829.42,84428,68578,5845,40780,46625,21953,2022,'BERILO',Berilo,'MG',3106507,2040.0,2040,170.0,170.0,2,96.0,96.0,Pequeno I
2308,2313,310660,4068,3623,63,3126,3189,434,3965.0,3559.42,82.42,3081.83,3164.25,395.17,47580,42713,989,36982,37971,4742,2022,'BERTOPOLIS',Bertópolis,'MG',3106606,2120.0,2120,176.7,176.7,1,173.0,173.0,Pequeno I
2309,2314,310665,3765,3386,149,2685,2834,552,3730.33,3366.17,104.92,2725.58,2830.5,535.67,44764,40394,1259,32707,33966,6428,2022,'BERIZAL',Berizal,'MG',3106655,538.0,538,44.8,44.8,1,30.0,30.0,Pequeno I
2310,2315,310670,189076,166490,17235,108354,125589,40901,174854.42,156052.67,15086.33,104023.25,119109.58,36943.08,2098253,1872632,181036,1248279,1429315,443317,2022,'BETIM',Betim,'MG',3106705,198622.0,208594,16551.8,17382.8,16,13307.0,13307.0,Grande
2311,2316,310680,2037,1790,71,1420,1491,299,1955.42,1735.83,86.58,1386.25,1472.83,263.0,23465,20830,1039,16635,17674,3156,2022,'BIAS FORTES',Bias Fortes,'MG',3106804,922.0,922,76.8,76.8,1,61.0,61.0,Pequeno I
2312,2317,310690,6617,5444,567,3465,4032,1412,6116.33,5075.08,476.83,3167.25,3644.08,1431.0,73396,60901,5722,38007,43729,17172,2022,'BICAS',Bicas,'MG',3106903,4846.0,4846,403.8,403.8,1,342.0,342.0,Pequeno I
2313,2318,310700,1224,1045,28,845,873,172,1160.33,1008.08,23.08,784.58,807.67,200.42,13924,12097,277,9415,9692,2405,2022,'BIQUINHAS',Biquinhas,'MG',3107000,761.0,761,63.4,63.4,1,77.0,77.0,Pequeno I
2314,2319,310710,19851,16601,4258,2384,6642,9959,18828.5,15903.5,3932.25,2694.17,6626.42,9277.08,225942,190842,47187,32330,79517,111325,2022,'BOA ESPERANCA',Boa Esperança,'MG',3107109,5459.0,5459,454.9,454.9,2,299.0,299.0,Pequeno II
2315,2320,310720,2916,2531,123,1844,1967,564,2757.25,2417.42,116.75,1767.25,1884.0,533.42,33087,29009,1401,21207,22608,6401,2022,'BOCAINA DE MINAS',Bocaina de Minas,'MG',3107208,2286.0,2286,190.5,190.5,1,136.0,136.0,Pequeno I
2316,2321,310730,29503,26542,1562,18755,20317,6225,28608.5,25972.17,1344.17,18946.75,20290.92,5681.25,343302,311666,16130,227361,243491,68175,2022,'BOCAIUVA',Bocaiúva,'MG',3107307,25848.0,25848,2154.0,2154.0,4,1782.0,1782.0,Pequeno II
2317,2322,310740,21127,17268,2439,7761,10200,7068,19916.08,16235.08,2369.08,6880.83,9249.92,6985.17,238993,194821,28429,82570,110999,83822,2022,'BOM DESPACHO',Bom Despacho,'MG',3107406,15031.0,15031,1252.6,1252.6,4,1076.0,1076.0,Pequeno II
2318,2323,310750,3560,2977,332,1610,1942,1035,3380.25,2879.25,255.75,1631.17,1886.92,992.33,40563,34551,3069,19574,22643,11908,2022,'BOM JARDIM DE MINAS',Bom Jardim de Minas,'MG',3107505,6142.0,6142,511.8,511.8,1,526.0,526.0,Pequeno I
2319,2324,310760,1992,1608,137,1000,1137,471,1922.58,1571.92,118.17,974.67,1092.83,479.08,23071,18863,1418,11696,13114,5749,2022,'BOM JESUS DA PENHA',Bom Jesus da Penha,'MG',3107604,3452.0,3452,313.8,313.8,1,121.0,121.0,Pequeno I
2320,2325,310770,3269,2631,409,1099,1508,1123,3145.42,2569.67,392.17,1091.33,1483.5,1086.17,37745,30836,4706,13096,17802,13034,2022,'BOM JESUS DO AMPARO',Bom Jesus do Amparo,'MG',3107703,675.0,675,112.5,112.5,1,107.0,107.0,Pequeno I
2321,2326,310780,10697,9280,729,6491,7220,2060,10581.25,9382.5,563.42,6991.67,7555.08,1827.42,126975,112590,6761,83900,90661,21929,2022,'BOM JESUS DO GALHO',Bom Jesus do Galho,'MG',3107802,4035.0,4035,336.2,336.2,1,266.0,266.0,Pequeno I
2322,2327,310790,6590,5889,1442,1161,2603,3286,6266.92,5655.42,1426.0,1057.83,2483.83,3171.58,75203,67865,17112,12694,29806,38059,2022,'BOM REPOUSO',Bom Repouso,'MG',3107901,4667.0,4667,388.9,388.9,1,358.0,358.0,Pequeno I
2323,2328,310800,7890,6309,1568,337,1905,4404,7613.17,6186.83,1681.25,376.25,2057.5,4129.33,91358,74242,20175,4515,24690,49552,2022,'BOM SUCESSO',Bom Sucesso,'MG',3108008,716.0,716,59.7,59.7,1,39.0,39.0,Pequeno I
2324,2329,310810,3940,3447,209,2473,2682,765,3637.08,3216.67,163.67,2312.5,2476.17,740.5,43645,38600,1964,27750,29714,8886,2022,'BONFIM',Bonfim,'MG',3108107,1680.0,1680,140.0,140.0,1,31.0,31.0,Pequeno I
2325,2330,310820,3390,2388,439,639,1078,1310,3230.33,2399.25,479.08,658.25,1137.33,1261.92,38764,28791,5749,7899,13648,15143,2022,'BONFINOPOLIS DE MINAS',Bonfinópolis de Minas,'MG',3108206,2400.0,2400,218.2,218.2,1,91.0,91.0,Pequeno I
2326,2331,310825,8117,7082,223,5603,5826,1256,8007.08,7048.5,291.58,5613.08,5904.67,1143.83,96085,84582,3499,67357,70856,13726,2022,'BONITO DE MINAS',Bonito de Minas,'MG',3108255,408.0,408,34.0,34.0,1,34.0,34.0,Pequeno I
2327,2332,310830,6468,5363,1090,2396,3486,1877,6104.75,5091.17,1043.58,2189.42,3233.0,1858.17,73257,61094,12523,26273,38796,22298,2022,'BORDA DA MATA',Borda da Mata,'MG',3108305,3045.0,3045,253.8,253.8,1,177.0,177.0,Pequeno I
2328,2333,310840,6937,5796,1366,1611,2977,2819,6555.33,5508.17,1304.67,1585.08,2889.75,2618.42,78664,66098,15656,19021,34677,31421,2022,'BOTELHOS',Botelhos,'MG',3108404,0.0,27092,0.0,2257.7,1,0.0,2237.0,Pequeno I
2329,2334,310850,4016,3571,208,2387,2595,976,3996.0,3590.42,203.67,2566.0,2769.67,820.75,47952,43085,2444,30792,33236,9849,2022,'BOTUMIRIM',Botumirim,'MG',3108503,521.0,521,43.4,43.4,1,25.0,25.0,Pequeno I
2330,2335,310855,9454,8139,617,5736,6353,1786,8961.42,7722.42,546.92,5467.42,6014.33,1708.08,107537,92669,6563,65609,72172,20497,2022,'BRASILANDIA DE MINAS',Brasilândia de Minas,'MG',3108552,5683.0,5683,473.6,473.6,1,850.0,850.0,Pequeno I
2331,2336,310860,21537,18647,2056,11220,13276,5371,20986.67,18334.42,1886.75,11361.08,13247.83,5086.58,251840,220013,22641,136333,158974,61039,2022,'BRASILIA DE MINAS',Brasília de Minas,'MG',3108602,2727.0,2727,227.2,227.2,2,70.0,70.0,Pequeno II
2332,2337,310870,2487,2161,141,1476,1617,544,2412.92,2109.08,159.33,1490.5,1649.83,459.25,28955,25309,1912,17886,19798,5511,2022,'BRAS PIRES',Brás Pires,'MG',3108701,481.0,481,40.1,40.1,1,48.0,48.0,Pequeno I
2333,2338,310880,2975,2403,315,1296,1611,792,2984.08,2485.08,310.33,1404.33,1714.67,770.42,35809,29821,3724,16852,20576,9245,2022,'BRAUNAS',Braúnas,'MG',3108800,990.0,990,165.0,165.0,1,143.0,143.0,Pequeno I
2334,2339,310890,7325,5393,1104,731,1835,3558,7008.25,5267.25,1131.92,737.83,1869.75,3397.5,84099,63207,13583,8854,22437,40770,2022,'BRASOPOLIS',Brasópolis,'MG',3108909,644.0,644,53.7,53.7,1,45.0,45.0,Pequeno I
2335,2340,310900,13523,10737,2268,4084,6352,4385,12449.5,9879.0,1870.33,3940.33,5810.67,4068.33,149394,118548,22444,47284,69728,48820,2022,'BRUMADINHO',Brumadinho,'MG',3109006,13769.0,13769,1147.4,1147.4,2,659.0,659.0,Pequeno II
2336,2341,310910,6066,4741,740,1153,1893,2848,5818.08,4662.25,714.58,1118.42,1833.0,2829.25,69817,55947,8575,13421,21996,33951,2022,'BUENO BRANDAO',Bueno Brandão,'MG',3109105,4890.0,4890,407.5,407.5,1,494.0,494.0,Pequeno I
2337,2342,310920,5396,4554,636,2732,3368,1186,5275.58,4516.33,525.33,2819.58,3344.92,1171.42,63307,54196,6304,33835,40139,14057,2022,'BUENOPOLIS',Buenópolis,'MG',3109204,4189.0,4189,349.1,349.1,1,240.0,240.0,Pequeno I
2338,2343,310925,3005,2569,154,1813,1967,602,2900.08,2528.08,159.33,1837.17,1996.5,531.58,34801,30337,1912,22046,23958,6379,2022,'BUGRE',Bugre,'MG',3109253,1781.0,1781,161.9,161.9,1,,,Pequeno I
2339,2344,310930,15656,12458,2460,6036,8496,3962,15412.5,12491.83,2360.17,6243.5,8603.67,3888.17,184950,149902,28322,74922,103244,46658,2022,'BURITIS',Buritis,'MG',3109303,5362.0,5362,446.8,446.8,1,324.0,324.0,Pequeno II
2340,2345,310940,17578,15278,741,11563,12304,2974,17017.83,14947.25,657.0,11573.25,12230.25,2717.0,204214,179367,7884,138879,146763,32604,2022,'BURITIZEIRO',Buritizeiro,'MG',3109402,2708.0,2708,225.7,225.7,1,305.0,305.0,Pequeno II
2341,2346,310945,3806,3187,436,1716,2152,1035,3668.67,3120.75,435.08,1741.75,2176.83,943.92,44024,37449,5221,20901,26122,11327,2022,'CABECEIRA GRANDE',Cabeceira Grande,'MG',3109451,6628.0,6628,552.3,552.3,2,523.0,523.0,Pequeno I
2342,2347,310950,6211,4345,840,910,1750,2595,6028.17,4412.08,849.67,1074.92,1924.58,2487.5,72338,52945,10196,12899,23095,29850,2022,'CABO VERDE',Cabo Verde,'MG',3109501,4871.0,4871,405.9,405.9,1,317.0,317.0,Pequeno I
2343,2348,310960,2180,1443,243,360,603,840,2097.58,1429.33,251.67,347.0,598.67,830.67,25171,17152,3020,4164,7184,9968,2022,'CACHOEIRA DA PRATA',Cachoeira da Prata,'MG',3109600,1777.0,1777,148.1,148.1,1,151.0,151.0,Pequeno I
2344,2349,310970,3973,3103,812,556,1368,1735,3792.58,3027.25,790.17,569.17,1359.33,1667.92,45511,36327,9482,6830,16312,20015,2022,'CACHOEIRA DE MINAS',Cachoeira de Minas,'MG',3109709,1965.0,1965,163.8,163.8,1,133.0,133.0,Pequeno I
2345,2350,310980,889,586,61,273,334,252,857.92,566.75,56.33,275.42,331.75,235.0,10295,6801,676,3305,3981,2820,2022,'CACHOEIRA DOURADA',Cachoeira Dourada,'MG',3109808,884.0,884,73.7,73.7,1,85.0,85.0,Pequeno I
2346,2351,310990,4393,3815,508,2106,2614,1201,4121.08,3596.33,468.42,2032.17,2500.58,1095.75,49453,43156,5621,24386,30007,13149,2022,'CAETANOPOLIS',Caetanópolis,'MG',3109907,2444.0,2444,203.7,203.7,1,53.0,53.0,Pequeno I
2347,2352,311000,13080,10949,2108,5513,7621,3328,12163.92,10287.83,2007.75,5126.58,7134.33,3153.5,145967,123454,24093,61519,85612,37842,2022,'CAETE',Caeté,'MG',3110004,9869.0,9869,822.4,822.4,3,1359.0,1359.0,Pequeno II
2348,2353,311010,2939,2553,587,1288,1875,678,2860.83,2515.25,576.83,1309.17,1886.0,629.25,34330,30183,6922,15710,22632,7551,2022,'CAIANA',Caiana,'MG',3110103,2262.0,2262,188.5,188.5,1,150.0,150.0,Pequeno I
2349,2354,311020,3333,2471,223,1286,1509,962,3218.17,2441.5,185.83,1284.5,1470.33,971.17,38618,29298,2230,15414,17644,11654,2022,'CAJURI',Cajuri,'MG',3110202,5812.0,5812,484.3,484.3,1,295.0,295.0,Pequeno I
2350,2355,311030,5285,4243,1173,1590,2763,1480,4979.67,4034.92,1027.33,1619.42,2646.75,1388.17,59756,48419,12328,19433,31761,16658,2022,'CALDAS',Caldas,'MG',3110301,1192.0,1192,99.3,99.3,1,88.0,88.0,Pequeno I
2351,2357,311050,8766,7360,1308,3414,4722,2638,8364.0,7109.33,1205.0,3446.08,4651.08,2458.25,100368,85312,14460,41353,55813,29499,2022,'CAMANDUCAIA',Camanducaia,'MG',3110509,2956.0,2956,246.3,246.3,1,220.0,220.0,Pequeno II
2352,2358,311060,10339,8287,1199,3410,4609,3678,9562.42,7813.25,1138.92,3189.67,4328.58,3484.67,114749,93759,13667,38276,51943,41816,2022,'CAMBUI',Cambuí,'MG',3110608,1891.0,1891,157.6,157.6,1,123.0,123.0,Pequeno II
2353,2359,311070,6849,5526,952,2598,3550,1976,6493.75,5316.92,805.17,2655.42,3460.58,1856.33,77925,63803,9662,31865,41527,22276,2022,'CAMBUQUIRA',Cambuquira,'MG',3110707,4621.0,4621,385.1,385.1,2,320.0,320.0,Pequeno I
2354,2360,311080,2804,2365,113,1745,1858,507,2766.33,2371.67,134.08,1758.92,1893.0,478.67,33196,28460,1609,21107,22716,5744,2022,'CAMPANARIO',Campanário,'MG',3110806,2126.0,2126,177.2,177.2,1,132.0,132.0,Pequeno I
2355,2361,311090,8004,7067,1704,2125,3829,3238,7776.25,6895.92,1540.67,2292.0,3832.67,3063.25,93315,82751,18488,27504,45992,36759,2022,'CAMPANHA',Campanha,'MG',3110905,3245.0,3245,270.4,270.4,1,207.0,207.0,Pequeno I
2356,2362,311100,7908,5856,1267,1374,2641,3215,7512.67,5558.58,1217.17,1303.42,2520.58,3038.0,90152,66703,14606,15641,30247,36456,2022,'CAMPESTRE',Campestre,'MG',3111002,2532.0,2532,211.0,211.0,1,112.0,112.0,Pequeno II
2357,2363,311110,9047,5863,1323,1083,2406,3457,8660.0,5831.08,1234.92,1539.08,2774.0,3057.08,103920,69973,14819,18469,33288,36685,2022,'CAMPINA VERDE',Campina Verde,'MG',3111101,4792.0,4792,399.3,399.3,1,223.0,223.0,Pequeno I
2358,2364,311115,3350,2969,92,2496,2588,381,3252.67,2913.33,94.75,2426.42,2521.17,392.17,39032,34960,1137,29117,30254,4706,2022,'CAMPO AZUL',Campo Azul,'MG',3111150,1417.0,1417,118.1,118.1,1,206.0,206.0,Pequeno I
2359,2365,311120,21395,17637,3022,6411,9433,8204,20187.5,16885.25,2787.42,6070.5,8857.92,8027.33,242250,202623,33449,72846,106295,96328,2022,'CAMPO BELO',Campo Belo,'MG',3111200,17151.0,17151,1429.2,1429.2,3,1413.0,1413.0,Médio
2360,2366,311130,5609,4864,580,2640,3220,1644,5352.42,4662.83,482.58,2652.58,3135.17,1527.67,64229,55954,5791,31831,37622,18332,2022,'CAMPO DO MEIO',Campo do Meio,'MG',3111309,2601.0,2601,236.5,236.5,1,,,Pequeno I
2361,2367,311140,4421,3830,468,2388,2856,974,4172.08,3637.58,395.83,2385.08,2780.92,856.67,50065,43651,4750,28621,33371,10280,2022,'CAMPO FLORIDO',Campo Florido,'MG',3111408,6108.0,6108,509.0,509.0,2,321.0,321.0,Pequeno I
2362,2368,311150,5119,4407,667,2194,2861,1546,5002.75,4356.58,649.42,2234.75,2884.17,1472.42,60033,52279,7793,26817,34610,17669,2022,'CAMPOS ALTOS',Campos Altos,'MG',3111507,458.0,458,38.2,38.2,1,29.0,29.0,Pequeno I
2363,2369,311160,13172,10764,2136,4082,6218,4546,12506.5,10313.25,2136.67,3975.83,6112.5,4200.75,150078,123759,25640,47710,73350,50409,2022,'CAMPOS GERAIS',Campos Gerais,'MG',3111606,2512.0,2512,209.3,209.3,1,600.0,600.0,Pequeno II
2364,2370,311170,2691,2426,162,1586,1748,678,2565.0,2318.75,154.58,1541.33,1695.92,622.83,30780,27825,1855,18496,20351,7474,2022,'CANAA',Canaã,'MG',3111705,3414.0,3414,284.5,284.5,1,292.0,292.0,Pequeno I
2365,2371,311180,3875,2985,439,1553,1992,993,3558.42,2751.33,430.92,1448.83,1879.75,871.58,42701,33016,5171,17386,22557,10459,2022,'CANAPOLIS',Canápolis,'MG',3111804,3348.0,3348,279.0,279.0,1,242.0,242.0,Pequeno I
2366,2372,311190,2762,2216,363,791,1154,1062,2640.0,2147.67,365.83,751.25,1117.08,1030.58,31680,25772,4390,9015,13405,12367,2022,'CANA VERDE',Cana Verde,'MG',3111903,1775.0,1775,147.9,147.9,1,130.0,130.0,Pequeno I
2367,2373,311200,6786,5505,1116,2002,3118,2387,6474.42,5237.67,1008.83,1907.75,2916.58,2321.08,77693,62852,12106,22893,34999,27853,2022,'CANDEIAS',Candeias,'MG',3112000,1857.0,1857,154.8,154.8,1,57.0,57.0,Pequeno I
2368,2374,311205,2938,2519,120,1546,1666,853,2824.25,2485.0,129.17,1556.92,1686.08,798.92,33891,29820,1550,18683,20233,9587,2022,'CANTAGALO',Cantagalo,'MG',3112059,2204.0,2204,183.7,183.7,1,143.0,143.0,Pequeno I
2369,2375,311210,3339,3129,354,2242,2596,533,3244.33,3054.08,308.17,2265.25,2573.42,480.67,38932,36649,3698,27183,30881,5768,2022,'CAPARAO',Caparaó,'MG',3112109,1033.0,1033,86.1,86.1,1,38.0,38.0,Pequeno I
2370,2376,311220,2438,2192,84,1586,1670,522,2341.0,2104.5,96.42,1475.83,1572.25,532.25,28092,25254,1157,17710,18867,6387,2022,'CAPELA NOVA',Capela Nova,'MG',3112208,1601.0,1601,133.4,133.4,1,91.0,91.0,Pequeno I
2371,2377,311230,26390,21222,4302,7523,11825,9397,25494.75,21092.83,3827.92,8268.5,12096.42,8996.42,305937,253114,45935,99222,145157,107957,2022,'CAPELINHA',Capelinha,'MG',3112307,30312.0,30312,2526.0,2526.0,3,2231.0,2231.0,Pequeno II
2372,2378,311240,3182,2767,478,1423,1901,866,3021.17,2642.67,483.42,1314.83,1798.25,844.42,36254,31712,5801,15778,21579,10133,2022,'CAPETINGA',Capetinga,'MG',3112406,1824.0,1824,152.0,152.0,1,87.0,87.0,Pequeno I
2373,2379,311250,4145,3481,721,1233,1954,1527,3901.25,3317.58,661.08,1208.67,1869.75,1447.83,46815,39811,7933,14504,22437,17374,2022,'CAPIM BRANCO',Capim Branco,'MG',3112505,2246.0,2246,249.6,249.6,1,304.0,304.0,Pequeno I
2374,2380,311260,7431,5538,827,2334,3161,2377,7212.83,5414.42,796.75,2322.92,3119.67,2294.75,86554,64973,9561,27875,37436,27537,2022,'CAPINOPOLIS',Capinópolis,'MG',3112604,6880.0,7902,573.3,658.5,1,679.0,679.0,Pequeno I
2375,2381,311265,3633,2890,150,2088,2238,652,3559.58,2910.83,154.67,2083.75,2238.42,672.42,42715,34930,1856,25005,26861,8069,2022,'CAPITAO ANDRADE',Capitão Andrade,'MG',3112653,2185.0,2185,182.1,182.1,1,160.0,160.0,Pequeno I
2376,2382,311270,9807,8932,766,5797,6563,2369,9465.0,8723.58,718.5,5958.17,6676.67,2046.92,113580,104683,8622,71498,80120,24563,2022,'CAPITAO ENEAS',Capitão Enéas,'MG',3112703,1737.0,1737,144.8,144.8,1,118.0,118.0,Pequeno I
2377,2383,311280,3681,2542,638,539,1177,1365,3360.33,2263.58,541.33,451.08,992.42,1271.17,40324,27163,6496,5413,11909,15254,2022,'CAPITOLIO',Capitólio,'MG',3112802,8592.0,8592,716.0,716.0,1,524.0,524.0,Pequeno I
2378,2384,311290,6028,5575,382,3587,3969,1606,5948.08,5545.42,373.5,3722.92,4096.42,1449.0,71377,66545,4482,44675,49157,17388,2022,'CAPUTIRA',Caputira,'MG',3112901,3341.0,3341,278.4,278.4,1,275.0,275.0,Pequeno I
2379,2385,311300,13345,11771,609,9289,9898,1873,13352.83,11847.58,679.92,9375.75,10055.67,1791.92,160234,142171,8159,112509,120668,21503,2022,'CARAI',Caraí,'MG',3113008,4715.0,4715,392.9,392.9,1,719.0,719.0,Pequeno II
2380,2386,311310,1702,1510,124,899,1023,487,1678.83,1501.25,103.0,947.08,1050.08,451.17,20146,18015,1236,11365,12601,5414,2022,'CARANAIBA',Caranaíba,'MG',3113107,845.0,845,70.4,70.4,1,44.0,44.0,Pequeno I
2381,2387,311320,10576,9350,1029,4392,5421,3929,10439.08,9405.5,1047.0,4602.08,5649.08,3756.42,125269,112866,12564,55225,67789,45077,2022,'CARANDAI',Carandaí,'MG',3113206,798.0,798,66.5,66.5,1,87.0,87.0,Pequeno II
2382,2388,311330,16770,14202,1660,7485,9145,5057,16054.83,13815.83,1401.67,7937.92,9339.58,4476.25,192658,165790,16820,95255,112075,53715,2022,'CARANGOLA',Carangola,'MG',3113305,3712.0,3712,309.3,309.3,2,198.0,198.0,Pequeno II
2383,2389,311340,33715,28845,6665,8722,15387,13458,32383.5,28023.33,6576.75,9009.0,15585.75,12437.58,388602,336280,78921,108108,187029,149251,2022,'CARATINGA',Caratinga,'MG',3113404,14283.0,14283,1428.3,1428.3,3,1474.0,1474.0,Médio
2384,2390,311350,6383,4992,687,2094,2781,2211,6255.33,4981.5,574.83,2374.58,2949.42,2032.08,75064,59778,6898,28495,35393,24385,2022,'CARBONITA',Carbonita,'MG',3113503,2090.0,2090,174.2,174.2,1,198.0,198.0,Pequeno I
2385,2391,311360,3099,2553,739,1082,1821,732,2945.75,2419.67,688.0,983.42,1671.42,748.25,35349,29036,8256,11801,20057,8979,2022,'CAREACU',Careaçu,'MG',3113602,1954.0,1954,162.8,162.8,1,141.0,141.0,Pequeno I
2386,2392,311370,12719,10280,1409,5270,6679,3601,12416.5,10207.33,1228.33,5623.08,6851.42,3355.92,148998,122488,14740,67477,82217,40271,2022,'CARLOS CHAGAS',Carlos Chagas,'MG',3113701,1930.0,1930,160.8,160.8,1,174.0,174.0,Pequeno II
2387,2393,311380,1371,1126,186,539,725,401,1296.58,1067.75,184.08,528.75,712.83,354.92,15559,12813,2209,6345,8554,4259,2022,'CARMESIA',Carmésia,'MG',3113800,1501.0,1501,125.1,125.1,1,138.0,138.0,Pequeno I
2388,2394,311390,5913,5317,2282,1109,3391,1926,5684.25,5156.42,2396.17,1176.42,3572.58,1583.83,68211,61877,28754,14117,42871,19006,2022,'CARMO DA CACHOEIRA',Carmo da Cachoeira,'MG',3113909,1140.0,1140,95.0,95.0,1,78.0,78.0,Pequeno I
2389,2395,311400,4988,3922,707,1004,1711,2211,4756.5,3821.58,693.67,967.17,1660.83,2160.75,57078,45859,8324,11606,19930,25929,2022,'CARMO DA MATA',Carmo da Mata,'MG',3114006,4845.0,4845,403.8,403.8,1,452.0,452.0,Pequeno I
2390,2396,311410,6261,5460,939,2479,3418,2042,5992.83,5298.33,843.92,2759.58,3603.5,1694.83,71914,63580,10127,33115,43242,20338,2022,'CARMO DE MINAS',Carmo de Minas,'MG',3114105,2736.0,2736,228.0,228.0,1,248.0,248.0,Pequeno I
2391,2397,311420,5325,4393,1004,1143,2147,2246,5037.0,4187.25,973.75,1150.25,2124.0,2063.25,60444,50247,11685,13803,25488,24759,2022,'CARMO DO CAJURU',Carmo do Cajuru,'MG',3114204,3524.0,3524,293.7,293.7,1,334.0,334.0,Pequeno II
2392,2398,311430,13560,10008,1523,3825,5348,4660,12858.25,9670.83,1432.33,3848.08,5280.42,4390.42,154299,116050,17188,46177,63365,52685,2022,'CARMO DO PARANAIBA',Carmo do Paranaíba,'MG',3114303,6569.0,6569,547.4,547.4,1,338.0,338.0,Pequeno II
2393,2399,311440,9590,8053,2873,1310,4183,3870,9090.0,7798.5,2488.83,1709.08,4197.92,3600.58,109080,93582,29866,20509,50375,43207,2022,'CARMO DO RIO CLARO',Carmo do Rio Claro,'MG',3114402,3289.0,3289,274.1,274.1,1,164.0,164.0,Pequeno II
2394,2400,311450,7982,5636,1608,972,2580,3056,6882.17,5266.33,1538.5,982.67,2521.17,2745.17,82586,63196,18462,11792,30254,32942,2022,'CARMOPOLIS DE MINAS',Carmópolis de Minas,'MG',3114501,1371.0,1371,114.2,114.2,1,84.0,84.0,Pequeno I
2395,2401,311455,2808,2259,245,1306,1551,708,2612.08,2100.83,256.25,1193.83,1450.08,650.75,31345,25210,3075,14326,17401,7809,2022,'CARNEIRINHO',Carneirinho,'MG',3114550,2464.0,2464,205.3,205.3,1,72.0,72.0,Pequeno I
2396,2402,311460,2004,1449,327,261,588,861,1860.0,1397.58,307.67,259.75,567.42,830.17,22320,16771,3692,3117,6809,9962,2022,'CARRANCAS',Carrancas,'MG',3114600,1768.0,1768,147.3,147.3,1,56.0,56.0,Pequeno I
2397,2403,311470,1686,1277,368,158,526,751,1682.25,1299.67,366.0,189.5,555.5,744.17,20187,15596,4392,2274,6666,8930,2022,'CARVALHOPOLIS',Carvalhópolis,'MG',3114709,364.0,364,30.3,30.3,1,0.0,0.0,Pequeno I
2398,2404,311480,2936,2569,200,2011,2211,358,2911.75,2578.33,196.5,1987.08,2183.58,394.75,34941,30940,2358,23845,26203,4737,2022,'CARVALHOS',Carvalhos,'MG',3114808,861.0,861,71.8,71.8,1,56.0,56.0,Pequeno I
2399,2405,311490,913,757,152,292,444,313,857.25,727.33,143.92,282.83,426.75,300.58,10287,8728,1727,3394,5121,3607,2022,'CASA GRANDE',Casa Grande,'MG',3114907,942.0,942,78.5,78.5,1,80.0,80.0,Pequeno I
2400,2406,311500,1409,1214,162,690,852,362,1298.25,1121.08,112.67,678.42,791.08,330.0,15579,13453,1352,8141,9493,3960,2022,'CASCALHO RICO',Cascalho Rico,'MG',3115003,395.0,395,32.9,32.9,1,21.0,21.0,Pequeno I
2401,2407,311510,9706,7729,975,3725,4700,3029,9322.0,7484.75,938.67,3440.0,4378.67,3106.08,111864,89817,11264,41280,52544,37273,2022,'CASSIA',Cássia,'MG',3115102,4090.0,12092,340.8,1007.7,1,735.0,735.0,Pequeno I
2402,2408,311520,1971,1771,166,1102,1268,503,1899.83,1724.83,180.0,1062.5,1242.5,482.33,22798,20698,2160,12750,14910,5788,2022,'CONCEICAO DA BARRA DE MINA,Conceição da Barra de Minas,'MG',3115201,303.0,303,37.9,37.9,1,39.0,39.0,Pequeno I
2403,2409,311530,24537,19256,4784,6169,10953,8303,23024.75,18012.08,4220.75,6074.75,10295.5,7716.58,276297,216145,50649,72897,123546,92599,2022,'CATAGUASES',Cataguases,'MG',3115300,21582.0,21582,1798.5,1798.5,3,1807.0,1807.0,Médio
2404,2410,311535,2684,2072,374,920,1294,778,2515.08,1961.17,336.58,822.58,1159.17,802.0,30181,23534,4039,9871,13910,9624,2022,'CATAS ALTAS',Catas Altas,'MG',3115359,1767.0,1767,147.2,147.2,1,158.0,158.0,Pequeno I
2405,2411,311540,1736,1584,240,1071,1311,273,1668.58,1541.83,219.58,1090.17,1309.75,232.08,20023,18502,2635,13082,15717,2785,2022,'CATAS ALTAS DA NORUEGA',Catas Altas da Noruega,'MG',3115409,653.0,653,54.4,54.4,1,21.0,21.0,Pequeno I
2406,2412,311545,6124,5624,309,4245,4554,1070,6018.08,5549.42,321.83,4268.75,4590.58,958.83,72217,66593,3862,51225,55087,11506,2022,'CATUJI',Catuji,'MG',3115458,1508.0,1508,150.8,150.8,1,,,Pequeno I
2407,2413,311547,4220,3841,77,3245,3322,519,4090.33,3754.42,91.83,3056.83,3148.67,605.75,49084,45053,1102,36682,37784,7269,2022,'CATUTI',Catuti,'MG',3115474,665.0,665,55.4,55.4,1,26.0,26.0,Pequeno I
2408,2414,311550,8952,7773,1287,3199,4486,3287,8706.25,7631.33,1216.33,3227.5,4443.83,3187.5,104475,91576,14596,38730,53326,38250,2022,'CAXAMBU',Caxambu,'MG',3115508,7008.0,7008,584.0,584.0,1,537.0,537.0,Pequeno II
2409,2415,311560,730,496,78,165,243,253,713.42,503.33,88.33,166.5,254.83,248.5,8561,6040,1060,1998,3058,2982,2022,'CEDRO DO ABAETE',Cedro do Abaeté,'MG',3115607,994.0,994,82.8,82.8,1,63.0,63.0,Pequeno I
2410,2416,311570,3783,3057,156,2256,2412,645,3782.67,3081.33,131.0,2342.08,2473.08,608.25,45392,36976,1572,28105,29677,7299,2022,'CENTRAL DE MINAS',Central de Minas,'MG',3115706,1355.0,1355,112.9,112.9,1,115.0,115.0,Pequeno I
2411,2417,311580,4911,3923,342,2643,2985,938,4684.83,3755.92,306.75,2572.25,2879.0,876.92,56218,45071,3681,30867,34548,10523,2022,'CENTRALINA',Centralina,'MG',3115805,2509.0,12762,209.1,1063.5,1,0.0,1142.0,Pequeno I
2412,2418,311590,1787,1612,192,1006,1198,414,1652.83,1489.5,204.75,912.92,1117.67,371.83,19834,17874,2457,10955,13412,4462,2022,'CHACARA',Chácara,'MG',3115904,985.0,985,140.7,140.7,1,70.0,70.0,Pequeno I
2413,2419,311600,4100,3619,521,2405,2926,693,4035.33,3606.08,450.0,2541.17,2991.17,614.92,48424,43273,5400,30494,35894,7379,2022,'CHALE',Chalé,'MG',3116001,702.0,702,58.5,58.5,1,69.0,69.0,Pequeno I
2414,2420,311610,7469,6429,540,3875,4415,2014,7411.58,6535.33,514.5,4078.83,4593.33,1942.0,88939,78424,6174,48946,55120,23304,2022,'CHAPADA DO NORTE',Chapada do Norte,'MG',3116100,3076.0,3076,256.3,256.3,1,184.0,184.0,Pequeno I
2415,2421,311615,10165,8789,430,6844,7274,1515,9887.75,8644.75,442.17,6788.25,7230.42,1414.33,118653,103737,5306,81459,86765,16972,2022,'CHAPADA GAUCHA',Chapada Gaúcha,'MG',3116159,2218.0,2218,184.8,184.8,1,185.0,185.0,Pequeno I
2416,2422,311620,1741,1449,211,808,1019,430,1596.58,1366.58,196.92,780.67,977.58,389.0,19159,16399,2363,9368,11731,4668,2022,'CHIADOR',Chiador,'MG',3116209,5841.0,5841,486.8,486.8,1,390.0,390.0,Pequeno I
2417,2423,311630,3930,3274,320,1923,2243,1031,3882.17,3321.75,336.0,2014.83,2350.83,970.92,46586,39861,4032,24178,28210,11651,2022,'CIPOTANEA',Cipotânea,'MG',3116308,4980.0,4980,415.0,415.0,1,354.0,354.0,Pequeno I
2418,2424,311640,2316,1998,317,1020,1337,661,2193.75,1913.33,286.92,961.17,1248.08,665.25,26325,22960,3443,11534,14977,7983,2022,'CLARAVAL',Claraval,'MG',3116407,6152.0,6152,512.7,512.7,1,337.0,337.0,Pequeno I
2419,2425,311650,5122,4434,575,2522,3097,1337,5076.67,4437.33,544.75,2621.67,3166.42,1270.92,60920,53248,6537,31460,37997,15251,2022,'CLARO DOS POCOES',Claro Dos Poções,'MG',3116506,7725.0,7725,643.8,643.8,1,462.0,462.0,Pequeno I
2420,2426,311660,9980,7966,1283,1755,3038,4928,9430.67,7703.08,1312.17,1732.33,3044.5,4658.58,113168,92437,15746,20788,36534,55903,2022,'CLAUDIO',Cláudio,'MG',3116605,1266.0,1266,105.5,105.5,1,75.0,75.0,Pequeno II
2421,2427,311670,4521,3638,460,1792,2252,1386,4400.17,3580.92,451.5,1763.25,2214.75,1366.17,52802,42971,5418,21159,26577,16394,2022,'COIMBRA',Coimbra,'MG',3116704,899.0,899,74.9,74.9,1,90.0,90.0,Pequeno I
2422,2428,311680,6710,5623,388,3952,4340,1283,6542.08,5536.92,385.17,3938.67,4323.83,1213.08,78505,66443,4622,47264,51886,14557,2022,'COLUNA',Coluna,'MG',3116803,670.0,670,55.8,55.8,1,43.0,43.0,Pequeno I
2423,2429,311690,1441,1174,95,812,907,267,1377.67,1154.25,74.75,850.67,925.42,228.83,16532,13851,897,10208,11105,2746,2022,'COMENDADOR GOMES',Comendador Gomes,'MG',3116902,1633.0,1633,136.1,136.1,1,114.0,114.0,Pequeno I
2424,2430,311700,5312,4474,101,3583,3684,790,5327.83,4550.5,102.58,3689.25,3791.83,758.67,63934,54606,1231,44271,45502,9104,2022,'COMERCINHO',Comercinho,'MG',3117009,1255.0,1255,104.6,104.6,1,94.0,94.0,Pequeno I
2425,2431,311710,5098,4267,1245,1238,2483,1784,4872.83,4084.42,1064.67,1418.83,2483.5,1600.92,58474,49013,12776,17026,29802,19211,2022,'CONCEICAO DA APARECIDA',Conceição da Aparecida,'MG',3117108,2552.0,2552,212.7,212.7,1,173.0,173.0,Pequeno I
2426,2432,311720,1408,1228,170,662,832,396,1353.08,1186.75,160.33,637.58,797.92,388.83,16237,14241,1924,7651,9575,4666,2022,'CONCEICAO DAS PEDRAS',Conceição Das Pedras,'MG',3117207,845.0,845,70.4,70.4,1,67.0,67.0,Pequeno I
2427,2433,311730,12789,9824,2284,4259,6543,3281,11707.25,8966.75,2220.58,3522.08,5742.67,3224.08,140487,107601,26647,42265,68912,38689,2022,'CONCEICAO DAS ALAGOAS',Conceição Das Alagoas,'MG',3117306,5919.0,5919,493.2,493.2,1,480.0,480.0,Pequeno II
2428,2434,311740,2821,2508,140,1984,2124,384,2727.17,2452.25,152.58,1993.25,2145.83,306.42,32726,29427,1831,23919,25750,3677,2022,'CONCEICAO DE IPANEMA',Conceição de Ipanema,'MG',3117405,1514.0,1514,151.4,151.4,1,,,Pequeno I
2429,2435,311750,12944,11204,1149,6739,7888,3316,12577.5,11071.5,1176.92,6870.42,8047.33,3024.17,150930,132858,14123,82445,96568,36290,2022,'CONCEICAO DO MATO DENTRO',Conceição do Mato Dentro,'MG',3117504,4390.0,4390,365.8,365.8,1,253.0,253.0,Pequeno I
2430,2436,311760,2268,1885,398,573,971,914,2090.17,1778.0,345.0,585.83,930.83,847.17,25082,21336,4140,7030,11170,10166,2022,'CONCEICAO DO PARA',Conceição do Pará,'MG',3117603,1554.0,1554,129.5,129.5,1,53.0,53.0,Pequeno I
2431,2437,311770,6950,5920,1343,2031,3374,2546,6753.92,5810.17,1219.75,2224.5,3444.25,2365.92,81047,69722,14637,26694,41331,28391,2022,'CONCEICAO DO RIO VERDE',Conceição do Rio Verde,'MG',3117702,7655.0,10040,637.9,836.7,1,487.0,487.0,Pequeno I
2432,2438,311780,4749,3891,819,1207,2026,1865,4435.92,3672.0,732.25,1183.25,1915.5,1756.5,53231,44064,8787,14199,22986,21078,2022,'CONCEICAO DOS OUROS',Conceição Dos Ouros,'MG',3117801,2864.0,2864,238.7,238.7,1,206.0,206.0,Pequeno I
2433,2439,311783,6513,5692,203,4459,4662,1030,6421.25,5657.17,223.83,4452.0,4675.83,981.33,77055,67886,2686,53424,56110,11776,2022,'CONEGO MARINHO',Cônego Marinho,'MG',3117836,995.0,995,82.9,82.9,1,12.0,12.0,Pequeno I
2434,2440,311787,2570,2062,379,677,1056,1006,2538.08,2090.92,351.92,757.5,1109.42,981.5,30457,25091,4223,9090,13313,11778,2022,'CONFINS',Confins,'MG',3117876,3015.0,3015,376.9,376.9,1,,,Pequeno I
2435,2441,311790,4827,3688,846,799,1645,2043,4592.08,3553.67,803.92,977.33,1781.25,1772.42,55105,42644,9647,11728,21375,21269,2022,'CONGONHAL',Congonhal,'MG',3117900,3217.0,3217,268.1,268.1,1,202.0,202.0,Pequeno I
2436,2442,311800,16912,14088,3131,1982,5113,8975,16278.58,13828.92,3017.08,2021.67,5038.75,8790.17,195343,165947,36205,24260,60465,105482,2022,'CONGONHAS',Congonhas,'MG',3118007,9673.0,9673,806.1,806.1,3,861.0,861.0,Pequeno II
2437,2443,311810,3058,2680,178,1918,2096,584,2957.92,2592.92,181.0,1764.75,1945.75,647.17,35495,31115,2172,21177,23349,7766,2022,'CONGONHAS DO NORTE',Congonhas do Norte,'MG',3118106,733.0,733,61.1,61.1,1,53.0,53.0,Pequeno I
2438,2444,311820,2580,2159,182,1408,1590,569,2338.17,1993.58,170.5,1288.17,1458.67,534.92,28058,23923,2046,15458,17504,6419,2022,'CONQUISTA',Conquista,'MG',3118205,3213.0,3213,267.8,267.8,1,88.0,88.0,Pequeno I
2439,2445,311830,28780,22489,6469,4116,10585,11904,26718.5,21129.33,6233.58,3900.58,10134.17,10995.17,320622,253552,74803,46807,121610,131942,2022,'CONSELHEIRO LAFAIETE',Conselheiro Lafaiete,'MG',3118304,22763.0,22763,1896.9,1896.9,4,1775.0,1775.0,Grande
2440,2446,311840,10750,9369,754,6719,7473,1896,10195.42,8983.58,669.58,6669.42,7339.0,1644.58,122345,107803,8035,80033,88068,19735,2022,'CONSELHEIRO PENA',Conselheiro Pena,'MG',3118403,6152.0,6152,559.3,559.3,1,,,Pequeno II
2441,2447,311850,980,821,51,534,585,236,977.17,832.83,50.83,547.17,598.0,234.83,11726,9994,610,6566,7176,2818,2022,'CONSOLACAO',Consolação,'MG',3118502,592.0,592,53.8,53.8,1,90.0,90.0,Pequeno I
2442,2448,311860,210258,177202,21401,105041,126442,50760,190217.5,161829.58,19661.92,96165.5,115827.42,46002.17,2282610,1941955,235943,1153986,1389929,552026,2022,'CONTAGEM',Contagem,'MG',3118601,146971.0,221674,12247.6,18472.8,10,14201.0,14201.0,Grande
2443,2449,311870,5508,4389,834,1675,2509,1880,5370.67,4319.08,889.5,1684.58,2574.08,1745.0,64448,51829,10674,20215,30889,20940,2022,'COQUEIRAL',Coqueiral,'MG',3118700,3935.0,3935,327.9,327.9,1,155.0,155.0,Pequeno I
2444,2450,311880,17793,15960,1073,11788,12861,3099,17475.25,15806.25,967.92,11889.5,12857.42,2948.83,209703,189675,11615,142674,154289,35386,2022,'CORACAO DE JESUS',Coração de Jesus,'MG',3118809,6762.0,6762,563.5,563.5,3,297.0,297.0,Pequeno II
2445,2451,311890,4700,4069,170,3067,3237,832,4483.0,3884.92,183.17,2857.33,3040.5,844.42,53796,46619,2198,34288,36486,10133,2022,'CORDISBURGO',Cordisburgo,'MG',3118908,2954.0,2954,268.5,268.5,1,,,Pequeno I
2446,2452,311900,1855,1590,265,847,1112,478,1910.75,1653.17,250.0,945.58,1195.58,457.58,22929,19838,3000,11347,14347,5491,2022,'CORDISLANDIA',Cordislândia,'MG',3119005,1526.0,1526,127.2,127.2,1,136.0,136.0,Pequeno I
2447,2453,311910,12020,10460,1885,5446,7331,3129,11467.17,10027.08,1835.67,5208.58,7044.25,2982.83,137606,120325,22028,62503,84531,35794,2022,'CORINTO',Corinto,'MG',3119104,2058.0,2058,171.5,171.5,1,125.0,125.0,Pequeno II
2448,2454,311920,6065,5310,319,3673,3992,1318,5921.17,5233.42,291.75,3633.92,3925.67,1307.75,71054,62801,3501,43607,47108,15693,2022,'COROACI',Coroaci,'MG',3119203,266.0,266,88.7,88.7,1,,,Pequeno I
2449,2455,311930,12105,10182,1971,5228,7199,2983,11058.83,9343.67,2023.67,4411.75,6435.42,2908.25,132706,112124,24284,52941,77225,34899,2022,'COROMANDEL',Coromandel,'MG',3119302,1513.0,1513,126.1,126.1,1,149.0,149.0,Pequeno II
2450,2456,311940,46206,36161,5526,14706,20232,15929,44748.42,35837.92,5205.67,15303.08,20508.75,15329.17,536981,430055,62468,183637,246105,183950,2022,'CORONEL FABRICIANO',Coronel Fabriciano,'MG',3119401,25979.0,25979,2164.9,2164.9,4,2563.0,2563.0,Grande
2451,2457,311950,6750,5478,511,3319,3830,1648,6591.25,5435.08,520.0,3312.75,3832.75,1602.33,79095,65221,6240,39753,45993,19228,2022,'CORONEL MURTA',Coronel Murta,'MG',3119500,1588.0,1588,132.3,132.3,1,113.0,113.0,Pequeno I
2452,2458,311960,1371,1154,166,473,639,515,1321.17,1140.5,152.67,516.67,669.33,471.17,15854,13686,1832,6200,8032,5654,2022,'CORONEL PACHECO',Coronel Pacheco,'MG',3119609,1891.0,1891,171.9,171.9,1,,,Pequeno I
2453,2459,311970,1514,1205,250,249,499,706,1471.67,1177.92,270.58,256.75,527.33,650.58,17660,14135,3247,3081,6328,7807,2022,'CORONEL XAVIER CHAVES',Coronel Xavier Chaves,'MG',3119708,1793.0,1793,149.4,149.4,1,100.0,100.0,Pequeno I
2454,2460,311980,1380,881,104,315,419,462,1331.67,865.5,104.33,303.92,408.25,457.25,15980,10386,1252,3647,4899,5487,2022,'CORREGO DANTA',Córrego Danta,'MG',3119807,1686.0,1686,140.5,140.5,1,114.0,114.0,Pequeno I
2455,2461,311990,1424,1079,212,389,601,478,1378.33,1057.83,205.25,393.0,598.25,459.58,16540,12694,2463,4716,7179,5515,2022,'CORREGO DO BOM JESUS',Córrego do Bom Jesus,'MG',3119906,1625.0,1625,135.4,135.4,1,100.0,100.0,Pequeno I
2456,2462,311995,3043,1790,139,179,318,1472,2930.5,1768.33,125.33,169.08,294.42,1473.92,35166,21220,1504,2029,3533,17687,2022,'CORREGO FUNDO',Córrego Fundo,'MG',3119955,854.0,854,71.2,71.2,1,45.0,45.0,Pequeno I
2457,2463,312000,2045,1713,78,1266,1344,369,2029.75,1708.58,99.08,1233.5,1332.58,376.0,24357,20503,1189,14802,15991,4512,2022,'CORREGO NOVO',Córrego Novo,'MG',3120003,2655.0,2655,221.2,221.2,1,239.0,239.0,Pequeno I
2458,2464,312010,3119,2713,186,1807,1993,720,2999.42,2622.08,162.17,1798.08,1960.25,661.83,35993,31465,1946,21577,23523,7942,2022,'COUTO DE MAGALHAES DE MINA,Couto de Magalhães de Minas,'MG',3120102,2306.0,2306,230.6,230.6,1,166.0,166.0,Pequeno I
2459,2465,312015,4020,3678,251,2834,3085,593,4043.75,3756.42,240.0,2930.08,3170.08,586.33,48525,45077,2880,35161,38041,7036,2022,'CRISOLITA',Crisólita,'MG',3120151,1722.0,1722,143.5,143.5,1,59.0,59.0,Pequeno I
2460,2466,312020,6117,4518,875,912,1787,2731,5848.58,4516.08,889.17,921.5,1810.67,2705.42,70183,54193,10670,11058,21728,32465,2022,'CRISTAIS',Cristais,'MG',3120201,2920.0,2920,243.3,243.3,1,314.0,314.0,Pequeno I
2461,2467,312030,5229,4757,215,4201,4416,341,5164.42,4766.58,146.17,4332.75,4478.92,287.67,61973,57199,1754,51993,53747,3452,2022,'CRISTALIA',Cristália,'MG',3120300,2900.0,2900,241.7,241.7,1,126.0,126.0,Pequeno I
2462,2468,312040,2772,2201,355,897,1252,949,2662.67,2132.33,328.67,910.92,1239.58,892.75,31952,25588,3944,10931,14875,10713,2022,'CRISTIANO OTONI',Cristiano Otoni,'MG',3120409,927.0,927,77.2,77.2,1,50.0,50.0,Pequeno I
2463,2469,312050,4088,3594,832,1118,1950,1644,3940.25,3486.58,883.42,1155.25,2038.67,1447.92,47283,41839,10601,13863,24464,17375,2022,'CRISTINA',Cristina,'MG',3120508,1941.0,1941,161.8,161.8,1,95.0,95.0,Pequeno I
2464,2470,312060,2722,2108,525,772,1297,811,2559.0,2025.42,466.17,865.5,1331.67,693.75,30708,24305,5594,10386,15980,8325,2022,'CRUCILANDIA',Crucilândia,'MG',3120607,4842.0,4842,403.5,403.5,1,208.0,208.0,Pequeno I
2465,2471,312070,2869,2115,133,1222,1355,760,2778.67,2170.08,143.33,1240.08,1383.42,786.67,33344,26041,1720,14881,16601,9440,2022,'CRUZEIRO DA FORTALEZA',Cruzeiro da Fortaleza,'MG',3120706,2926.0,2926,243.8,243.8,1,134.0,134.0,Pequeno I
2466,2472,312080,7951,6782,404,4321,4725,2057,7551.92,6479.75,402.0,4160.83,4562.83,1916.92,90623,77757,4824,49930,54754,23003,2022,'CRUZILIA',Cruzília,'MG',3120805,2368.0,2368,197.3,197.3,1,123.0,123.0,Pequeno I
2467,2473,312083,2822,2394,182,1818,2000,394,2630.17,2248.42,175.42,1689.17,1864.58,383.83,31562,26981,2105,20270,22375,4606,2022,'CUPARAQUE',Cuparaque,'MG',3120839,344.0,344,28.7,28.7,1,19.0,19.0,Pequeno I
2468,2474,312087,6782,5927,230,4707,4937,990,6737.33,5920.67,209.25,4787.17,4996.42,924.25,80848,71048,2511,57446,59957,11091,2022,'CURRAL DE DENTRO',Curral de Dentro,'MG',3120870,1612.0,1612,134.3,134.3,1,153.0,153.0,Pequeno I
2469,2475,312090,33643,28859,3553,15925,19478,9381,31529.42,27281.83,3483.0,15031.42,18514.42,8767.42,378353,327382,41796,180377,222173,105209,2022,'CURVELO',Curvelo,'MG',3120904,11467.0,11467,955.6,955.6,3,725.0,725.0,Médio
2470,2476,312100,4975,4214,363,2354,2717,1497,4860.83,4165.58,384.17,2463.92,2848.08,1317.5,58330,49987,4610,29567,34177,15810,2022,'DATAS',Datas,'MG',3121001,1677.0,1677,139.8,139.8,1,60.0,60.0,Pequeno I
2471,2477,312110,3450,2990,623,1256,1879,1111,3315.33,2908.0,623.58,1194.33,1817.92,1090.08,39784,34896,7483,14332,21815,13081,2022,'DELFIM MOREIRA',Delfim Moreira,'MG',3121100,2820.0,2820,235.0,235.0,1,196.0,196.0,Pequeno I
2472,2478,312120,3261,2549,749,659,1408,1141,3061.58,2444.17,694.42,675.42,1369.83,1074.33,36739,29330,8333,8105,16438,12892,2022,'DELFINOPOLIS',Delfinópolis,'MG',3121209,2346.0,2346,195.5,195.5,1,139.0,139.0,Pequeno I
2473,2479,312125,5398,4882,265,3857,4122,760,5096.0,4658.0,282.08,3640.08,3922.17,735.83,61152,55896,3385,43681,47066,8830,2022,'DELTA',Delta,'MG',3121258,3246.0,3246,270.5,270.5,1,152.0,152.0,Pequeno I
2474,2480,312130,3089,2475,225,1277,1502,973,2946.75,2396.17,239.0,1141.42,1380.42,1015.75,35361,28754,2868,13697,16565,12189,2022,'DESCOBERTO',Descoberto,'MG',3121308,2039.0,2039,169.9,169.9,1,210.0,210.0,Pequeno I
2475,2481,312140,2418,2085,561,784,1345,740,2286.75,2003.58,421.17,855.75,1276.92,726.67,27441,24043,5054,10269,15323,8720,2022,'DESTERRO DE ENTRE RIOS',Desterro de Entre Rios,'MG',3121407,2200.0,2200,183.3,183.3,1,326.0,326.0,Pequeno I
2476,2482,312150,1495,1329,95,853,948,381,1421.42,1271.75,86.92,801.17,888.08,383.67,17057,15261,1043,9614,10657,4604,2022,'DESTERRO DO MELO',Desterro do Melo,'MG',3121506,2405.0,2405,200.4,200.4,1,289.0,289.0,Pequeno I
2477,2483,312160,28102,23436,2980,11415,14395,9041,26929.83,22860.0,2886.42,11315.83,14202.25,8657.75,323158,274320,34637,135790,170427,103893,2022,'DIAMANTINA',Diamantina,'MG',3121605,20726.0,20726,1727.2,1727.2,3,1013.0,1013.0,Pequeno II
2478,2484,312170,2490,2027,149,1305,1454,573,2465.17,2033.58,145.58,1310.42,1456.0,577.58,29582,24403,1747,15725,17472,6931,2022,'DIOGO DE VASCONCELOS',Diogo de Vasconcelos,'MG',3121704,2496.0,2496,208.0,208.0,1,142.0,142.0,Pequeno I
2479,2485,312180,4038,3492,416,1913,2329,1163,3947.83,3443.25,404.42,1910.0,2314.42,1128.83,47374,41319,4853,22920,27773,13546,2022,'DIONISIO',Dionísio,'MG',3121803,4334.0,4334,361.2,361.2,1,180.0,180.0,Pequeno I
2480,2486,312190,2392,2007,225,1055,1280,727,2256.67,1910.5,215.58,974.08,1189.67,720.83,27080,22926,2587,11689,14276,8650,2022,'DIVINESIA',Divinésia,'MG',3121902,1142.0,1142,95.2,95.2,1,79.0,79.0,Pequeno I
2481,2487,312200,14068,12035,1477,7023,8500,3535,13575.67,11747.83,1545.5,6729.92,8275.42,3472.42,162908,140974,18546,80759,99305,41669,2022,'DIVINO',Divino,'MG',3122009,4795.0,4795,399.6,399.6,1,483.0,483.0,Pequeno I
2482,2488,312210,3351,2785,131,2194,2325,460,3252.42,2721.92,141.75,2117.08,2258.83,463.08,39029,32663,1701,25405,27106,5557,2022,'DIVINO DAS LARANJEIRAS',Divino Das Laranjeiras,'MG',3122108,2824.0,2824,235.3,235.3,1,179.0,179.0,Pequeno I
2483,2489,312220,5540,4997,570,3187,3757,1240,5319.0,4840.58,473.83,3189.92,3663.75,1176.83,63828,58087,5686,38279,43965,14122,2022,'DIVINOLANDIA DE MINAS',Divinolândia de Minas,'MG',3122207,2915.0,2915,242.9,242.9,1,232.0,232.0,Pequeno I
2484,2490,312230,57578,45638,10101,13679,23780,21858,50034.92,40018.83,9022.25,11518.92,20541.17,19477.67,600419,480226,108267,138227,246494,233732,2022,'DIVINOPOLIS',Divinópolis,'MG',3122306,12668.0,12668,1055.7,1055.7,5,678.0,678.0,Grande
2485,2491,312235,5580,4905,334,3637,3971,934,5411.17,4761.58,398.0,3365.08,3763.08,998.5,64934,57139,4776,40381,45157,11982,2022,'DIVISA ALEGRE',Divisa Alegre,'MG',3122355,1458.0,1458,121.5,121.5,1,68.0,68.0,Pequeno I
2486,2492,312240,2823,2368,525,673,1198,1170,2680.17,2263.0,493.83,701.67,1195.5,1067.5,32162,27156,5926,8420,14346,12810,2022,'DIVISA NOVA',Divisa Nova,'MG',3122405,3503.0,3503,291.9,291.9,1,359.0,359.0,Pequeno I
2487,2493,312245,7514,6710,101,6073,6174,536,7293.5,6539.33,101.83,5794.83,5896.67,642.67,87522,78472,1222,69538,70760,7712,2022,'DIVISOPOLIS',Divisópolis,'MG',3122454,3815.0,3815,317.9,317.9,1,160.0,160.0,Pequeno I
2488,2494,312247,2650,2064,283,1179,1462,602,2611.58,2093.83,256.67,1278.5,1535.17,558.67,31339,25126,3080,15342,18422,6704,2022,'DOM BOSCO',Dom Bosco,'MG',3122470,1680.0,1680,186.7,186.7,1,106.0,106.0,Pequeno I
2489,2495,312250,2758,1973,298,668,966,1007,2658.17,1932.67,293.67,642.42,936.08,996.58,31898,23192,3524,7709,11233,11959,2022,'DOM CAVATI',Dom Cavati,'MG',3122504,2295.0,2295,191.2,191.2,1,115.0,115.0,Pequeno I
2490,2496,312260,2897,2527,205,1856,2061,466,2776.83,2437.75,187.42,1823.0,2010.42,427.33,33322,29253,2249,21876,24125,5128,2022,'DOM JOAQUIM',Dom Joaquim,'MG',3122603,582.0,582,48.5,48.5,1,124.0,124.0,Pequeno I
2491,2497,312270,2227,1797,112,963,1075,722,2145.58,1770.08,122.08,920.33,1042.42,727.67,25747,21241,1465,11044,12509,8732,2022,'DOM SILVERIO',Dom Silvério,'MG',3122702,1704.0,1704,154.9,154.9,1,242.0,242.0,Pequeno I
2492,2498,312280,1458,1282,331,422,753,529,1352.08,1178.5,285.92,346.92,632.83,545.67,16225,14142,3431,4163,7594,6548,2022,'DOM VICOSO',Dom Viçoso,'MG',3122801,1617.0,1617,134.8,134.8,1,80.0,80.0,Pequeno I
2493,2499,312290,3039,2724,518,958,1476,1248,2823.58,2541.67,501.67,862.25,1363.92,1177.75,33883,30500,6020,10347,16367,14133,2022,'DONA EUZEBIA',Dona Eusébia,'MG',3122900,2894.0,2894,241.2,241.2,1,79.0,79.0,Pequeno I
2494,2500,312300,3901,2980,729,559,1288,1692,3563.58,2734.83,674.33,499.0,1173.33,1561.5,42763,32818,8092,5988,14080,18738,2022,'DORES DE CAMPOS',Dores de Campos,'MG',3123007,797.0,797,66.4,66.4,1,77.0,77.0,Pequeno I
2495,2501,312310,3350,2750,426,1305,1731,1019,3145.25,2676.67,417.67,1314.67,1732.33,944.33,37743,32120,5012,15776,20788,11332,2022,'DORES DE GUANHAES',Dores de Guanhães,'MG',3123106,2128.0,2128,177.3,177.3,1,138.0,138.0,Pequeno I
2496,2502,312320,5960,4685,884,1270,2154,2531,5732.83,4650.42,944.17,1244.58,2188.75,2461.67,68794,55805,11330,14935,26265,29540,2022,'DORES DO INDAIA',Dores do Indaiá,'MG',3123205,2570.0,2570,214.2,214.2,1,190.0,190.0,Pequeno I
2497,2503,312330,2899,2516,406,1344,1750,766,2773.83,2427.67,322.67,1387.25,1709.92,717.75,33286,29132,3872,16647,20519,8613,2022,'DORES DO TURVO',Dores do Turvo,'MG',3123304,1528.0,1528,152.8,152.8,1,102.0,102.0,Pequeno I
2498,2504,312340,687,546,102,261,363,183,680.75,555.67,109.42,270.25,379.67,176.0,8169,6668,1313,3243,4556,2112,2022,'DORESOPOLIS',Doresópolis,'MG',3123403,888.0,888,74.0,74.0,1,98.0,98.0,Pequeno I
2499,2505,312350,592,500,37,309,346,154,580.5,486.08,37.58,299.42,337.0,149.08,6966,5833,451,3593,4044,1789,2022,'DOURADOQUARA',Douradoquara,'MG',3123502,467.0,467,38.9,38.9,1,37.0,37.0,Pequeno I
2500,2506,312352,5184,4762,914,2407,3321,1441,5002.25,4615.75,804.92,2463.25,3268.17,1347.58,60027,55389,9659,29559,39218,16171,2022,'DURANDE',Durandé,'MG',3123528,2485.0,2485,355.0,355.0,1,,,Pequeno I
2501,2507,312360,11131,9099,2041,3291,5332,3767,10141.33,8461.25,1790.67,3181.58,4972.25,3489.0,121696,101535,21488,38179,59667,41868,2022,'ELOI MENDES',Elói Mendes,'MG',3123601,3639.0,3639,303.2,303.2,1,362.0,362.0,Pequeno II
2502,2508,312370,5814,5008,695,2917,3612,1396,5526.5,4864.33,615.33,2920.58,3535.92,1328.42,66318,58372,7384,35047,42431,15941,2022,'ENGENHEIRO CALDAS',Engenheiro Caldas,'MG',3123700,1373.0,1373,114.4,114.4,1,47.0,47.0,Pequeno I
2503,2509,312380,5289,4681,52,3890,3942,739,5226.5,4678.25,35.25,3994.5,4029.75,648.5,62718,56139,423,47934,48357,7782,2022,'ENGENHEIRO NAVARRO',Engenheiro Navarro,'MG',3123809,6401.0,8528,533.4,710.7,1,124.0,124.0,Pequeno I
2504,2510,312385,3731,3141,1068,813,1881,1260,3621.5,3067.17,971.5,859.5,1831.0,1236.17,43458,36806,11658,10314,21972,14834,2022,'ENTRE FOLHAS',Entre Folhas,'MG',3123858,2572.0,2572,214.3,214.3,1,89.0,89.0,Pequeno I
2505,2511,312390,5924,4839,825,1176,2001,2838,5842.75,4807.83,821.0,1250.5,2071.5,2736.33,70113,57694,9852,15006,24858,32836,2022,'ENTRE RIOS DE MINAS',Entre Rios de Minas,'MG',3123908,3678.0,3678,306.5,306.5,1,200.0,200.0,Pequeno I
2506,2512,312400,9790,8877,3157,1949,5106,3771,9323.17,8485.08,2726.67,2621.0,5347.67,3137.42,111878,101821,32720,31452,64172,37649,2022,'ERVALIA',Ervália,'MG',3124005,5968.0,12029,497.3,1002.4,1,924.0,924.0,Pequeno I
2507,2513,312410,44041,38675,4904,23850,28754,9921,39927.08,35482.5,4695.17,21934.83,26630.0,8852.5,479125,425790,56342,263218,319560,106230,2022,'ESMERALDAS',Esmeraldas,'MG',3124104,20386.0,66131,1698.8,5510.9,4,900.0,6361.0,Médio
2508,2514,312420,11963,10410,2362,4681,7043,3367,11441.42,10109.75,2139.58,4956.83,7096.42,3013.33,137297,121317,25675,59482,85157,36160,2022,'ESPERA FELIZ',Espera Feliz,'MG',3124203,6513.0,6513,542.8,542.8,2,424.0,424.0,Pequeno II
2509,2515,312430,24051,20795,832,15391,16223,4572,23171.83,20167.5,858.5,14802.75,15661.25,4506.25,278062,242010,10302,177633,187935,54075,2022,'ESPINOSA',Espinosa,'MG',3124302,20546.0,20546,1712.2,1712.2,2,1754.0,1754.0,Pequeno II
2510,2516,312440,3646,3236,1670,572,2242,994,3432.92,3061.42,1514.67,595.75,2110.42,951.0,41195,36737,18176,7149,25325,11412,2022,'ESPIRITO SANTO DO DOURADO',Espírito Santo do Dourado,'MG',3124401,1624.0,1624,135.3,135.3,1,78.0,78.0,Pequeno I
2511,2517,312450,4442,3710,1048,1413,2461,1249,4158.92,3528.0,908.5,1440.0,2348.5,1179.5,49907,42336,10902,17280,28182,14154,2022,'ESTIVA',Estiva,'MG',3124500,5879.0,5879,489.9,489.9,1,359.0,359.0,Pequeno I
2512,2518,312460,1315,1086,65,709,774,312,1272.5,1056.75,90.83,667.83,758.67,298.08,15270,12681,1090,8014,9104,3577,2022,'ESTRELA DALVA',Estrela Dalva,'MG',3124609,1414.0,1414,117.8,117.8,1,300.0,300.0,Pequeno I
2513,2519,312470,1303,918,147,221,368,550,1268.42,917.75,143.58,238.08,381.67,536.08,15221,11013,1723,2857,4580,6433,2022,'ESTRELA DO INDAIA',Estrela do Indaiá,'MG',3124708,825.0,825,68.8,68.8,1,51.0,51.0,Pequeno I
2514,2520,312480,3002,2465,260,1263,1523,942,2836.0,2347.83,248.92,1243.17,1492.08,855.75,34032,28174,2987,14918,17905,10269,2022,'ESTRELA DO SUL',Estrela do Sul,'MG',3124807,4526.0,4526,377.2,377.2,1,387.0,387.0,Pequeno I
2515,2521,312490,6444,5528,496,3248,3744,1784,6051.75,5260.58,446.75,3227.0,3673.75,1586.83,72621,63127,5361,38724,44085,19042,2022,'EUGENOPOLIS',Eugenópolis,'MG',3124906,6167.0,6167,513.9,513.9,1,540.0,540.0,Pequeno I
2516,2522,312500,2821,2549,156,1945,2101,448,2710.25,2451.5,136.33,1862.58,1998.92,452.58,32523,29418,1636,22351,23987,5431,2022,'EWBANK DA CAMARA',Ewbank da Câmara,'MG',3125002,1491.0,1491,124.2,124.2,1,102.0,102.0,Pequeno I
2517,2523,312510,15149,11200,2192,2897,5089,6111,13387.42,10462.0,2200.83,2930.67,5131.5,5330.5,160649,125544,26410,35168,61578,63966,2022,'EXTREMA',Extrema,'MG',3125101,8839.0,8839,736.6,736.6,3,684.0,684.0,Pequeno II
2518,2524,312520,1019,869,196,491,687,182,926.08,800.5,168.42,450.67,619.08,181.42,11113,9606,2021,5408,7429,2177,2022,'FAMA',Fama,'MG',3125200,477.0,477,43.4,43.4,1,,,Pequeno I
2519,2525,312530,1808,1640,99,1228,1327,313,1693.58,1547.17,80.92,1184.33,1265.25,281.92,20323,18566,971,14212,15183,3383,2022,'FARIA LEMOS',Faria Lemos,'MG',3125309,258.0,258,51.6,51.6,1,,,Pequeno I
2520,2526,312540,4636,3484,398,1810,2208,1276,4588.5,3539.0,399.42,1913.08,2312.5,1226.5,55062,42468,4793,22957,27750,14718,2022,'FELICIO DOS SANTOS',Felício Dos Santos,'MG',3125408,2953.0,2953,246.1,246.1,1,212.0,212.0,Pequeno I
2521,2527,312550,2326,1798,92,1062,1154,644,2264.42,1831.0,126.75,1090.67,1217.42,613.58,27173,21972,1521,13088,14609,7363,2022,'SAO GONCALO DO RIO PRETO',São Gonçalo do Rio Preto,'MG',3125507,835.0,835,69.6,69.6,1,50.0,50.0,Pequeno I
2522,2528,312560,5171,4358,319,2989,3308,1050,5147.17,4423.92,309.0,3106.0,3415.0,1008.92,61766,53087,3708,37272,40980,12107,2022,'FELISBURGO',Felisburgo,'MG',3125606,1068.0,1068,89.0,89.0,1,102.0,102.0,Pequeno I
2523,2529,312570,7009,5962,1004,3035,4039,1923,6562.17,5639.67,972.33,2996.33,3968.67,1671.0,78746,67676,11668,35956,47624,20052,2022,'FELIXLANDIA',Felixlândia,'MG',3125705,7567.0,10801,630.6,900.1,1,969.0,969.0,Pequeno I
2524,2530,312580,1952,1430,166,647,813,617,1839.92,1394.83,174.5,615.42,789.92,604.92,22079,16738,2094,7385,9479,7259,2022,'FERNANDES TOURINHO',Fernandes Tourinho,'MG',3125804,559.0,559,46.6,46.6,1,45.0,45.0,Pequeno I
2525,2531,312590,4799,3932,545,1992,2537,1395,4716.92,3940.58,473.33,2110.67,2584.0,1356.58,56603,47287,5680,25328,31008,16279,2022,'FERROS',Ferros,'MG',3125903,1068.0,1068,89.0,89.0,1,44.0,44.0,Pequeno I
2526,2532,312595,6640,5920,786,3537,4323,1597,6379.58,5724.58,706.83,3651.17,4358.0,1366.58,76555,68695,8482,43814,52296,16399,2022,'FERVEDOURO',Fervedouro,'MG',3125952,2742.0,2742,228.5,228.5,1,174.0,174.0,Pequeno I
2527,2533,312600,3867,2636,478,862,1340,1296,3414.25,2382.42,416.67,724.83,1141.5,1240.92,40971,28589,5000,8698,13698,14891,2022,'FLORESTAL',Florestal,'MG',3126000,3633.0,3633,302.8,302.8,1,348.0,348.0,Pequeno I
2528,2534,312610,20351,15325,2822,4442,7264,8061,19780.33,15112.58,2526.75,4923.33,7450.08,7662.5,237364,181351,30321,59080,89401,91950,2022,'FORMIGA',Formiga,'MG',3126109,14497.0,14497,1208.1,1208.1,4,1054.0,1054.0,Médio
2529,2535,312620,6814,5819,249,4691,4940,879,6706.5,5756.75,252.58,4637.17,4889.75,867.0,80478,69081,3031,55646,58677,10404,2022,'FORMOSO',Formoso,'MG',3126208,2495.0,2495,415.8,415.8,1,,,Pequeno I
2530,2536,312630,1038,841,175,324,499,342,978.83,800.67,165.17,317.67,482.83,317.83,11746,9608,1982,3812,5794,3814,2022,'FORTALEZA DE MINAS',Fortaleza de Minas,'MG',3126307,708.0,708,59.0,59.0,1,62.0,62.0,Pequeno I
2531,2537,312640,1669,1400,202,635,837,563,1592.58,1340.92,177.17,638.17,815.33,525.58,19111,16091,2126,7658,9784,6307,2022,'FORTUNA DE MINAS',Fortuna de Minas,'MG',3126406,979.0,979,81.6,81.6,1,93.0,93.0,Pequeno I
2532,2538,312650,5596,4210,171,2923,3094,1116,5497.33,4242.67,190.17,2929.0,3119.17,1123.5,65968,50912,2282,35148,37430,13482,2022,'FRANCISCO BADARO',Francisco Badaró,'MG',3126505,818.0,818,68.2,68.2,1,19.0,19.0,Pequeno I
2533,2539,312660,3481,2879,209,1889,2098,781,3399.5,2836.17,231.75,1869.5,2101.25,734.92,40794,34034,2781,22434,25215,8819,2022,'FRANCISCO DUMONT',Francisco Dumont,'MG',3126604,2144.0,2144,178.7,178.7,1,69.0,69.0,Pequeno I
2534,2540,312670,15626,13763,516,10564,11080,2683,14822.25,13196.33,580.17,9970.25,10550.42,2645.92,177867,158356,6962,119643,126605,31751,2022,'FRANCISCO SA',Francisco sá,'MG',3126703,1099.0,1099,91.6,91.6,2,55.0,55.0,Pequeno II
2535,2541,312675,3323,2945,173,2270,2443,502,3345.42,2984.5,153.5,2370.75,2524.25,460.25,40145,35814,1842,28449,30291,5523,2022,'FRANCISCOPOLIS',Franciscópolis,'MG',3126752,2879.0,2879,239.9,239.9,1,69.0,69.0,Pequeno I
2536,2542,312680,4233,3953,149,3453,3602,351,4171.5,3891.83,174.83,3332.25,3507.08,384.75,50058,46702,2098,39987,42085,4617,2022,'FREI GASPAR',Frei Gaspar,'MG',3126802,1031.0,1031,85.9,85.9,1,36.0,36.0,Pequeno I
2537,2543,312690,6820,5694,227,4501,4728,966,6637.83,5628.92,219.25,4463.33,4682.58,946.33,79654,67547,2631,53560,56191,11356,2022,'FREI INOCENCIO',Frei Inocêncio,'MG',3126901,2528.0,2528,210.7,210.7,1,74.0,74.0,Pequeno I
2538,2544,312695,2884,2570,89,2113,2202,368,2819.58,2532.25,82.92,2064.25,2147.17,385.08,33835,30387,995,24771,25766,4621,2022,'FREI LAGONEGRO',Frei Lagonegro,'MG',3126950,1920.0,1920,160.0,160.0,1,198.0,198.0,Pequeno I
2539,2545,312700,6112,4854,636,2386,3022,1832,5935.0,4813.5,562.42,2546.92,3109.33,1704.17,71220,57762,6749,30563,37312,20450,2022,'FRONTEIRA',Fronteira,'MG',3127008,7018.0,10224,584.8,852.0,1,502.0,502.0,Pequeno I
2540,2546,312705,3785,3439,45,3224,3269,170,3699.92,3389.42,43.33,3162.42,3205.75,183.67,44399,40673,520,37949,38469,2204,2022,'FRONTEIRA DOS VALES',Fronteira Dos Vales,'MG',3127057,2695.0,2695,224.6,224.6,1,209.0,209.0,Pequeno I
2541,2547,312707,4197,3347,228,2006,2234,1113,4193.25,3392.92,242.75,2115.17,2357.92,1035.0,50319,40715,2913,25382,28295,12420,2022,'FRUTA DE LEITE',Fruta de Leite,'MG',3127073,1710.0,1710,142.5,142.5,1,90.0,90.0,Pequeno I
2542,2548,312710,19833,14919,3829,4627,8456,6463,18185.0,13745.33,3324.42,4649.33,7973.75,5771.58,218220,164944,39893,55792,95685,69259,2022,'FRUTAL',Frutal,'MG',3127107,10174.0,10174,847.8,847.8,3,722.0,722.0,Médio
2543,2549,312720,3157,2713,304,1658,1962,751,3068.42,2620.08,304.67,1635.92,1940.58,679.5,36821,31441,3656,19631,23287,8154,2022,'FUNILANDIA',Funilândia,'MG',3127206,2124.0,2124,193.1,193.1,1,,,Pequeno I
2544,2550,312730,4220,3477,311,2155,2466,1011,4061.25,3370.92,317.92,2059.0,2376.92,994.0,48735,40451,3815,24708,28523,11928,2022,'GALILEIA',Galiléia,'MG',3127305,2039.0,2039,169.9,169.9,1,491.0,491.0,Pequeno I
2545,2551,312733,3815,3096,159,1902,2061,1035,3782.0,3101.58,163.58,1959.08,2122.67,978.92,45384,37219,1963,23509,25472,11747,2022,'GAMELEIRAS',Gameleiras,'MG',3127339,910.0,910,75.8,75.8,1,49.0,49.0,Pequeno I
2546,2552,312735,2247,1810,146,1097,1243,567,2164.42,1806.75,158.42,1080.17,1238.58,568.17,25973,21681,1901,12962,14863,6818,2022,'GLAUCILANDIA',Glaucilândia,'MG',3127354,3805.0,3805,317.1,317.1,1,365.0,365.0,Pequeno I
2547,2553,312737,2029,1632,174,1079,1253,379,1933.0,1571.83,160.0,1060.75,1220.75,351.08,23196,18862,1920,12729,14649,4213,2022,'GOIABEIRA',Goiabeira,'MG',3127370,1949.0,1949,162.4,162.4,1,129.0,129.0,Pequeno I
2548,2554,312738,2238,1755,187,1032,1219,536,2101.92,1677.17,173.58,983.0,1156.58,520.58,25223,20126,2083,11796,13879,6247,2022,'GOIANA',Goianá,'MG',3127388,2086.0,2086,173.8,173.8,1,170.0,170.0,Pequeno I
2549,2555,312740,1280,939,220,180,400,539,1225.5,916.58,207.0,191.42,398.42,518.17,14706,10999,2484,2297,4781,6218,2022,'GONCALVES',Gonçalves,'MG',3127404,1377.0,1377,114.8,114.8,1,78.0,78.0,Pequeno I
2550,2556,312750,4518,3625,496,1519,2015,1610,4554.58,3731.67,546.58,1654.33,2200.92,1530.75,54655,44780,6559,19852,26411,18369,2022,'GONZAGA',Gonzaga,'MG',3127503,2539.0,2539,211.6,211.6,1,85.0,85.0,Pequeno I
2551,2557,312760,6008,4751,738,1729,2467,2284,5757.25,4623.08,729.75,1753.83,2483.58,2139.5,69087,55477,8757,21046,29803,25674,2022,'GOUVEIA',Gouveia,'MG',3127602,4295.0,4295,357.9,357.9,1,121.0,121.0,Pequeno I
2552,2558,312770,125944,92368,17324,34473,51797,40571,119175.58,88608.25,16455.75,33361.92,49817.67,38790.58,1430107,1063299,197469,400343,597812,465487,2022,'GOVERNADOR VALADARES',Governador Valadares,'MG',3127701,41091.0,41091,3424.2,3424.2,6,4013.0,4013.0,Grande
2553,2559,312780,8138,7254,903,4322,5225,2029,7820.0,7066.67,827.67,4438.42,5266.08,1800.58,93840,84800,9932,53261,63193,21607,2022,'GRAO MOGOL',Grão Mogol,'MG',3127800,1719.0,1719,143.2,143.2,1,115.0,115.0,Pequeno I
2554,2560,312790,636,393,14,51,65,328,624.0,405.42,17.83,60.67,78.5,326.92,7488,4865,214,728,942,3923,2022,'GRUPIARA',Grupiara,'MG',3127909,809.0,809,67.4,67.4,1,42.0,42.0,Pequeno I
2555,2561,312800,17194,14630,1722,8319,10041,4589,16116.92,13709.42,1910.5,7277.58,9188.08,4521.33,193403,164513,22926,87331,110257,54256,2022,'GUANHAES',Guanhães,'MG',3128006,4884.0,4884,407.0,407.0,1,370.0,370.0,Pequeno II
2556,2562,312810,4972,3829,1188,997,2185,1644,4692.58,3674.83,1026.17,1152.92,2179.08,1495.75,56311,44098,12314,13835,26149,17949,2022,'GUAPE',Guapé,'MG',3128105,7317.0,8407,609.8,700.6,1,521.0,521.0,Pequeno I
2557,2563,312820,5071,4357,291,3015,3306,1051,4936.33,4290.25,262.25,3046.92,3309.17,981.08,59236,51483,3147,36563,39710,11773,2022,'GUARACIABA',Guaraciaba,'MG',3128204,3274.0,3274,272.8,272.8,1,218.0,218.0,Pequeno I
2558,2564,312825,3597,3207,82,2717,2799,408,3477.08,3152.25,76.83,2682.42,2759.25,393.0,41725,37827,922,32189,33111,4716,2022,'GUARACIAMA',Guaraciama,'MG',3128253,1689.0,1689,140.8,140.8,1,126.0,126.0,Pequeno I
2559,2565,312830,8617,6397,1625,1768,3393,3004,8389.5,6233.25,1478.42,1706.17,3184.58,3048.67,100674,74799,17741,20474,38215,36584,2022,'GUARANESIA',Guaranésia,'MG',3128303,2865.0,2865,238.8,238.8,2,223.0,223.0,Pequeno I
2560,2566,312840,4221,3566,449,1721,2170,1396,4089.83,3499.75,388.0,1848.42,2236.42,1263.33,49078,41997,4656,22181,26837,15160,2022,'GUARANI',Guarani,'MG',3128402,4035.0,4035,336.2,336.2,1,184.0,184.0,Pequeno I
2561,2567,312850,2693,2220,74,1490,1564,656,2550.83,2094.5,90.25,1339.0,1429.25,665.25,30610,25134,1083,16068,17151,7983,2022,'GUARARA',Guarará,'MG',3128501,2952.0,2952,246.0,246.0,1,146.0,146.0,Pequeno I
2562,2568,312860,3078,2434,685,648,1333,1101,3012.33,2420.75,631.33,670.67,1302.0,1118.75,36148,29049,7576,8048,15624,13425,2022,'GUARDA-MOR',Guarda-mor,'MG',3128600,587.0,587,48.9,48.9,1,37.0,37.0,Pequeno I
2563,2569,312870,18217,13241,2470,3457,5927,7314,17613.25,13024.0,2293.33,3440.67,5734.0,7290.0,211359,156288,27520,41288,68808,87480,2022,'GUAXUPE',Guaxupé,'MG',3128709,3638.0,3638,303.2,303.2,1,406.0,406.0,Pequeno II
2564,2570,312880,4089,3433,524,1717,2241,1192,3951.5,3363.5,324.92,1848.75,2173.67,1189.83,47418,40362,3899,22185,26084,14278,2022,'GUIDOVAL',Guidoval,'MG',3128808,4151.0,4151,345.9,345.9,1,193.0,193.0,Pequeno I
2565,2571,312890,6259,5065,312,2878,3190,1875,6058.75,4973.17,302.67,2828.5,3131.17,1842.0,72705,59678,3632,33942,37574,22104,2022,'GUIMARANIA',Guimarânia,'MG',3128907,5635.0,5635,469.6,469.6,1,214.0,214.0,Pequeno I
2566,2572,312900,3647,3251,448,1934,2382,869,3567.58,3210.25,378.75,1961.17,2339.92,870.33,42811,38523,4545,23534,28079,10444,2022,'GUIRICEMA',Guiricema,'MG',3129004,1634.0,1634,136.2,136.2,1,139.0,139.0,Pequeno I
2567,2573,312910,3172,2259,305,1204,1509,750,3036.67,2135.33,304.25,1073.33,1377.58,757.75,36440,25624,3651,12880,16531,9093,2022,'GURINHATA',Gurinhatã,'MG',3129103,1887.0,1887,157.2,157.2,1,121.0,121.0,Pequeno I
2568,2574,312920,2842,2301,428,689,1117,1184,2775.0,2278.17,438.08,734.83,1172.92,1105.25,33300,27338,5257,8818,14075,13263,2022,'HELIODORA',Heliodora,'MG',3129202,2166.0,2166,180.5,180.5,1,163.0,163.0,Pequeno I
2569,2575,312930,6526,5331,950,2634,3584,1747,6295.5,5260.42,944.83,2670.33,3615.17,1645.25,75546,63125,11338,32044,43382,19743,2022,'IAPU',Iapu,'MG',3129301,4880.0,4880,406.7,406.7,1,430.0,430.0,Pequeno I
2570,2576,312940,2972,2603,304,1276,1580,1023,2922.67,2595.33,289.75,1382.67,1672.42,922.92,35072,31144,3477,16592,20069,11075,2022,'IBERTIOGA',Ibertioga,'MG',3129400,2125.0,2125,177.1,177.1,1,35.0,35.0,Pequeno I
2571,2577,312950,9110,7345,1277,3749,5026,2319,8502.08,6809.92,1215.67,3301.25,4516.92,2293.0,102025,81719,14588,39615,54203,27516,2022,'IBIA',Ibiá,'MG',3129509,7986.0,7986,665.5,665.5,1,790.0,790.0,Pequeno II
2572,2578,312960,4969,4418,261,3265,3526,892,4962.58,4454.42,239.58,3367.08,3606.67,847.75,59551,53453,2875,40405,43280,10173,2022,'IBIAI',Ibiaí,'MG',3129608,3377.0,3377,281.4,281.4,1,75.0,75.0,Pequeno I
2573,2579,312965,4841,4215,408,2709,3117,1098,4710.5,4180.08,383.42,2770.0,3153.42,1026.67,56526,50161,4601,33240,37841,12320,2022,'IBIRACATU',Ibiracatu,'MG',3129657,3474.0,3474,289.5,289.5,1,120.0,120.0,Pequeno I
2574,2580,312970,4981,4372,548,2364,2912,1460,4647.42,4125.67,519.0,2380.17,2899.17,1226.5,55769,49508,6228,28562,34790,14718,2022,'IBIRACI',Ibiraci,'MG',3129707,0.0,22101,0.0,1841.8,1,0.0,1330.0,Pequeno I
2575,2581,312980,80113,68831,13794,28776,42570,26261,75880.08,66141.75,12639.0,29884.17,42523.17,23618.58,910561,793701,151668,358610,510278,283423,2022,'IBIRITE',Ibirité,'MG',3129806,43880.0,43880,3656.7,3656.7,7,3196.0,3196.0,Grande
2576,2582,312990,1448,1109,233,462,695,414,1407.75,1100.58,206.58,510.75,717.33,383.25,16893,13207,2479,6129,8608,4599,2022,'IBITIURA DE MINAS',Ibitiúra de Minas,'MG',3129905,1816.0,1816,151.3,151.3,1,182.0,182.0,Pequeno I
2577,2583,313000,1500,1254,126,699,825,429,1442.33,1216.5,116.75,707.58,824.33,392.17,17308,14598,1401,8491,9892,4706,2022,'IBITURUNA',Ibituruna,'MG',3130002,1232.0,1232,102.7,102.7,1,110.0,110.0,Pequeno I
2578,2584,313005,7653,6815,365,4754,5119,1696,7583.42,6829.83,376.17,4855.17,5231.33,1598.5,91001,81958,4514,58262,62776,19182,2022,'ICARAI DE MINAS',Icaraí de Minas,'MG',3130051,4852.0,4852,404.3,404.3,1,222.0,222.0,Pequeno I
2579,2585,313010,17786,15460,2761,8653,11414,4046,16470.5,14440.83,2365.0,8505.83,10870.83,3570.0,197646,173290,28380,102070,130450,42840,2022,'IGARAPE',Igarapé,'MG',3130101,13640.0,13640,1136.7,1136.7,3,835.0,835.0,Pequeno II
2580,2586,313020,3432,2900,609,505,1114,1786,3511.33,2893.25,563.42,563.92,1127.33,1765.92,42136,34719,6761,6767,13528,21191,2022,'IGARATINGA',Igaratinga,'MG',3130200,3351.0,3351,279.2,279.2,1,198.0,198.0,Pequeno I
2581,2587,313030,3054,2452,209,1674,1883,569,2875.0,2316.75,187.42,1576.83,1764.25,552.5,34500,27801,2249,18922,21171,6630,2022,'IGUATAMA',Iguatama,'MG',3130309,4957.0,4957,413.1,413.1,1,697.0,697.0,Pequeno I
2582,2588,313040,2987,2652,154,1554,1708,944,2821.0,2511.67,157.33,1524.08,1681.42,830.25,33852,30140,1888,18289,20177,9963,2022,'IJACI',Ijaci,'MG',3130408,380.0,380,42.2,42.2,1,21.0,21.0,Pequeno I
2583,2589,313050,5627,4596,840,1074,1914,2682,5402.0,4467.08,849.83,1169.17,2019.0,2448.08,64824,53605,10198,14030,24228,29377,2022,'ILICINEA',Ilicínea,'MG',3130507,3483.0,3483,290.2,290.2,1,240.0,240.0,Pequeno I
2584,2590,313055,5521,4991,1843,2287,4130,861,5392.58,4976.08,1273.17,2987.25,4260.42,715.67,64711,59713,15278,35847,51125,8588,2022,'IMBE DE MINAS',Imbé de Minas,'MG',3130556,2663.0,2663,221.9,221.9,1,102.0,102.0,Pequeno I
2585,2591,313060,2947,2325,598,494,1092,1233,2749.25,2222.83,575.08,495.58,1070.67,1152.17,32991,26674,6901,5947,12848,13826,2022,'INCONFIDENTES',Inconfidentes,'MG',3130606,4534.0,4534,377.8,377.8,1,420.0,420.0,Pequeno I
2586,2592,313065,5068,4660,130,3827,3957,703,5036.25,4665.75,187.25,3734.83,3922.08,743.67,60435,55989,2247,44818,47065,8924,2022,'INDAIABIRA',Indaiabira,'MG',3130655,788.0,788,65.7,65.7,1,27.0,27.0,Pequeno I
2587,2593,313070,2621,2235,276,1065,1341,894,2600.25,2229.75,242.0,1167.33,1409.33,820.42,31203,26757,2904,14008,16912,9845,2022,'INDIANOPOLIS',Indianópolis,'MG',3130705,2604.0,2604,217.0,217.0,1,412.0,412.0,Pequeno I
2588,2594,313080,1230,999,204,329,533,466,1169.58,967.5,199.83,312.58,512.42,455.08,14035,11610,2398,3751,6149,5461,2022,'INGAI',Ingaí,'MG',3130804,847.0,847,70.6,70.6,1,80.0,80.0,Pequeno I
2589,2595,313090,15447,13631,720,9531,10251,3380,14871.0,13286.17,825.75,9228.42,10054.17,3232.0,178452,159434,9909,110741,120650,38784,2022,'INHAPIM',Inhapim,'MG',3130903,10190.0,10190,849.2,849.2,1,790.0,790.0,Pequeno II
2590,2596,313100,3809,3330,219,2277,2496,834,3702.5,3248.08,174.67,2304.58,2479.25,768.83,44430,38977,2096,27655,29751,9226,2022,'INHAUMA',Inhaúma,'MG',3131000,2214.0,2214,184.5,184.5,1,113.0,113.0,Pequeno I
2591,2597,313110,4453,3491,406,1582,1988,1503,4281.42,3442.92,373.25,1648.17,2021.42,1421.5,51377,41315,4479,19778,24257,17058,2022,'INIMUTABA',Inimutaba,'MG',3131109,4069.0,4069,339.1,339.1,1,69.0,69.0,Pequeno I
2592,2598,313115,8904,7551,872,4004,4876,2675,8687.42,7488.17,933.92,3950.58,4884.5,2603.67,104249,89858,11207,47407,58614,31244,2022,'IPABA',Ipaba,'MG',3131158,3433.0,3433,286.1,286.1,1,400.0,400.0,Pequeno I
2593,2599,313120,10026,8355,604,5578,6182,2173,9714.67,8192.67,541.75,5613.0,6154.75,2037.92,116576,98312,6501,67356,73857,24455,2022,'IPANEMA',Ipanema,'MG',3131208,5747.0,5747,478.9,478.9,1,917.0,917.0,Pequeno I
2594,2600,313130,93900,76642,8886,41589,50475,26167,89999.5,74469.92,8365.25,40820.5,49185.75,25284.17,1079994,893639,100383,489846,590229,303410,2022,'IPATINGA',Ipatinga,'MG',3131307,38619.0,38619,3218.2,3218.2,5,2751.0,2751.0,Grande
2595,2601,313140,1857,1460,106,1064,1170,290,1719.0,1359.5,87.58,1026.75,1114.33,245.17,20628,16314,1051,12321,13372,2942,2022,'IPIACU',Ipiaçu,'MG',3131406,3053.0,3053,254.4,254.4,1,89.0,89.0,Pequeno I
2596,2602,313150,4488,3596,1160,464,1624,1972,4285.25,3551.33,1197.58,561.75,1759.33,1792.0,51423,42616,14371,6741,21112,21504,2022,'IPUIUNA',Ipuiúna,'MG',3131505,1983.0,1983,165.2,165.2,1,96.0,96.0,Pequeno I
2597,2603,313160,3882,3241,86,2364,2450,791,3595.67,3076.5,85.67,2272.42,2358.08,718.42,43148,36918,1028,27269,28297,8621,2022,'IRAI DE MINAS',Iraí de Minas,'MG',3131604,5250.0,5250,437.5,437.5,1,299.0,299.0,Pequeno I
2598,2604,313170,37062,29885,5295,10418,15713,14172,35156.17,29005.25,5236.75,10224.42,15461.17,13544.08,421874,348063,62841,122693,185534,162529,2022,'ITABIRA',Itabira,'MG',3131703,20750.0,20750,1729.2,1729.2,5,1561.0,1561.0,Grande
2599,2605,313180,7330,5794,448,3756,4204,1590,6877.58,5448.75,501.42,3465.67,3967.08,1481.67,82531,65385,6017,41588,47605,17780,2022,'ITABIRINHA DE MANTENA',Itabirinha,'MG',3131802,3473.0,3473,289.4,289.4,1,272.0,272.0,Pequeno I
2600,2606,313190,14666,11731,2233,4301,6534,5197,13869.17,11267.25,2139.25,3970.67,6109.92,5157.33,166430,135207,25671,47648,73319,61888,2022,'ITABIRITO',Itabirito,'MG',3131901,8657.0,8657,721.4,721.4,2,734.0,734.0,Pequeno II
2601,2607,313200,3231,2858,92,2255,2347,511,3217.33,2879.75,84.0,2321.67,2405.67,474.08,38608,34557,1008,27860,28868,5689,2022,'ITACAMBIRA',Itacambira,'MG',3132008,614.0,614,51.2,51.2,1,29.0,29.0,Pequeno I
2602,2608,313210,12056,10671,1264,6655,7919,2752,11715.08,10444.08,1291.25,6404.0,7695.25,2748.83,140581,125329,15495,76848,92343,32986,2022,'ITACARAMBI',Itacarambi,'MG',3132107,5378.0,11870,448.2,989.2,1,628.0,628.0,Pequeno I
2603,2609,313220,5768,4206,615,1711,2326,1880,5299.0,3965.17,547.17,1631.0,2178.17,1787.0,63588,47582,6566,19572,26138,21444,2022,'ITAGUARA',Itaguara,'MG',3132206,2455.0,2455,204.6,204.6,1,163.0,163.0,Pequeno I
2604,2610,313230,8357,7507,218,6123,6341,1166,8288.33,7517.75,217.75,6191.92,6409.67,1108.08,99460,90213,2613,74303,76916,13297,2022,'ITAIPE',Itaipé,'MG',3132305,3928.0,3928,327.3,327.3,1,232.0,232.0,Pequeno I
2605,2611,313240,31537,25211,3125,13224,16349,8862,29210.33,23379.0,3022.33,12027.08,15049.42,8329.58,350524,280548,36268,144325,180593,99955,2022,'ITAJUBA',Itajubá,'MG',3132404,8042.0,8042,670.2,670.2,2,324.0,324.0,Médio
2606,2612,313250,20210,16418,3261,7020,10281,6137,19646.83,16188.08,3000.58,7205.0,10205.58,5982.5,235762,194257,36007,86460,122467,71790,2022,'ITAMARANDIBA',Itamarandiba,'MG',3132503,6135.0,6135,511.2,511.2,2,397.0,397.0,Pequeno II
2607,2613,313260,2214,1767,238,874,1112,655,2116.58,1716.25,276.92,820.5,1097.42,618.83,25399,20595,3323,9846,13169,7426,2022,'ITAMARATI DE MINAS',Itamarati de Minas,'MG',3132602,3645.0,3645,303.8,303.8,1,306.0,306.0,Pequeno I
2608,2614,313270,16713,14959,897,12341,13238,1721,15914.33,14262.83,1011.5,11387.33,12398.83,1864.0,190972,171154,12138,136648,148786,22368,2022,'ITAMBACURI',Itambacuri,'MG',3132701,3367.0,3367,280.6,280.6,1,313.0,313.0,Pequeno II
2609,2615,313280,1381,1023,149,448,597,426,1356.58,1024.17,153.58,440.17,593.75,430.42,16279,12290,1843,5282,7125,5165,2022,'ITAMBE DO MATO DENTRO',Itambé do Mato Dentro,'MG',3132800,302.0,302,25.2,25.2,1,20.0,20.0,Pequeno I
2610,2616,313290,3704,3190,923,1004,1927,1263,3502.33,3018.67,811.08,1072.42,1883.5,1135.17,42028,36224,9733,12869,22602,13622,2022,'ITAMOGI',Itamogi,'MG',3132909,491.0,491,40.9,40.9,1,63.0,63.0,Pequeno I
2611,2617,313300,5673,4724,1086,1476,2562,2162,5325.83,4493.0,1048.33,1410.33,2458.67,2034.33,63910,53916,12580,16924,29504,24412,2022,'ITAMONTE',Itamonte,'MG',3133006,2376.0,2376,198.0,198.0,1,36.0,36.0,Pequeno I
2612,2618,313310,4929,4169,807,1097,1904,2265,4494.58,3842.33,743.25,1087.0,1830.25,2012.08,53935,46108,8919,13044,21963,24145,2022,'ITANHANDU',Itanhandu,'MG',3133105,3052.0,3052,254.3,254.3,1,302.0,302.0,Pequeno I
2613,2619,313320,5987,4915,1177,1711,2888,2027,5780.5,4754.08,1030.42,1813.08,2843.5,1910.58,69366,57049,12365,21757,34122,22927,2022,'ITANHOMI',Itanhomi,'MG',3133204,1580.0,1580,131.7,131.7,1,64.0,64.0,Pequeno I
2614,2620,313330,11816,9899,806,6316,7122,2777,11512.33,9815.42,740.83,6411.92,7152.75,2662.67,138148,117785,8890,76943,85833,31952,2022,'ITAOBIM',Itaobim,'MG',3133303,4125.0,4125,343.8,343.8,2,588.0,588.0,Pequeno II
2615,2621,313340,4273,3639,278,2572,2850,789,3822.83,3222.17,246.25,2296.75,2543.0,679.17,45874,38666,2955,27561,30516,8150,2022,'ITAPAGIPE',Itapagipe,'MG',3133402,2585.0,2585,215.4,215.4,1,354.0,354.0,Pequeno I
2616,2622,313350,9252,6754,924,2602,3526,3228,8957.0,6635.58,835.42,2533.08,3368.5,3267.08,107484,79627,10025,30397,40422,39205,2022,'ITAPECERICA',Itapecerica,'MG',3133501,7225.0,7225,602.1,602.1,2,476.0,476.0,Pequeno II
2617,2623,313360,4662,3614,722,1669,2391,1223,4323.08,3409.83,646.58,1629.92,2276.5,1133.33,51877,40918,7759,19559,27318,13600,2022,'ITAPEVA',Itapeva,'MG',3133600,2170.0,2170,180.8,180.8,1,118.0,118.0,Pequeno I
2618,2624,313370,5049,4124,899,1404,2303,1821,4762.42,4012.5,824.92,1455.58,2280.5,1732.0,57149,48150,9899,17467,27366,20784,2022,'ITATIAIUCU',Itatiaiuçu,'MG',3133709,8555.0,9579,777.7,870.8,1,792.0,792.0,Pequeno I
2619,2625,313375,5613,4080,873,968,1841,2239,5385.83,4031.75,824.58,997.83,1822.42,2209.33,64630,48381,9895,11974,21869,26512,2022,'ITAU DE MINAS',Itaú de Minas,'MG',3133758,9092.0,9092,757.7,757.7,1,687.0,687.0,Pequeno I
2620,2626,313380,19908,15678,2741,6802,9543,6135,18584.42,14882.08,2504.5,6812.58,9317.08,5565.0,223013,178585,30054,81751,111805,66780,2022,'ITAUNA',Itaúna,'MG',3133808,5687.0,5687,473.9,473.9,3,409.0,409.0,Médio
2621,2627,313390,2696,2441,208,1580,1788,653,2655.92,2431.92,229.83,1572.83,1802.67,629.25,31871,29183,2758,18874,21632,7551,2022,'ITAVERAVA',Itaverava,'MG',3133907,463.0,463,38.6,38.6,1,8.0,8.0,Pequeno I
2622,2628,313400,10051,8361,421,6078,6499,1862,9757.42,8319.75,440.08,6175.67,6615.75,1704.0,117089,99837,5281,74108,79389,20448,2022,'ITINGA',Itinga,'MG',3134004,4602.0,4602,383.5,383.5,1,407.0,407.0,Pequeno I
2623,2629,313410,4028,3297,863,1651,2514,783,3867.42,3172.17,712.0,1639.5,2351.5,820.67,46409,38066,8544,19674,28218,9848,2022,'ITUETA',Itueta,'MG',3134103,868.0,868,72.3,72.3,1,50.0,50.0,Pequeno I
2624,2630,313420,40569,27085,7122,6175,13297,13788,38783.58,26008.5,6842.25,5079.33,11921.58,14086.92,465403,312102,82107,60952,143059,169043,2022,'ITUIUTABA',Ituiutaba,'MG',3134202,75323.0,75323,6276.9,6276.9,6,5235.0,5235.0,Médio
2625,2631,313430,3477,3032,252,2163,2415,617,3247.83,2837.67,306.5,1798.42,2104.92,732.75,38974,34052,3678,21581,25259,8793,2022,'ITUMIRIM',Itumirim,'MG',3134301,1184.0,1184,98.7,98.7,1,83.0,83.0,Pequeno I
2626,2632,313440,16779,13874,498,10636,11134,2740,15554.5,12816.42,548.25,9594.0,10142.25,2674.17,186654,153797,6579,115128,121707,32090,2022,'ITURAMA',Iturama,'MG',3134400,26735.0,26735,2227.9,2227.9,2,504.0,504.0,Pequeno II
2627,2633,313450,2184,1693,328,468,796,897,2129.83,1697.92,317.75,509.33,827.08,870.83,25558,20375,3813,6112,9925,10450,2022,'ITUTINGA',Itutinga,'MG',3134509,1136.0,1136,94.7,94.7,1,99.0,99.0,Pequeno I
2628,2634,313460,7498,6527,1286,2928,4214,2313,6937.0,6095.5,1214.67,2863.08,4077.75,2017.75,83244,73146,14576,34357,48933,24213,2022,'JABOTICATUBAS',Jaboticatubas,'MG',3134608,5600.0,5600,466.7,466.7,2,326.0,326.0,Pequeno I
2629,2635,313470,7709,6732,427,5071,5498,1234,7594.17,6656.75,425.0,5030.08,5455.08,1201.67,91130,79881,5100,60361,65461,14420,2022,'JACINTO',Jacinto,'MG',3134707,1826.0,1826,152.2,152.2,1,113.0,113.0,Pequeno I
2630,2636,313480,3708,2589,305,992,1297,1292,3395.25,2402.0,270.0,848.92,1118.92,1283.08,40743,28824,3240,10187,13427,15397,2022,'JACUI',Jacuí,'MG',3134806,6548.0,6548,545.7,545.7,1,439.0,439.0,Pequeno I
2631,2637,313490,9167,5961,1229,1390,2619,3342,8583.17,5714.75,1137.75,1561.75,2699.5,3015.25,102998,68577,13653,18741,32394,36183,2022,'JACUTINGA',Jacutinga,'MG',3134905,13530.0,13530,1127.5,1127.5,1,594.0,594.0,Pequeno II
2632,2638,313500,1625,1187,166,496,662,525,1620.08,1255.25,130.17,525.5,655.67,599.58,19441,15063,1562,6306,7868,7195,2022,'JAGUARACU',Jaguaraçu,'MG',3135001,6724.0,11341,560.3,945.1,1,0.0,1240.0,Pequeno I
2633,2639,313505,29613,26907,1254,21230,22484,4423,28410.0,25996.33,1162.75,20741.08,21903.83,4092.5,340920,311956,13953,248893,262846,49110,2022,'JAIBA',Jaíba,'MG',3135050,12944.0,29963,1078.7,2496.9,1,1100.0,1100.0,Pequeno II
2634,2640,313507,3821,3280,159,2411,2570,710,3817.08,3321.0,161.17,2515.83,2677.0,644.0,45805,39852,1934,30190,32124,7728,2022,'JAMPRUCA',Jampruca,'MG',3135076,1203.0,1203,109.4,109.4,1,54.0,54.0,Pequeno I
2635,2641,313510,45335,37553,3704,20069,23773,13780,43400.67,36334.42,3820.42,18874.67,22695.08,13639.33,520808,436013,45845,226496,272341,163672,2022,'JANAUBA',Janaúba,'MG',3135100,12457.0,12457,1038.1,1038.1,3,779.0,779.0,Médio
2636,2642,313520,45186,39210,2147,29215,31362,7848,43820.92,38248.67,2161.25,28593.92,30755.17,7493.5,525851,458984,25935,343127,369062,89922,2022,'JANUARIA',Januária,'MG',3135209,12663.0,12663,1055.2,1055.2,3,904.0,904.0,Médio
2637,2643,313530,1951,1527,266,555,821,706,1871.58,1514.92,235.0,546.0,781.0,733.92,22459,18179,2820,6552,9372,8807,2022,'JAPARAIBA',Japaraíba,'MG',3135308,2665.0,2665,222.1,222.1,1,144.0,144.0,Pequeno I
2638,2644,313535,7098,5979,658,3513,4171,1808,6925.58,5954.92,620.67,3628.75,4249.42,1705.5,83107,71459,7448,43545,50993,20466,2022,'JAPONVAR',Japonvar,'MG',3135357,930.0,930,77.5,77.5,1,51.0,51.0,Pequeno I
2639,2645,313540,2780,2237,343,906,1249,988,2642.83,2185.75,339.5,942.17,1281.67,904.08,31714,26229,4074,11306,15380,10849,2022,'JECEABA',Jeceaba,'MG',3135407,2806.0,2806,233.8,233.8,1,134.0,134.0,Pequeno I
2640,2646,313545,4058,3642,572,1597,2169,1473,3951.67,3577.42,492.25,1828.83,2321.08,1256.33,47420,42929,5907,21946,27853,15076,2022,'JENIPAPO DE MINAS',Jenipapo de Minas,'MG',3135456,1617.0,1617,134.8,134.8,1,90.0,90.0,Pequeno I
2641,2647,313550,6627,5647,691,3611,4302,1345,6335.92,5455.75,656.92,3515.83,4172.75,1283.0,76031,65469,7883,42190,50073,15396,2022,'JEQUERI',Jequeri,'MG',3135506,3673.0,3673,306.1,306.1,1,39.0,39.0,Pequeno I
2642,2648,313560,6015,4951,68,4362,4430,521,5789.58,4808.75,73.0,4222.83,4295.83,512.92,69475,57705,876,50674,51550,6155,2022,'JEQUITAI',Jequitaí,'MG',3135605,1310.0,1310,109.2,109.2,1,52.0,52.0,Pequeno I
2643,2649,313570,3170,2717,571,1147,1718,999,3078.92,2713.58,532.08,1250.33,1782.42,931.17,36947,32563,6385,15004,21389,11174,2022,'JEQUITIBA',Jequitibá,'MG',3135704,4165.0,5345,347.1,445.4,1,342.0,342.0,Pequeno I
2644,2650,313580,16142,13637,945,9414,10359,3278,15773.25,13455.0,1071.92,8993.0,10064.92,3390.08,189279,161460,12863,107916,120779,40681,2022,'JEQUITINHONHA',Jequitinhonha,'MG',3135803,2393.0,2393,199.4,199.4,1,143.0,143.0,Pequeno II
2645,2651,313590,3380,2987,642,1612,2254,733,3254.42,2904.58,582.92,1617.58,2200.5,704.08,39053,34855,6995,19411,26406,8449,2022,'JESUANIA',Jesuânia,'MG',3135902,2642.0,2642,220.2,220.2,1,145.0,145.0,Pequeno I
2646,2652,313600,11596,10393,303,9035,9338,1055,11402.33,10256.92,308.67,8877.33,9186.0,1070.92,136828,123083,3704,106528,110232,12851,2022,'JOAIMA',Joaíma,'MG',3136009,3016.0,3016,251.3,251.3,1,248.0,248.0,Pequeno I
2647,2653,313610,2781,2395,229,1431,1660,735,2752.08,2390.75,217.92,1479.67,1697.58,693.17,33025,28689,2615,17756,20371,8318,2022,'JOANESIA',Joanésia,'MG',3136108,1398.0,1398,116.5,116.5,1,179.0,179.0,Pequeno I
2648,2654,313620,17128,14807,1706,9107,10813,3994,16084.08,13934.42,1550.5,8580.25,10130.75,3803.67,193009,167213,18606,102963,121569,45644,2022,'JOAO MONLEVADE',João Monlevade,'MG',3136207,8298.0,8298,691.5,691.5,1,940.0,940.0,Médio
2649,2655,313630,24710,20136,2455,11576,14031,6105,23553.75,19282.5,2227.58,11401.5,13629.08,5653.42,282645,231390,26731,136818,163549,67841,2022,'JOAO PINHEIRO',João Pinheiro,'MG',3136306,6522.0,6522,543.5,543.5,3,371.0,371.0,Pequeno II
2650,2656,313640,3038,2395,219,1721,1940,455,2914.83,2285.42,224.92,1572.67,1797.58,487.83,34978,27425,2699,18872,21571,5854,2022,'JOAQUIM FELICIO',Joaquim Felício,'MG',3136405,1519.0,1519,126.6,126.6,1,100.0,100.0,Pequeno I
2651,2657,313650,5498,4731,452,2847,3299,1432,5334.83,4655.92,424.92,2925.58,3350.5,1305.42,64018,55871,5099,35107,40206,15665,2022,'JORDANIA',Jordânia,'MG',3136504,1943.0,1943,161.9,161.9,1,269.0,269.0,Pequeno I
2652,2658,313652,2753,2501,202,1719,1921,580,2637.75,2447.17,211.25,1733.5,1944.75,502.42,31653,29366,2535,20802,23337,6029,2022,'JOSE GONCALVES DE MINAS',José Gonçalves de Minas,'MG',3136520,2022.0,2022,168.5,168.5,1,129.0,129.0,Pequeno I
2653,2659,313655,3133,2741,199,1999,2198,543,3045.42,2677.58,203.92,1934.75,2138.67,538.92,36545,32131,2447,23217,25664,6467,2022,'JOSE RAYDAN',José Raydan,'MG',3136553,1861.0,1861,155.1,155.1,1,59.0,59.0,Pequeno I
2654,2660,313657,3208,2711,162,1772,1934,777,3203.17,2749.83,138.42,1883.67,2022.08,727.75,38438,32998,1661,22604,24265,8733,2022,'JOSENOPOLIS',Josenópolis,'MG',3136579,605.0,605,50.4,50.4,1,47.0,47.0,Pequeno I
2655,2661,313660,3329,2928,261,2028,2289,639,3154.92,2800.33,250.92,1935.92,2186.83,613.5,37859,33604,3011,23231,26242,7362,2022,'NOVA UNIAO',Nova União,'MG',3136603,2510.0,2510,209.2,209.2,1,186.0,186.0,Pequeno I
2656,2662,313665,16672,14098,1458,8628,10086,4012,15592.0,13364.42,1246.92,8452.25,9699.17,3665.25,187104,160373,14963,101427,116390,43983,2022,'JUATUBA',Juatuba,'MG',3136652,8443.0,8443,703.6,703.6,2,758.0,758.0,Pequeno II
2657,2663,313670,158433,122500,17538,57762,75300,47200,146083.08,113414.0,15941.33,53597.67,69539.0,43875.0,1752997,1360968,191296,643172,834468,526500,2022,'JUIZ DE FORA',Juiz de Fora,'MG',3136702,119032.0,119032,9919.3,9919.3,11,8335.0,8335.0,Grande
2658,2664,313680,3008,2607,111,1647,1758,849,2956.58,2598.83,130.83,1686.83,1817.67,781.17,35479,31186,1570,20242,21812,9374,2022,'JURAMENTO',Juramento,'MG',3136801,3575.0,3575,297.9,297.9,1,233.0,233.0,Pequeno I
2659,2665,313690,3352,2700,564,527,1091,1609,3130.83,2536.92,547.5,660.5,1208.0,1328.92,37570,30443,6570,7926,14496,15947,2022,'JURUAIA',Juruaia,'MG',3136900,1966.0,1966,163.8,163.8,1,140.0,140.0,Pequeno I
2660,2666,313695,5198,4262,293,2854,3147,1115,5122.17,4254.42,297.42,2904.25,3201.67,1052.75,61466,51053,3569,34851,38420,12633,2022,'JUVENILIA',Juvenília,'MG',3136959,1024.0,1024,85.3,85.3,1,45.0,45.0,Pequeno I
2661,2667,313700,9612,8985,753,7177,7930,1055,9375.08,8802.08,761.58,7036.25,7797.83,1004.25,112501,105625,9139,84435,93574,12051,2022,'LADAINHA',Ladainha,'MG',3137007,6444.0,7895,537.0,657.9,1,589.0,589.0,Pequeno I
2662,2668,313710,3693,3009,330,1870,2200,809,3581.33,2967.33,264.75,1960.58,2225.33,742.0,42976,35608,3177,23527,26704,8904,2022,'LAGAMAR',Lagamar,'MG',3137106,3351.0,3351,279.2,279.2,1,327.0,327.0,Pequeno I
2663,2669,313720,19912,15627,2262,6718,8980,6647,18477.25,14608.83,2142.83,6047.83,8190.67,6418.17,221727,175306,25714,72574,98288,77018,2022,'LAGOA DA PRATA',Lagoa da Prata,'MG',3137205,10450.0,10450,870.8,870.8,3,510.0,510.0,Pequeno II
2664,2670,313730,3323,2764,145,1817,1962,802,3259.0,2732.0,164.67,1798.92,1963.58,768.42,39108,32784,1976,21587,23563,9221,2022,'LAGOA DOS PATOS',Lagoa Dos Patos,'MG',3137304,1129.0,1129,94.1,94.1,1,86.0,86.0,Pequeno I
2665,2671,313740,6728,5925,1466,1307,2773,3152,6460.25,5739.33,1454.75,1263.58,2718.33,3021.0,77523,68872,17457,15163,32620,36252,2022,'LAGOA DOURADA',Lagoa Dourada,'MG',3137403,2622.0,2622,218.5,218.5,1,97.0,97.0,Pequeno I
2666,2672,313750,6739,5833,999,3201,4200,1633,6245.08,5416.17,934.92,2883.42,3818.33,1597.83,74941,64994,11219,34601,45820,19174,2022,'LAGOA FORMOSA',Lagoa Formosa,'MG',3137502,6530.0,6530,544.2,544.2,1,427.0,427.0,Pequeno I
2667,2673,313753,5851,4498,946,1616,2562,1936,5729.42,4428.17,748.25,1867.33,2615.58,1812.58,68753,53138,8979,22408,31387,21751,2022,'LAGOA GRANDE',Lagoa Grande,'MG',3137536,668.0,668,60.7,60.7,1,36.0,36.0,Pequeno I
2668,2674,313760,19008,16112,2776,7216,9992,6120,17662.08,15073.58,2612.42,6932.25,9544.67,5528.92,211945,180883,31349,83187,114536,66347,2022,'LAGOA SANTA',Lagoa Santa,'MG',3137601,9558.0,9558,796.5,796.5,3,489.0,489.0,Médio
2669,2675,313770,12761,11169,546,8586,9132,2037,12248.42,10756.58,546.33,8275.08,8821.42,1935.17,146981,129079,6556,99301,105857,23222,2022,'LAJINHA',Lajinha,'MG',3137700,3000.0,3000,300.0,300.0,1,207.0,207.0,Pequeno I
2670,2676,313780,11801,9810,1536,3266,4802,5008,11456.5,9594.08,1239.5,3332.08,4571.58,5022.5,137478,115129,14874,39985,54859,60270,2022,'LAMBARI',Lambari,'MG',3137809,4134.0,8585,344.5,715.4,1,512.0,512.0,Pequeno I
2671,2677,313790,1887,1668,228,973,1201,467,1775.67,1604.08,216.67,944.5,1161.17,442.92,21308,19249,2600,11334,13934,5315,2022,'LAMIM',Lamim,'MG',3137908,639.0,639,53.2,53.2,1,59.0,59.0,Pequeno I
2672,2678,313800,3429,2783,310,1509,1819,964,3326.67,2745.75,282.5,1490.25,1772.75,973.0,39920,32949,3390,17883,21273,11676,2022,'LARANJAL',Laranjal,'MG',3138005,3158.0,3158,263.2,263.2,1,197.0,197.0,Pequeno I
2673,2679,313810,4738,4106,230,3135,3365,741,4513.92,3976.67,204.17,3097.75,3301.92,674.75,54167,47720,2450,37173,39623,8097,2022,'LASSANCE',Lassance,'MG',3138104,5355.0,5355,446.2,446.2,1,465.0,465.0,Pequeno I
2674,2680,313820,50887,35961,6189,10098,16287,19674,49344.25,35292.42,5990.17,9781.5,15771.67,19520.75,592131,423509,71882,117378,189260,234249,2022,'LAVRAS',Lavras,'MG',3138203,22643.0,22643,2058.5,2058.5,7,1597.0,1597.0,Médio
2675,2681,313830,1330,1070,251,346,597,473,1282.0,1023.92,216.0,385.42,601.42,422.5,15384,12287,2592,4625,7217,5070,2022,'LEANDRO FERREIRA',Leandro Ferreira,'MG',3138302,905.0,905,75.4,75.4,1,75.0,75.0,Pequeno I
2676,2682,313835,2886,2412,276,1137,1413,999,2790.0,2427.25,294.58,1207.75,1502.33,924.92,33480,29127,3535,14493,18028,11099,2022,'LEME DO PRADO',Leme do Prado,'MG',3138351,4946.0,6592,412.2,549.3,1,148.0,148.0,Pequeno I
2677,2683,313840,23878,20523,4954,5652,10606,9917,22578.25,19541.42,4571.83,5552.92,10124.75,9416.67,270939,234497,54862,66635,121497,113000,2022,'LEOPOLDINA',Leopoldina,'MG',3138401,28812.0,28812,2401.0,2401.0,3,2160.0,2160.0,Médio
2678,2684,313850,2645,2294,413,1115,1528,766,2581.67,2260.5,402.33,1104.17,1506.5,754.0,30980,27126,4828,13250,18078,9048,2022,'LIBERDADE',Liberdade,'MG',3138500,2507.0,2507,208.9,208.9,1,152.0,152.0,Pequeno I
2679,2685,313860,8322,6846,1009,3092,4101,2745,7847.92,6529.42,986.58,2982.58,3969.17,2560.25,94175,78353,11839,35791,47630,30723,2022,'LIMA DUARTE',Lima Duarte,'MG',3138609,5679.0,5679,516.3,516.3,1,390.0,390.0,Pequeno I
2680,2686,313862,3005,1980,145,959,1104,876,2871.08,1902.92,128.17,938.25,1066.42,836.5,34453,22835,1538,11259,12797,10038,2022,'LIMEIRA DO OESTE',Limeira do Oeste,'MG',3138625,1316.0,1316,109.7,109.7,1,64.0,64.0,Pequeno I
2681,2687,313865,7324,6466,230,4754,4984,1482,7206.42,6392.17,249.33,4722.08,4971.42,1420.75,86477,76706,2992,56665,59657,17049,2022,'LONTRA',Lontra,'MG',3138658,2638.0,2638,219.8,219.8,1,192.0,192.0,Pequeno I
2682,2688,313867,4724,4007,875,1896,2771,1236,4569.75,3964.42,765.58,2128.33,2893.92,1070.5,54837,47573,9187,25540,34727,12846,2022,'LUISBURGO',Luisburgo,'MG',3138674,5470.0,5470,455.8,455.8,1,435.0,435.0,Pequeno I
2683,2689,313868,5535,4720,240,3375,3615,1105,5429.17,4749.33,223.25,3463.42,3686.67,1062.67,65150,56992,2679,41561,44240,12752,2022,'LUISLANDIA',Luislândia,'MG',3138682,6393.0,6393,532.8,532.8,1,779.0,779.0,Pequeno I
2684,2690,313870,3081,2299,339,897,1236,1063,2931.58,2226.67,284.42,889.58,1174.0,1052.67,35179,26720,3413,10675,14088,12632,2022,'LUMINARIAS',Luminárias,'MG',3138708,1644.0,1644,137.0,137.0,1,44.0,44.0,Pequeno I
2685,2691,313880,6382,5273,858,2455,3313,1960,5786.67,4808.17,653.42,2387.17,3040.58,1767.58,69440,57698,7841,28646,36487,21211,2022,'LUZ',Luz,'MG',3138807,5257.0,5257,438.1,438.1,1,401.0,401.0,Pequeno I
2686,2692,313890,5278,4286,139,3278,3417,869,5045.67,4162.67,132.42,3162.92,3295.33,867.33,60548,49952,1589,37955,39544,10408,2022,'MACHACALIS',Machacalis,'MG',3138906,1606.0,1606,133.8,133.8,1,325.0,325.0,Pequeno I
2687,2693,313900,16923,13039,3535,3323,6858,6181,15741.92,12281.25,3136.33,3203.5,6339.83,5941.42,188903,147375,37636,38442,76078,71297,2022,'MACHADO',Machado,'MG',3139003,5561.0,5561,463.4,463.4,3,2386.0,2386.0,Pequeno II
2688,2694,313910,2538,2086,413,511,924,1162,2379.92,1977.75,396.92,477.08,874.0,1103.75,28559,23733,4763,5725,10488,13245,2022,'MADRE DE DEUS DE MINAS',Madre de Deus de Minas,'MG',3139102,1954.0,1954,162.8,162.8,1,125.0,125.0,Pequeno I
2689,2695,313920,9231,8022,1505,4073,5578,2444,9080.42,7974.33,1412.33,4203.42,5615.75,2358.58,108965,95692,16948,50441,67389,28303,2022,'MALACACHETA',Malacacheta,'MG',3139201,4844.0,4844,403.7,403.7,1,105.0,105.0,Pequeno I
2690,2696,313925,4598,3764,429,2250,2679,1085,4435.92,3760.25,382.75,2412.0,2794.75,965.5,53231,45123,4593,28944,33537,11586,2022,'MAMONAS',Mamonas,'MG',3139250,1030.0,1030,85.8,85.8,1,111.0,111.0,Pequeno I
2691,2697,313930,15259,13166,1078,8637,9715,3451,14886.25,13003.33,1004.33,8731.75,9736.08,3267.25,178635,156040,12052,104781,116833,39207,2022,'MANGA',Manga,'MG',3139300,0.0,39016,0.0,3251.3,1,0.0,2883.0,Pequeno I
2692,2698,313940,33210,28399,6574,7184,13758,14641,30893.92,26587.75,5374.83,7415.75,12790.58,13797.17,370727,319053,64498,88989,153487,165566,2022,'MANHUACU',Manhuaçu,'MG',3139409,6942.0,6942,578.5,578.5,1,487.0,487.0,Médio
2693,2699,313950,13459,11507,642,8226,8868,2639,12978.92,11203.42,647.67,8050.0,8697.67,2505.75,155747,134441,7772,96600,104372,30069,2022,'MANHUMIRIM',Manhumirim,'MG',3139508,8127.0,8127,677.2,677.2,1,531.0,531.0,Pequeno II
2694,2700,313960,15730,11930,2062,4571,6633,5297,15122.42,11532.42,2135.0,4066.25,6201.25,5331.17,181469,138389,25620,48795,74415,63974,2022,'MANTENA',Mantena,'MG',3139607,3879.0,3879,323.2,323.2,1,198.0,198.0,Pequeno II
2695,2701,313970,4597,4071,138,2668,2806,1265,4422.25,3982.17,148.25,2604.17,2752.42,1229.75,53067,47786,1779,31250,33029,14757,2022,'MARAVILHAS',Maravilhas,'MG',3139706,352.0,352,29.3,29.3,1,30.0,30.0,Pequeno I
2696,2702,313980,4368,3545,696,1403,2099,1446,3952.25,3225.42,633.25,1347.42,1980.67,1244.75,47427,38705,7599,16169,23768,14937,2022,'MAR DE ESPANHA',Mar de Espanha,'MG',3139805,2106.0,2106,175.5,175.5,1,150.0,150.0,Pequeno I
2697,2703,313990,7109,5936,1104,2992,4096,1840,6720.67,5612.83,1079.67,2674.83,3754.5,1858.33,80648,67354,12956,32098,45054,22300,2022,'MARIA DA FE',Maria da fé,'MG',3139904,5547.0,5547,462.2,462.2,1,420.0,420.0,Pequeno I
2698,2704,314000,29689,25107,2096,15697,17793,7314,28313.0,24485.33,2051.75,15750.92,17802.67,6682.67,339756,293824,24621,189011,213632,80192,2022,'MARIANA',Mariana,'MG',3140001,17825.0,17825,1485.4,1485.4,2,1267.0,1267.0,Médio
2699,2705,314010,3561,3060,216,2130,2346,714,3555.83,3091.33,163.42,2245.0,2408.42,682.92,42670,37096,1961,26940,28901,8195,2022,'MARILAC',Marilac,'MG',3140100,1817.0,1817,151.4,151.4,1,124.0,124.0,Pequeno I
2700,2706,314015,7318,6232,832,3402,4234,1998,6531.83,5628.75,698.58,3141.83,3840.42,1788.33,78382,67545,8383,37702,46085,21460,2022,'MARIO CAMPOS',Mário Campos,'MG',3140159,3913.0,3913,326.1,326.1,1,305.0,305.0,Pequeno I
2701,2707,314020,1544,1188,497,91,588,600,1506.0,1179.42,441.17,149.42,590.58,588.83,18072,14153,5294,1793,7087,7066,2022,'MARIPA DE MINAS',Maripá de Minas,'MG',3140209,5560.0,5560,463.3,463.3,1,203.0,203.0,Pequeno I
2702,2708,314030,2584,2102,292,866,1158,944,2490.58,2089.0,303.17,940.25,1243.42,845.58,29887,25068,3638,11283,14921,10147,2022,'MARLIERIA',Marliéria,'MG',3140308,5911.0,5911,492.6,492.6,1,381.0,381.0,Pequeno I
2703,2710,314050,5819,4708,348,2745,3093,1615,5509.17,4500.67,360.75,2574.5,2935.25,1565.42,66110,54008,4329,30894,35223,18785,2022,'MARTINHO CAMPOS',Martinho Campos,'MG',3140506,4311.0,4311,359.2,359.2,2,286.0,286.0,Pequeno I
2704,2711,314053,6548,5565,817,3347,4164,1401,6322.0,5442.33,782.25,3335.25,4117.5,1324.83,75864,65308,9387,40023,49410,15898,2022,'MARTINS SOARES',Martins Soares,'MG',3140530,1353.0,1353,112.8,112.8,1,73.0,73.0,Pequeno I
2705,2712,314055,6266,5623,214,4646,4860,763,6137.75,5547.25,217.25,4568.08,4785.33,761.92,73653,66567,2607,54817,57424,9143,2022,'MATA VERDE',Mata Verde,'MG',3140555,2976.0,2976,248.0,248.0,1,156.0,156.0,Pequeno I
2706,2713,314060,3703,3058,116,2115,2231,827,3683.75,3093.92,123.42,2153.5,2276.92,817.0,44205,37127,1481,25842,27323,9804,2022,'MATERLANDIA',Materlândia,'MG',3140605,960.0,960,80.0,80.0,1,47.0,47.0,Pequeno I
2707,2714,314070,14967,12902,1953,6803,8756,4146,14316.83,12422.17,1881.83,6540.92,8422.75,3999.42,171802,149066,22582,78491,101073,47993,2022,'MATEUS LEME',Mateus Leme,'MG',3140704,1693.0,1693,141.1,141.1,1,103.0,103.0,Pequeno II
2708,2715,314080,5742,4725,485,2116,2601,2124,5716.5,4678.83,492.25,2015.33,2507.58,2171.25,68598,56146,5907,24184,30091,26055,2022,'MATIAS BARBOSA',Matias Barbosa,'MG',3140803,5106.0,5106,464.2,464.2,1,396.0,396.0,Pequeno I
2709,2716,314085,6908,6027,664,3820,4484,1543,6757.83,5980.25,621.58,3797.5,4419.08,1561.17,81094,71763,7459,45570,53029,18734,2022,'MATIAS CARDOSO',Matias Cardoso,'MG',3140852,1929.0,1929,160.8,160.8,1,107.0,107.0,Pequeno I
2710,2717,314090,14449,13145,1279,8602,9881,3264,14035.33,12879.08,1082.67,8794.83,9877.5,3001.58,168424,154549,12992,105538,118530,36019,2022,'MATIPO',Matipó,'MG',3140902,1430.0,1430,119.2,119.2,2,136.0,136.0,Pequeno I
2711,2718,314100,8056,6867,212,5022,5234,1633,7838.92,6764.42,181.5,5010.92,5192.42,1572.0,94067,81173,2178,60131,62309,18864,2022,'MATO VERDE',Mato Verde,'MG',3141009,4290.0,4290,357.5,357.5,2,309.0,309.0,Pequeno I
2712,2719,314110,15731,13558,1892,6521,8413,5145,15146.5,13233.92,1616.0,6767.5,8383.5,4850.42,181758,158807,19392,81210,100602,58205,2022,'MATOZINHOS',Matozinhos,'MG',3141108,2062.0,2062,171.8,171.8,1,102.0,102.0,Pequeno II
2713,2720,314120,1841,1076,230,355,585,491,1778.58,1031.5,229.17,315.92,545.08,486.42,21343,12378,2750,3791,6541,5837,2022,'MATUTINA',Matutina,'MG',3141207,657.0,657,54.8,54.8,1,50.0,50.0,Pequeno I
2714,2721,314130,2035,1579,88,1021,1109,470,1924.83,1483.58,93.67,920.0,1013.67,469.92,23098,17803,1124,11040,12164,5639,2022,'MEDEIROS',Medeiros,'MG',3141306,1759.0,1759,146.6,146.6,1,189.0,189.0,Pequeno I
2715,2722,314140,13685,11533,1329,6193,7522,4011,13432.83,11505.42,1283.08,6351.25,7634.33,3871.08,161194,138065,15397,76215,91612,46453,2022,'MEDINA',Medina,'MG',3141405,5437.0,5437,453.1,453.1,3,414.0,414.0,Pequeno II
2716,2723,314150,4010,3157,359,1854,2213,944,3945.0,3160.25,263.92,2024.33,2288.25,872.0,47340,37923,3167,24292,27459,10464,2022,'MENDES PIMENTEL',Mendes Pimentel,'MG',3141504,1667.0,1667,138.9,138.9,1,112.0,112.0,Pequeno I
2717,2724,314160,6667,5209,526,2128,2654,2555,6426.0,5158.08,565.42,2351.67,2917.08,2241.0,77112,61897,6785,28220,35005,26892,2022,'MERCES',Mercês,'MG',3141603,4960.0,4960,413.3,413.3,1,349.0,349.0,Pequeno I
2718,2725,314170,2821,2350,174,1445,1619,731,2753.5,2335.33,160.83,1460.92,1621.75,713.58,33042,28024,1930,17531,19461,8563,2022,'MESQUITA',Mesquita,'MG',3141702,659.0,659,54.9,54.9,1,44.0,44.0,Pequeno I
2719,2726,314180,16513,14067,1673,7192,8865,5202,16112.08,14054.42,1385.33,7997.25,9382.58,4671.83,193345,168653,16624,95967,112591,56062,2022,'MINAS NOVAS',Minas Novas,'MG',3141801,14151.0,14151,1179.2,1179.2,1,441.0,441.0,Pequeno II
2720,2727,314190,1755,1472,226,775,1001,471,1684.17,1431.25,208.0,792.25,1000.25,431.0,20210,17175,2496,9507,12003,5172,2022,'MINDURI',Minduri,'MG',3141900,2059.0,2059,171.6,171.6,1,219.0,219.0,Pequeno I
2721,2728,314200,9150,8087,773,5073,5846,2241,8892.0,7935.67,657.67,5195.33,5853.0,2082.67,106704,95228,7892,62344,70236,24992,2022,'MIRABELA',Mirabela,'MG',3142007,687.0,13239,57.2,1103.2,1,0.0,1185.0,Pequeno I
2722,2729,314210,5740,4732,825,1531,2356,2376,5684.42,4807.25,790.42,1786.58,2577.0,2230.25,68213,57687,9485,21439,30924,26763,2022,'MIRADOURO',Miradouro,'MG',3142106,5094.0,5094,424.5,424.5,1,382.0,382.0,Pequeno I
2723,2730,314220,5126,4447,809,1843,2652,1795,4779.33,4171.5,735.25,1819.67,2554.92,1616.58,57352,50058,8823,21836,30659,19399,2022,'MIRAI',Miraí,'MG',3142205,3458.0,3458,288.2,288.2,2,204.0,204.0,Pequeno I
2724,2731,314225,3329,2794,329,1645,1974,820,3298.75,2864.33,292.92,1827.92,2120.83,743.5,39585,34372,3515,21935,25450,8922,2022,'MIRAVANIA',Miravânia,'MG',3142254,665.0,665,55.4,55.4,1,21.0,21.0,Pequeno I
2725,2732,314230,2549,2210,312,1247,1559,651,2453.5,2179.33,242.33,1401.67,1644.0,535.33,29442,26152,2908,16820,19728,6424,2022,'MOEDA',Moeda,'MG',3142304,689.0,689,57.4,57.4,1,60.0,60.0,Pequeno I
2726,2733,314240,3308,2883,652,1177,1829,1054,3184.92,2787.67,619.58,1195.25,1814.83,972.83,38219,33452,7435,14343,21778,11674,2022,'MOEMA',Moema,'MG',3142403,1323.0,1323,110.2,110.2,1,29.0,29.0,Pequeno I
2727,2734,314250,1368,963,144,329,473,490,1381.17,1001.08,134.17,358.75,492.92,508.17,16574,12013,1610,4305,5915,6098,2022,'MONJOLOS',Monjolos,'MG',3142502,1775.0,1775,147.9,147.9,1,130.0,130.0,Pequeno I
2728,2735,314260,3177,2791,959,829,1788,1003,3094.75,2741.75,679.33,1166.92,1846.25,895.5,37137,32901,8152,14003,22155,10746,2022,'MONSENHOR PAULO',Monsenhor Paulo,'MG',3142601,461.0,461,38.4,38.4,1,40.0,40.0,Pequeno I
2729,2736,314270,9923,8765,277,6545,6822,1943,9801.83,8746.25,337.58,6497.17,6834.75,1911.5,117622,104955,4051,77966,82017,22938,2022,'MONTALVANIA',Montalvânia,'MG',3142700,2949.0,2949,245.8,245.8,1,165.0,165.0,Pequeno I
2730,2737,314280,9462,7505,899,4134,5033,2472,9052.17,7234.17,813.92,4085.67,4899.58,2334.58,108626,86810,9767,49028,58795,28015,2022,'MONTE ALEGRE DE MINAS',Monte Alegre de Minas,'MG',3142809,2478.0,2478,206.5,206.5,2,266.0,266.0,Pequeno I
2731,2738,314290,12763,11271,668,8028,8696,2575,12402.0,10993.33,701.42,7719.33,8420.75,2572.58,148824,131920,8417,92632,101049,30871,2022,'MONTE AZUL',Monte Azul,'MG',3142908,3942.0,3942,328.5,328.5,3,232.0,232.0,Pequeno II
2732,2739,314300,6319,4459,1056,1163,2219,2240,6200.33,4473.0,967.33,1314.83,2282.17,2190.83,74404,53676,11608,15778,27386,26290,2022,'MONTE BELO',Monte Belo,'MG',3143005,2698.0,2698,224.8,224.8,1,156.0,156.0,Pequeno I
2733,2740,314310,11627,9182,2806,1178,3984,5198,11153.67,8888.67,2859.17,1173.08,4032.25,4856.42,133844,106664,34310,14077,48387,58277,2022,'MONTE CARMELO',Monte Carmelo,'MG',3143104,14425.0,14425,1202.1,1202.1,2,980.0,980.0,Pequeno II
2734,2741,314315,3334,2809,233,1801,2034,775,3239.67,2831.75,227.67,1906.67,2134.33,697.42,38876,33981,2732,22880,25612,8369,2022,'MONTE FORMOSO',Monte Formoso,'MG',3143153,406.0,406,58.0,58.0,1,,,Pequeno I
2735,2742,314320,10006,7571,1342,2860,4202,3369,9481.17,7261.67,1316.25,2770.42,4086.67,3175.0,113774,87140,15795,33245,49040,38100,2022,'MONTE SANTO DE MINAS',Monte Santo de Minas,'MG',3143203,2401.0,2401,200.1,200.1,1,180.0,180.0,Pequeno II
2736,2743,314330,178936,149878,36294,40408,76702,73176,165450.5,140645.42,33893.25,39486.0,73379.25,67266.17,1985406,1687745,406719,473832,880551,807194,2022,'MONTES CLAROS',Montes Claros,'MG',3143302,149199.0,149199,12433.2,12433.2,11,9717.0,9717.0,Grande
2737,2744,314340,7718,5869,1361,1844,3205,2664,7140.33,5406.25,1198.33,1584.5,2782.83,2623.42,85684,64875,14380,19014,33394,31481,2022,'MONTE SIAO',Monte Sião,'MG',3143401,5741.0,5741,478.4,478.4,1,344.0,344.0,Pequeno II
2738,2745,314345,4816,4148,311,2867,3178,970,4571.42,4015.75,316.42,2766.58,3083.0,932.75,54857,48189,3797,33199,36996,11193,2022,'MONTEZUMA',Montezuma,'MG',3143450,720.0,720,60.0,60.0,1,104.0,104.0,Pequeno I
2739,2746,314350,2955,2194,389,326,715,1479,2583.75,1996.67,437.75,339.67,777.42,1219.25,31005,23960,5253,4076,9329,14631,2022,'MORADA NOVA DE MINAS',Morada Nova de Minas,'MG',3143500,1668.0,1668,139.0,139.0,1,57.0,57.0,Pequeno I
2740,2747,314360,1747,1277,200,323,523,754,1706.92,1286.42,193.67,356.75,550.42,736.0,20483,15437,2324,4281,6605,8832,2022,'MORRO DA GARCA',Morro da Garça,'MG',3143609,1991.0,1991,165.9,165.9,1,128.0,128.0,Pequeno I
2741,2748,314370,2118,1859,204,1192,1396,463,2084.83,1840.08,173.75,1195.92,1369.67,470.42,25018,22081,2085,14351,16436,5645,2022,'MORRO DO PILAR',Morro do Pilar,'MG',3143708,3250.0,3250,270.8,270.8,1,200.0,200.0,Pequeno I
2742,2749,314380,3808,3028,769,896,1665,1363,3490.58,2802.25,722.08,811.5,1533.58,1268.67,41887,33627,8665,9738,18403,15224,2022,'MUNHOZ',Munhoz,'MG',3143807,853.0,853,121.9,121.9,1,,,Pequeno I
2743,2750,314390,43710,34082,5464,13205,18669,15413,41075.75,32340.83,5099.33,12130.67,17230.0,15110.83,492909,388090,61192,145568,206760,181330,2022,'MURIAE',Muriaé,'MG',3143906,30157.0,30157,2513.1,2513.1,8,2235.0,2235.0,Grande
2744,2751,314400,13432,11231,3808,3396,7204,4027,12927.08,10932.5,3281.75,4039.67,7321.42,3611.08,155125,131190,39381,48476,87857,43333,2022,'MUTUM',Mutum,'MG',3144003,15183.0,15183,1265.2,1265.2,1,1253.0,1253.0,Pequeno II
2745,2752,314410,9652,7337,1817,1493,3310,4027,9107.33,7114.17,1547.67,1697.75,3245.42,3868.75,109288,85370,18572,20373,38945,46425,2022,'MUZAMBINHO',Muzambinho,'MG',3144102,3715.0,3715,309.6,309.6,1,240.0,240.0,Pequeno II
2746,2753,314420,2112,1707,92,1061,1153,554,2093.58,1727.83,95.0,1087.83,1182.83,545.0,25123,20734,1140,13054,14194,6540,2022,'NACIP RAYDAN',Nacip Raydan,'MG',3144201,1845.0,1845,153.8,153.8,1,130.0,130.0,Pequeno I
2747,2754,314430,21298,16836,2489,7796,10285,6551,20680.33,16569.33,2408.83,7923.33,10332.17,6237.17,248164,198832,28906,95080,123986,74846,2022,'NANUQUE',Nanuque,'MG',3144300,9517.0,9517,793.1,793.1,2,850.0,850.0,Pequeno II
2748,2755,314435,5511,4708,835,2339,3174,1534,5397.08,4663.75,738.67,2519.75,3258.42,1405.33,64765,55965,8864,30237,39101,16864,2022,'NAQUE',Naque,'MG',3144359,0.0,16182,0.0,1348.5,1,0.0,1326.0,Pequeno I
2749,2756,314437,2467,2017,188,1233,1421,596,2419.08,1979.25,186.0,1181.83,1367.83,611.42,29029,23751,2232,14182,16414,7337,2022,'NATALANDIA',Natalândia,'MG',3144375,1435.0,1435,119.6,119.6,1,164.0,164.0,Pequeno I
2750,2757,314440,1956,1553,441,337,778,775,1884.67,1512.33,466.83,308.17,775.0,737.33,22616,18148,5602,3698,9300,8848,2022,'NATERCIA',Natércia,'MG',3144409,572.0,572,47.7,47.7,1,35.0,35.0,Pequeno I
2751,2758,314450,4314,3732,524,1889,2413,1319,4158.08,3670.42,504.67,1919.5,2424.17,1246.25,49897,44045,6056,23034,29090,14955,2022,'NAZARENO',Nazareno,'MG',3144508,2769.0,2769,230.8,230.8,1,152.0,152.0,Pequeno I
2752,2759,314460,11631,9570,2466,3185,5651,3919,10955.25,9109.08,2366.75,2860.33,5227.08,3882.0,131463,109309,28401,34324,62725,46584,2022,'NEPOMUCENO',Nepomuceno,'MG',3144607,3745.0,3745,312.1,312.1,2,226.0,226.0,Pequeno II
2753,2760,314465,7025,6000,179,4406,4585,1415,6868.67,5996.0,202.58,4469.92,4672.5,1323.5,82424,71952,2431,53639,56070,15882,2022,'NINHEIRA',Ninheira,'MG',3144656,1236.0,1236,103.0,103.0,1,73.0,73.0,Pequeno I
2754,2761,314467,2775,2414,293,1534,1827,587,2670.33,2358.92,213.0,1607.75,1820.75,538.17,32044,28307,2556,19293,21849,6458,2022,'NOVA BELEM',Nova Belém,'MG',3144672,4788.0,4788,399.0,399.0,1,330.0,330.0,Pequeno I
2755,2762,314470,7267,6328,1234,2756,3990,2338,6956.5,6115.25,1043.5,2849.75,3893.25,2222.0,83478,73383,12522,34197,46719,26664,2022,'NOVA ERA',Nova Era,'MG',3144706,2260.0,2260,188.3,188.3,1,115.0,115.0,Pequeno I
2756,2763,314480,27421,21951,3545,8998,12543,9408,24612.17,20179.17,3269.42,8081.42,11350.83,8828.33,295346,242150,39233,96977,136210,105940,2022,'NOVA LIMA',Nova Lima,'MG',3144805,47286.0,47286,3940.5,3940.5,5,4691.0,4691.0,Médio
2757,2764,314490,3007,2327,226,1403,1629,698,2970.17,2343.58,207.42,1484.17,1691.58,652.0,35642,28123,2489,17810,20299,7824,2022,'NOVA MODICA',Nova Módica,'MG',3144904,2554.0,2554,212.8,212.8,1,180.0,180.0,Pequeno I
2758,2765,314500,5129,4216,1162,1150,2312,1904,4718.08,3955.08,954.83,1405.92,2360.75,1594.33,56617,47461,11458,16871,28329,19132,2022,'NOVA PONTE',Nova Ponte,'MG',3145000,1930.0,1930,160.8,160.8,1,130.0,130.0,Pequeno I
2759,2766,314505,5611,4907,269,3730,3999,908,5430.25,4798.92,261.75,3599.83,3861.58,937.33,65163,57587,3141,43198,46339,11248,2022,'NOVA PORTEIRINHA',Nova Porteirinha,'MG',3145059,1164.0,1164,97.0,97.0,1,100.0,100.0,Pequeno I
2760,2767,314510,6387,5367,1838,1629,3467,1900,5923.67,4971.83,1403.42,1889.67,3293.08,1678.75,71084,59662,16841,22676,39517,20145,2022,'NOVA RESENDE',Nova Resende,'MG',3145109,2384.0,2384,198.7,198.7,1,243.0,243.0,Pequeno I
2761,2768,314520,25643,21835,4946,4733,9679,12156,20900.0,17992.58,4233.75,3842.33,8076.08,9916.5,250800,215911,50805,46108,96913,118998,2022,'NOVA SERRANA',Nova Serrana,'MG',3145208,19956.0,19956,1663.0,1663.0,3,891.0,891.0,Médio
2762,2769,314530,18147,16697,1235,11852,13087,3610,17843.58,16636.08,1174.75,12162.33,13337.08,3299.0,214123,199633,14097,145948,160045,39588,2022,'NOVO CRUZEIRO',Novo Cruzeiro,'MG',3145307,7262.0,7262,605.2,605.2,2,445.0,445.0,Pequeno II
2763,2770,314535,7524,6523,407,5136,5543,980,7217.42,6329.33,373.75,4956.08,5329.83,999.5,86609,75952,4485,59473,63958,11994,2022,'NOVO ORIENTE DE MINAS',Novo Oriente de Minas,'MG',3145356,4429.0,4429,369.1,369.1,1,266.0,266.0,Pequeno I
2764,2771,314537,3695,3112,201,2000,2201,911,3591.42,3071.0,196.5,2087.25,2283.75,787.25,43097,36852,2358,25047,27405,9447,2022,'NOVORIZONTE',Novorizonte,'MG',3145372,1846.0,1846,153.8,153.8,1,116.0,116.0,Pequeno I
2765,2772,314540,1188,954,56,495,551,403,1145.17,934.58,45.0,514.33,559.33,375.25,13742,11215,540,6172,6712,4503,2022,'OLARIA',Olaria,'MG',3145406,1223.0,1223,101.9,101.9,1,68.0,68.0,Pequeno I
2766,2773,314545,4863,4539,173,3653,3826,713,4813.33,4535.08,134.83,3897.58,4032.42,502.67,57760,54421,1618,46771,48389,6032,2022,'OLHOS-DAGUA',Olhos-d´água,'MG',3145455,591.0,591,65.7,65.7,1,,,Pequeno I
2767,2774,314550,2029,1507,155,693,848,659,1953.5,1513.0,142.08,769.67,911.75,601.25,23442,18156,1705,9236,10941,7215,2022,'OLIMPIO NORONHA',Olímpio Noronha,'MG',3145505,2162.0,2162,180.2,180.2,1,190.0,190.0,Pequeno I
2768,2775,314560,15840,12763,2005,5124,7129,5634,15108.33,12315.92,1928.58,4745.33,6673.92,5642.0,181300,147791,23143,56944,80087,67704,2022,'OLIVEIRA',Oliveira,'MG',3145604,29258.0,29258,2438.2,2438.2,3,2131.0,2131.0,Pequeno II
2769,2776,314570,995,808,94,404,498,310,947.92,766.58,82.25,390.92,473.17,293.42,11375,9199,987,4691,5678,3521,2022,'OLIVEIRA FORTES',Oliveira Fortes,'MG',3145703,380.0,380,31.7,31.7,1,20.0,20.0,Pequeno I
2770,2777,314580,1581,1332,306,436,742,590,1524.67,1308.5,293.83,469.92,763.75,544.75,18296,15702,3526,5639,9165,6537,2022,'ONCA DE PITANGUI',Onça de Pitangui,'MG',3145802,860.0,860,71.7,71.7,1,38.0,38.0,Pequeno I
2771,2778,314585,2450,1973,208,877,1085,888,2240.67,1857.17,193.75,839.17,1032.92,824.25,26888,22286,2325,10070,12395,9891,2022,'ORATORIOS',Oratórios,'MG',3145851,559.0,559,46.6,46.6,1,36.0,36.0,Pequeno I
2772,2779,314587,6670,5715,1563,2754,4317,1398,6414.0,5521.17,1280.25,2930.67,4210.92,1310.25,76968,66254,15363,35168,50531,15723,2022,'ORIZANIA',Orizânia,'MG',3145877,2776.0,2776,231.3,231.3,1,114.0,114.0,Pequeno I
2773,2780,314590,13356,10973,1475,5041,6516,4457,12580.25,10547.83,1413.92,4896.67,6310.58,4237.25,150963,126574,16967,58760,75727,50847,2022,'OURO BRANCO',Ouro Branco,'MG',3145901,7764.0,7764,647.0,647.0,3,540.0,540.0,Pequeno II
2774,2781,314600,5702,4225,1085,454,1539,2686,5545.5,4157.67,1061.08,491.75,1552.83,2604.83,66546,49892,12733,5901,18634,31258,2022,'OURO FINO',Ouro Fino,'MG',3146008,3488.0,3488,290.7,290.7,1,238.0,238.0,Pequeno II
2775,2782,314610,27385,23147,3229,11392,14621,8526,25752.83,21929.17,3131.75,11064.33,14196.08,7733.08,309034,263150,37581,132772,170353,92797,2022,'OURO PRETO',Ouro Preto,'MG',3146107,13661.0,13661,1138.4,1138.4,5,1001.0,1001.0,Médio
2776,2783,314620,6032,5276,275,4227,4502,774,5823.92,5158.17,242.75,4243.25,4486.0,672.17,69887,61898,2913,50919,53832,8066,2022,'OURO VERDE DE MINAS',Ouro Verde de Minas,'MG',3146206,679.0,679,67.9,67.9,1,,,Pequeno I
2777,2784,314625,4385,3974,192,3289,3481,493,4327.83,3959.75,162.5,3298.92,3461.42,498.33,51934,47517,1950,39587,41537,5980,2022,'PADRE CARVALHO',Padre Carvalho,'MG',3146255,914.0,914,76.2,76.2,1,95.0,95.0,Pequeno I
2778,2785,314630,13907,12191,568,9455,10023,2168,13877.17,12294.67,531.75,9853.25,10385.0,1909.67,166526,147536,6381,118239,124620,22916,2022,'PADRE PARAISO',Padre Paraíso,'MG',3146305,1206.0,1206,100.5,100.5,1,60.0,60.0,Pequeno I
2779,2786,314640,2013,1658,94,1175,1269,389,1897.08,1574.67,127.25,1046.58,1173.83,400.83,22765,18896,1527,12559,14086,4810,2022,'PAINEIRAS',Paineiras,'MG',3146404,2093.0,2093,174.4,174.4,1,165.0,165.0,Pequeno I
2780,2787,314650,2276,1733,204,917,1121,612,2156.58,1650.92,194.58,891.5,1086.08,564.83,25879,19811,2335,10698,13033,6778,2022,'PAINS',Pains,'MG',3146503,1597.0,1597,133.1,133.1,1,89.0,89.0,Pequeno I
2781,2788,314655,4487,3570,404,1922,2326,1244,4443.0,3591.92,463.0,1884.0,2347.0,1244.92,53316,43103,5556,22608,28164,14939,2022,'PAI PEDRO',Pai Pedro,'MG',3146552,3417.0,3417,284.8,284.8,1,561.0,561.0,Pequeno I
2782,2789,314660,841,671,22,484,506,165,824.58,652.25,30.92,451.33,482.25,170.0,9895,7827,371,5416,5787,2040,2022,'PAIVA',Paiva,'MG',3146602,1380.0,1380,115.0,115.0,1,106.0,106.0,Pequeno I
2783,2790,314670,3990,3152,82,2106,2188,964,3927.58,3147.25,80.58,2128.67,2209.25,938.0,47131,37767,967,25544,26511,11256,2022,'PALMA',Palma,'MG',3146701,3221.0,3221,268.4,268.4,1,280.0,280.0,Pequeno I
2784,2791,314675,4721,4198,250,3178,3428,770,4598.17,4126.0,239.75,3158.58,3398.33,727.67,55178,49512,2877,37903,40780,8732,2022,'PALMOPOLIS',Palmópolis,'MG',3146750,1594.0,1594,132.8,132.8,1,31.0,31.0,Pequeno I
2785,2792,314690,6360,5439,1479,1983,3462,1977,6048.25,5212.17,1322.42,2067.33,3389.75,1822.42,72579,62546,15869,24808,40677,21869,2022,'PAPAGAIOS',Papagaios,'MG',3146909,3132.0,3132,261.0,261.0,1,242.0,242.0,Pequeno I
2786,2793,314700,36171,28017,4860,11604,16464,11553,34294.92,26933.25,4740.08,11256.83,15996.92,10936.33,411539,323199,56881,135082,191963,131236,2022,'PARACATU',Paracatu,'MG',3147006,13919.0,13919,1159.9,1159.9,3,1557.0,1557.0,Médio
2787,2794,314710,26527,20979,3471,7169,10640,10339,25459.58,20427.58,3303.5,7216.75,10520.25,9907.33,305515,245131,39642,86601,126243,118888,2022,'PARA DE MINAS',Pará de Minas,'MG',3147105,18184.0,18184,1515.3,1515.3,3,1478.0,1478.0,Médio
2788,2795,314720,7972,6156,1326,1032,2358,3798,7460.58,5869.08,1221.92,1109.58,2331.5,3537.58,89527,70429,14663,13315,27978,42451,2022,'PARAGUACU',Paraguaçu,'MG',3147204,3131.0,3131,260.9,260.9,1,293.0,293.0,Pequeno II
2789,2796,314730,7429,5756,1172,1691,2863,2893,7041.67,5567.5,1081.0,1813.83,2894.83,2672.67,84500,66810,12972,21766,34738,32072,2022,'PARAISOPOLIS',Paraisópolis,'MG',3147303,3242.0,3242,270.2,270.2,1,267.0,267.0,Pequeno I
2790,2797,314740,10131,8596,1616,4043,5659,2937,9579.5,8258.08,1385.67,4122.5,5508.17,2749.92,114954,99097,16628,49470,66098,32999,2022,'PARAOPEBA',Paraopeba,'MG',3147402,2430.0,2430,202.5,202.5,1,122.0,122.0,Pequeno II
2791,2798,314750,884,719,97,371,468,251,841.33,692.0,96.5,364.42,460.92,231.08,10096,8304,1158,4373,5531,2773,2022,'PASSABEM',Passabém,'MG',3147501,1625.0,1625,135.4,135.4,1,110.0,110.0,Pequeno I
2792,2799,314760,6090,4304,785,960,1745,2559,5972.92,4347.25,816.75,989.75,1806.5,2540.75,71675,52167,9801,11877,21678,30489,2022,'PASSA QUATRO',Passa Quatro,'MG',3147600,126.0,126,10.5,10.5,1,10.0,10.0,Pequeno I
2793,2800,314770,3394,2176,378,481,859,1317,3266.5,2152.92,325.92,572.42,898.33,1254.58,39198,25835,3911,6869,10780,15055,2022,'PASSA TEMPO',Passa Tempo,'MG',3147709,784.0,784,65.3,65.3,1,90.0,90.0,Pequeno I
2794,2801,314780,1022,806,105,426,531,275,981.5,792.42,100.42,417.67,518.08,274.33,11778,9509,1205,5012,6217,3292,2022,'PASSA-VINTE',Passa-vinte,'MG',3147808,1167.0,1167,97.2,97.2,1,70.0,70.0,Pequeno I
2795,2802,314790,36137,28705,5539,11277,16816,11889,34807.0,28040.08,4968.75,11688.5,16657.25,11382.83,417684,336481,59625,140262,199887,136594,2022,'PASSOS',Passos,'MG',3147907,15811.0,15811,1317.6,1317.6,5,869.0,869.0,Grande
2796,2803,314795,4197,3714,199,2746,2945,769,4169.58,3746.33,180.5,2826.0,3006.5,739.83,50035,44956,2166,33912,36078,8878,2022,'PATIS',Patis,'MG',3147956,4857.0,4857,404.8,404.8,1,58.0,58.0,Pequeno I
2797,2804,314800,34802,26347,4894,8500,13394,12953,32080.92,24390.92,4498.5,7498.83,11997.33,12393.58,384971,292691,53982,89986,143968,148723,2022,'PATOS DE MINAS',Patos de Minas,'MG',3148004,30617.0,30617,2551.4,2551.4,4,2049.0,2049.0,Grande
2798,2805,314810,31649,26264,6870,9499,16369,9895,28894.83,24161.33,6234.5,8796.75,15031.25,9130.08,346738,289936,74814,105561,180375,109561,2022,'PATROCINIO',Patrocínio,'MG',3148103,23169.0,23169,1930.8,1930.8,5,1698.0,1698.0,Médio
2799,2806,314820,3441,2926,250,1785,2035,891,3359.25,2884.67,238.33,1769.75,2008.08,876.58,40311,34616,2860,21237,24097,10519,2022,'PATROCINIO DO MURIAE',Patrocínio do Muriaé,'MG',3148202,1621.0,1621,231.6,231.6,1,,,Pequeno I
2800,2807,314830,5374,4725,461,2746,3207,1518,5229.67,4643.5,481.25,2668.67,3149.92,1493.58,62756,55722,5775,32024,37799,17923,2022,'PAULA CANDIDO',Paula Cândido,'MG',3148301,3061.0,3061,255.1,255.1,1,179.0,179.0,Pequeno I
2801,2808,314840,2958,2534,326,1559,1885,649,2870.5,2478.92,254.5,1636.83,1891.33,587.58,34446,29747,3054,19642,22696,7051,2022,'PAULISTAS',Paulistas,'MG',3148400,1712.0,1712,142.7,142.7,1,62.0,62.0,Pequeno I
2802,2809,314850,5688,5002,77,4564,4641,361,5443.67,4810.17,100.08,4326.17,4426.25,383.92,65324,57722,1201,51914,53115,4607,2022,'PAVAO',Pavão,'MG',3148509,4406.0,4406,367.2,367.2,1,298.0,298.0,Pequeno I
2803,2810,314860,10197,9010,513,6400,6913,2097,9963.75,8877.58,563.75,6267.42,6831.17,2046.42,119565,106531,6765,75209,81974,24557,2022,'PECANHA',Peçanha,'MG',3148608,3154.0,3154,262.8,262.8,1,153.0,153.0,Pequeno I
2804,2811,314870,16823,14452,627,11159,11786,2666,16392.42,14199.17,645.83,11017.0,11662.83,2536.33,196709,170390,7750,132204,139954,30436,2022,'PEDRA AZUL',Pedra Azul,'MG',3148707,3613.0,3613,301.1,301.1,1,234.0,234.0,Pequeno II
2805,2812,314875,6003,5582,501,4111,4612,970,5892.83,5550.33,499.0,4279.33,4778.33,772.0,70714,66604,5988,51352,57340,9264,2022,'PEDRA BONITA',Pedra Bonita,'MG',3148756,2702.0,2702,225.2,225.2,1,195.0,195.0,Pequeno I
2806,2813,314880,2144,1800,128,1063,1191,609,2138.0,1811.33,125.75,1102.33,1228.08,583.25,25656,21736,1509,13228,14737,6999,2022,'PEDRA DO ANTA',Pedra do Anta,'MG',3148806,1296.0,1296,108.0,108.0,1,60.0,60.0,Pequeno I
2807,2814,314890,1754,1384,221,615,836,548,1555.33,1280.33,196.75,554.5,751.25,529.08,18664,15364,2361,6654,9015,6349,2022,'PEDRA DO INDAIA',Pedra do Indaiá,'MG',3148905,2133.0,2133,177.8,177.8,1,178.0,178.0,Pequeno I
2808,2815,314900,2442,2035,272,1062,1334,701,2339.83,1965.75,263.83,985.58,1249.42,716.33,28078,23589,3166,11827,14993,8596,2022,'PEDRA DOURADA',Pedra Dourada,'MG',3149002,2701.0,2701,225.1,225.1,1,199.0,199.0,Pequeno I
2809,2816,314910,5351,4502,997,1809,2806,1696,5173.67,4375.58,845.5,1966.0,2811.5,1564.08,62084,52507,10146,23592,33738,18769,2022,'PEDRALVA',Pedralva,'MG',3149101,480.0,480,40.0,40.0,1,31.0,31.0,Pequeno I
2810,2817,314915,6726,5876,547,3612,4159,1717,6605.42,5842.0,520.75,3738.42,4259.17,1582.83,79265,70104,6249,44861,51110,18994,2022,'PEDRAS DE MARIA DA CRUZ',Pedras de Maria da Cruz,'MG',3149150,3579.0,3579,325.4,325.4,1,234.0,234.0,Pequeno I
2811,2818,314920,1585,1313,66,943,1009,304,1482.17,1223.25,63.75,863.42,927.17,296.08,17786,14679,765,10361,11126,3553,2022,'PEDRINOPOLIS',Pedrinópolis,'MG',3149200,776.0,776,64.7,64.7,1,54.0,54.0,Pequeno I
2812,2819,314930,20041,16721,3039,6754,9793,6928,18433.5,15568.83,2802.5,6378.83,9181.33,6387.5,221202,186826,33630,76546,110176,76650,2022,'PEDRO LEOPOLDO',Pedro Leopoldo,'MG',3149309,6868.0,6868,572.3,572.3,2,731.0,731.0,Médio
2813,2820,314940,1097,958,105,586,691,267,1059.25,929.83,68.5,624.25,692.75,237.08,12711,11158,822,7491,8313,2845,2022,'PEDRO TEIXEIRA',Pedro Teixeira,'MG',3149408,2404.0,2404,200.3,200.3,1,237.0,237.0,Pequeno I
2814,2821,314950,1864,1447,197,712,909,538,1704.92,1366.5,171.25,690.08,861.33,505.17,20459,16398,2055,8281,10336,6062,2022,'PEQUERI',Pequeri,'MG',3149507,2224.0,2224,202.2,202.2,1,194.0,194.0,Pequeno I
2815,2822,314960,2496,2092,165,1403,1568,524,2323.33,1966.17,144.08,1356.42,1500.5,465.67,27880,23594,1729,16277,18006,5588,2022,'PEQUI',Pequi,'MG',3149606,1910.0,1910,159.2,159.2,1,150.0,150.0,Pequeno I
2816,2823,314970,3773,3155,638,1184,1822,1333,3516.08,2963.0,532.25,1221.0,1753.25,1209.75,42193,35556,6387,14652,21039,14517,2022,'PERDIGAO',Perdigão,'MG',3149705,3940.0,3940,328.3,328.3,1,253.0,253.0,Pequeno I
2817,2824,314980,5902,5184,566,3459,4025,1159,5136.0,4479.08,561.17,2862.0,3423.17,1055.92,61632,53749,6734,34344,41078,12671,2022,'PERDIZES',Perdizes,'MG',3149804,4135.0,4135,344.6,344.6,1,228.0,228.0,Pequeno I
2818,2825,314990,8973,6875,1188,1650,2838,4037,8513.25,6694.42,1160.0,1625.33,2785.33,3909.08,102159,80333,13920,19504,33424,46909,2022,'PERDOES',Perdões,'MG',3149903,4590.0,4590,382.5,382.5,2,216.0,216.0,Pequeno II
2819,2826,314995,5145,4312,215,2562,2777,1535,4960.75,4243.5,193.25,2623.17,2816.42,1427.08,59529,50922,2319,31478,33797,17125,2022,'PERIQUITO',Periquito,'MG',3149952,6740.0,6740,612.7,612.7,1,581.0,581.0,Pequeno I
2820,2827,315000,3062,2471,256,1524,1780,691,3036.83,2487.08,259.17,1551.92,1811.08,676.0,36442,29845,3110,18623,21733,8112,2022,'PESCADOR',Pescador,'MG',3150000,872.0,872,72.7,72.7,1,173.0,173.0,Pequeno I
2821,2828,315010,1212,1064,131,620,751,313,1162.42,1022.17,138.92,577.0,715.92,306.25,13949,12266,1667,6924,8591,3675,2022,'PIAU',Piau,'MG',3150109,1240.0,1240,103.3,103.3,1,149.0,149.0,Pequeno I
2822,2829,315015,7536,6899,803,4649,5452,1447,7180.25,6601.25,737.67,4460.33,5198.0,1403.25,86163,79215,8852,53524,62376,16839,2022,'PIEDADE DE CARATINGA',Piedade de Caratinga,'MG',3150158,5271.0,12429,439.2,1035.8,1,987.0,987.0,Pequeno I
2823,2830,315020,2557,2010,210,885,1095,915,2473.75,1968.67,243.17,882.25,1125.42,843.25,29685,23624,2918,10587,13505,10119,2022,'PIEDADE DE PONTE NOVA',Piedade de Ponte Nova,'MG',3150208,880.0,880,73.3,73.3,1,43.0,43.0,Pequeno I
2824,2831,315030,1966,1521,470,322,792,729,1839.25,1441.08,441.08,306.08,747.17,693.92,22071,17293,5293,3673,8966,8327,2022,'PIEDADE DO RIO GRANDE',Piedade do Rio Grande,'MG',3150307,908.0,908,75.7,75.7,1,37.0,37.0,Pequeno I
2825,2832,315040,2851,2540,450,1509,1959,581,2742.83,2461.58,428.25,1454.83,1883.08,578.5,32914,29539,5139,17458,22597,6942,2022,'PIEDADE DOS GERAIS',Piedade Dos Gerais,'MG',3150406,3770.0,3770,314.2,314.2,1,219.0,219.0,Pequeno I
2826,2833,315050,3315,2726,266,1222,1488,1238,3270.67,2748.83,251.25,1377.5,1628.75,1120.08,39248,32986,3015,16530,19545,13441,2022,'PIMENTA',Pimenta,'MG',3150505,757.0,757,63.1,63.1,1,66.0,66.0,Pequeno I
2827,2834,315053,3430,2755,328,1497,1825,930,3316.42,2721.0,279.83,1529.5,1809.33,911.67,39797,32652,3358,18354,21712,10940,2022,'PINGO-DAGUA',Pingo-d´água,'MG',3150539,5992.0,5992,499.3,499.3,1,509.0,509.0,Pequeno I
2828,2835,315057,5652,4869,365,3305,3670,1199,5539.83,4838.58,370.42,3330.75,3701.17,1137.42,66478,58063,4445,39969,44414,13649,2022,'PINTOPOLIS',Pintópolis,'MG',3150570,2818.0,2818,234.8,234.8,1,140.0,140.0,Pequeno I
2829,2836,315060,2344,1838,376,480,856,982,2186.17,1772.67,374.75,449.33,824.08,948.58,26234,21272,4497,5392,9889,11383,2022,'PIRACEMA',Piracema,'MG',3150604,3749.0,3749,312.4,312.4,1,288.0,288.0,Pequeno I
2830,2837,315070,2126,1774,214,1155,1369,405,1874.67,1578.5,260.67,840.5,1101.17,477.33,22496,18942,3128,10086,13214,5728,2022,'PIRAJUBA',Pirajuba,'MG',3150703,8343.0,8343,758.5,758.5,1,,,Pequeno I
2831,2838,315080,9581,7761,447,5266,5713,2048,9318.08,7787.42,451.17,5332.58,5783.75,2003.67,111817,93449,5414,63991,69405,24044,2022,'PIRANGA',Piranga,'MG',3150802,6878.0,6878,625.3,625.3,1,,,Pequeno I
2832,2839,315090,2684,2251,355,924,1279,972,2617.5,2226.33,326.67,932.0,1258.67,967.67,31410,26716,3920,11184,15104,11612,2022,'PIRANGUCU',Piranguçu,'MG',3150901,870.0,870,72.5,72.5,1,63.0,63.0,Pequeno I
2833,2840,315100,4750,3484,515,1258,1773,1711,4477.33,3329.75,500.0,1317.0,1817.0,1512.75,53728,39957,6000,15804,21804,18153,2022,'PIRANGUINHO',Piranguinho,'MG',3151008,659.0,659,73.2,73.2,1,78.0,78.0,Pequeno I
2834,2841,315110,5881,4780,377,2696,3073,1707,5544.42,4566.92,364.75,2607.5,2972.25,1594.67,66533,54803,4377,31290,35667,19136,2022,'PIRAPETINGA',Pirapetinga,'MG',3151107,4294.0,4294,357.8,357.8,1,150.0,150.0,Pequeno I
2835,2842,315120,33286,26966,2759,15752,18511,8455,32050.17,26454.25,2651.5,15962.25,18613.75,7840.5,384602,317451,31818,191547,223365,94086,2022,'PIRAPORA',Pirapora,'MG',3151206,21066.0,21066,1755.5,1755.5,4,1532.0,1532.0,Médio
2836,2843,315130,5404,4861,604,2318,2922,1939,5077.67,4585.75,569.67,2066.33,2636.0,1949.75,60932,55029,6836,24796,31632,23397,2022,'PIRAUBA',Piraúba,'MG',3151305,5983.0,11721,498.6,976.8,1,0.0,1129.0,Pequeno I
2837,2844,315140,10097,8720,1715,4377,6092,2628,9269.58,8046.83,1677.67,3976.5,5654.17,2392.67,111235,96562,20132,47718,67850,28712,2022,'PITANGUI',Pitangui,'MG',3151404,2947.0,2947,245.6,245.6,1,134.0,134.0,Pequeno II
2838,2845,315150,13106,10569,1970,4639,6609,3960,12116.83,9873.5,1669.83,4596.75,6266.58,3606.92,145402,118482,20038,55161,75199,43283,2022,'PIUMHI',Piumhi,'MG',3151503,3510.0,3510,292.5,292.5,1,330.0,330.0,Pequeno II
2839,2846,315160,5335,4199,651,2245,2896,1303,5051.17,4004.25,674.5,2048.25,2722.75,1281.5,60614,48051,8094,24579,32673,15378,2022,'PLANURA',Planura,'MG',3151602,4609.0,4609,384.1,384.1,1,280.0,280.0,Pequeno I
2840,2847,315170,5128,3851,784,1045,1829,2022,4779.67,3718.58,778.33,1043.33,1821.67,1896.92,57356,44623,9340,12520,21860,22763,2022,'POCO FUNDO',Poço Fundo,'MG',3151701,927.0,927,77.2,77.2,1,38.0,38.0,Pequeno I
2841,2848,315180,50884,34596,5378,11165,16543,18053,47800.92,33129.5,5053.17,10870.42,15923.58,17205.92,573611,397554,60638,130445,191083,206471,2022,'POCOS DE CALDAS',Poços de Caldas,'MG',3151800,75490.0,118614,6290.8,9884.5,5,5930.0,10277.0,Grande
2842,2849,315190,5577,4713,446,3502,3948,765,5312.58,4549.75,418.75,3420.83,3839.58,710.17,63751,54597,5025,41050,46075,8522,2022,'POCRANE',Pocrane,'MG',3151909,3069.0,10069,255.8,839.1,1,136.0,136.0,Pequeno I
2843,2850,315200,14219,11897,3674,3649,7323,4574,13283.25,11198.75,3286.58,3509.25,6795.83,4402.92,159399,134385,39439,42111,81550,52835,2022,'POMPEU',Pompéu,'MG',3152006,9750.0,9750,812.5,812.5,1,536.0,536.0,Pequeno II
2844,2851,315210,25906,19568,2319,8366,10685,8883,25069.0,19247.67,2116.67,8674.0,10790.67,8457.0,300828,230972,25400,104088,129488,101484,2022,'PONTE NOVA',Ponte Nova,'MG',3152105,3744.0,3744,312.0,312.0,1,312.0,312.0,Médio
2845,2852,315213,3055,2823,83,2245,2328,495,3035.5,2814.42,89.5,2256.75,2346.25,468.17,36426,33773,1074,27081,28155,5618,2022,'PONTO CHIQUE',Ponto Chique,'MG',3152131,1419.0,1419,118.2,118.2,1,55.0,55.0,Pequeno I
2846,2853,315217,8386,6956,388,4648,5036,1920,8325.67,7056.42,453.17,4697.83,5151.0,1905.42,99908,84677,5438,56374,61812,22865,2022,'PONTO DOS VOLANTES',Ponto Dos Volantes,'MG',3152170,3851.0,3851,320.9,320.9,1,120.0,120.0,Pequeno I
2847,2854,315220,25802,21892,1515,12328,13843,8049,25089.42,21594.67,1668.5,12315.25,13983.75,7610.92,301073,259136,20022,147783,167805,91331,2022,'PORTEIRINHA',Porteirinha,'MG',3152204,13966.0,13966,1163.8,1163.8,2,299.0,299.0,Pequeno II
2848,2855,315230,7281,6423,311,4620,4931,1492,7170.17,6360.08,353.92,4509.42,4863.33,1496.75,86042,76321,4247,54113,58360,17961,2022,'PORTO FIRME',Porto Firme,'MG',3152303,245.0,245,61.2,61.2,1,,,Pequeno I
2849,2856,315240,7895,6911,1804,2987,4791,2120,7614.75,6779.92,1531.67,3242.0,4773.67,2006.25,91377,81359,18380,38904,57284,24075,2022,'POTE',Poté,'MG',3152402,3889.0,3889,324.1,324.1,1,156.0,156.0,Pequeno I
2850,2857,315250,46154,37428,6400,15549,21949,15479,42922.92,35172.92,5767.0,14929.83,20696.83,14476.08,515075,422075,69204,179158,248362,173713,2022,'POUSO ALEGRE',Pouso Alegre,'MG',3152501,84498.0,84498,7041.5,7041.5,6,4457.0,4457.0,Grande
2851,2858,315260,2952,2011,402,290,692,1319,2773.67,1889.75,400.17,200.25,600.42,1289.33,33284,22677,4802,2403,7205,15472,2022,'POUSO ALTO',Pouso Alto,'MG',3152600,1306.0,1306,108.8,108.8,1,96.0,96.0,Pequeno I
2852,2859,315270,3103,2586,415,1012,1427,1159,2925.92,2424.92,425.25,874.58,1299.83,1125.08,35111,29099,5103,10495,15598,13501,2022,'PRADOS',Prados,'MG',3152709,2665.0,2665,222.1,222.1,2,178.0,178.0,Pequeno I
2853,2860,315280,9280,6957,1964,1727,3691,3266,8448.08,6383.42,1765.17,1479.25,3244.42,3139.0,101377,76601,21182,17751,38933,37668,2022,'PRATA',Prata,'MG',3152808,3270.0,3270,272.5,272.5,1,217.0,217.0,Pequeno II
2854,2861,315290,3387,2540,602,929,1531,1009,3211.58,2416.08,594.67,880.0,1474.67,941.42,38539,28993,7136,10560,17696,11297,2022,'PRATAPOLIS',Pratápolis,'MG',3152907,5119.0,5119,465.4,465.4,1,336.0,336.0,Pequeno I
2855,2862,315300,1833,1517,101,1048,1149,368,1781.0,1477.92,95.5,1026.67,1122.17,355.75,21372,17735,1146,12320,13466,4269,2022,'PRATINHA',Pratinha,'MG',3153004,2597.0,2597,216.4,216.4,1,451.0,451.0,Pequeno I
2856,2863,315310,3602,2942,248,1798,2046,896,3530.0,2950.83,268.58,1802.33,2070.92,879.92,42360,35410,3223,21628,24851,10559,2022,'PRESIDENTE BERNARDES',Presidente Bernardes,'MG',3153103,1245.0,1245,103.8,103.8,2,109.0,109.0,Pequeno I
2857,2864,315320,2080,1622,244,560,804,818,2039.92,1618.17,255.42,596.83,852.25,765.92,24479,19418,3065,7162,10227,9191,2022,'PRESIDENTE JUSCELINO',Presidente Juscelino,'MG',3153202,667.0,667,55.6,55.6,1,30.0,30.0,Pequeno I
2858,2865,315330,2633,1750,248,625,873,877,2618.83,1770.58,245.75,622.83,868.58,902.0,31426,21247,2949,7474,10423,10824,2022,'PRESIDENTE KUBITSCHEK',Presidente Kubitschek,'MG',3153301,1134.0,1134,94.5,94.5,1,43.0,43.0,Pequeno I
2859,2866,315340,7873,6233,1463,2303,3766,2467,7749.83,6200.42,1295.42,2594.75,3890.17,2310.25,92998,74405,15545,31137,46682,27723,2022,'PRESIDENTE OLEGARIO',Presidente Olegário,'MG',3153400,1044.0,1044,87.0,87.0,1,69.0,69.0,Pequeno I
2860,2867,315350,5275,4720,405,3431,3836,884,5006.67,4490.08,431.33,3153.17,3584.5,905.58,60080,53881,5176,37838,43014,10867,2022,'ALTO JEQUITIBA',Alto Jequitibá,'MG',3153509,330.0,330,30.0,30.0,1,30.0,30.0,Pequeno I
2861,2868,315360,5492,4602,651,2052,2703,1899,5428.0,4624.75,652.83,2027.25,2680.08,1944.67,65136,55497,7834,24327,32161,23336,2022,'PRUDENTE DE MORAIS',Prudente de Morais,'MG',3153608,2841.0,2841,236.8,236.8,1,167.0,167.0,Pequeno I
2862,2869,315370,1740,1515,208,611,819,696,1677.42,1458.58,208.5,657.92,866.42,592.17,20129,17503,2502,7895,10397,7106,2022,'QUARTEL GERAL',Quartel Geral,'MG',3153707,1622.0,1622,135.2,135.2,1,81.0,81.0,Pequeno I
2863,2870,315380,773,560,106,54,160,400,767.25,581.42,112.42,52.92,165.33,416.08,9207,6977,1349,635,1984,4993,2022,'QUELUZITO',Queluzito,'MG',3153806,2024.0,2024,168.7,168.7,1,135.0,135.0,Pequeno I
2864,2871,315390,3969,3467,421,1789,2210,1257,3747.08,3293.75,400.0,1719.25,2119.25,1174.5,44965,39525,4800,20631,25431,14094,2022,'RAPOSOS',Raposos,'MG',3153905,1620.0,1620,147.3,147.3,1,135.0,135.0,Pequeno I
2865,2872,315400,12311,10504,1406,5802,7208,3296,11892.25,10239.83,1297.83,5882.75,7180.58,3059.25,142707,122878,15574,70593,86167,36711,2022,'RAUL SOARES',Raul Soares,'MG',3154002,3627.0,3627,302.2,302.2,3,190.0,190.0,Pequeno II
2866,2873,315410,6024,4818,1037,1259,2296,2522,5924.33,4841.75,1015.5,1223.25,2238.75,2603.0,71092,58101,12186,14679,26865,31236,2022,'RECREIO',Recreio,'MG',3154101,3532.0,3532,294.3,294.3,1,331.0,331.0,Pequeno I
2867,2874,315415,4573,4013,1381,682,2063,1950,4348.5,3843.75,1130.08,986.17,2116.25,1727.5,52182,46125,13561,11834,25395,20730,2022,'REDUTO',Reduto,'MG',3154150,626.0,626,52.2,52.2,1,35.0,35.0,Pequeno I
2868,2875,315420,4766,3801,985,828,1813,1988,4574.42,3675.75,851.33,868.08,1719.42,1956.33,54893,44109,10216,10417,20633,23476,2022,'RESENDE COSTA',Resende Costa,'MG',3154200,4418.0,4418,368.2,368.2,1,200.0,200.0,Pequeno I
2869,2876,315430,9857,7909,1438,3563,5001,2908,9595.33,7786.25,1399.67,3669.83,5069.5,2716.75,115144,93435,16796,44038,60834,32601,2022,'RESPLENDOR',Resplendor,'MG',3154309,3641.0,3641,303.4,303.4,1,274.0,274.0,Pequeno I
2870,2877,315440,2944,2509,296,1433,1729,780,2891.08,2493.58,263.25,1409.42,1672.67,820.92,34693,29923,3159,16913,20072,9851,2022,'RESSAQUINHA',Ressaquinha,'MG',3154408,2104.0,2104,175.3,175.3,1,77.0,77.0,Pequeno I
2871,2878,315445,5465,4464,256,3436,3692,772,5158.92,4282.58,247.25,3358.75,3606.0,676.58,61907,51391,2967,40305,43272,8119,2022,'RIACHINHO',Riachinho,'MG',3154457,2175.0,2175,181.2,181.2,1,190.0,190.0,Pequeno I
2872,2879,315450,6577,5724,600,3606,4206,1518,6520.75,5754.33,580.67,3703.58,4284.25,1470.08,78249,69052,6968,44443,51411,17641,2022,'RIACHO DOS MACHADOS',Riacho Dos Machados,'MG',3154507,2206.0,2206,183.8,183.8,1,109.0,109.0,Pequeno I
2873,2880,315460,139898,124247,14688,75322,90010,34237,128283.92,114680.33,14105.33,68848.92,82954.25,31726.08,1539407,1376164,169264,826187,995451,380713,2022,'RIBEIRAO DAS NEVES',Ribeirão Das Neves,'MG',3154606,51825.0,51825,4318.8,4318.8,9,2936.0,2936.0,Grande
2874,2881,315470,2094,1545,157,690,847,698,2039.17,1524.58,142.58,722.25,864.83,659.75,24470,18295,1711,8667,10378,7917,2022,'RIBEIRAO VERMELHO',Ribeirão Vermelho,'MG',3154705,2450.0,2450,204.2,204.2,1,156.0,156.0,Pequeno I
2875,2882,315480,4624,3545,543,1471,2014,1531,4088.67,3229.83,505.33,1323.58,1828.92,1400.92,49064,38758,6064,15883,21947,16811,2022,'RIO ACIMA',Rio Acima,'MG',3154804,2741.0,2741,228.4,228.4,2,164.0,164.0,Pequeno I
2876,2883,315490,8053,6379,1063,2286,3349,3030,7855.25,6283.75,926.08,2411.83,3337.92,2945.83,94263,75405,11113,28942,40055,35350,2022,'RIO CASCA',Rio Casca,'MG',3154903,2577.0,2577,214.8,214.8,1,498.0,498.0,Pequeno I
2877,2884,315500,1548,1060,80,543,623,437,1525.25,1083.83,95.83,538.83,634.67,449.17,18303,13006,1150,6466,7616,5390,2022,'RIO DOCE',Rio Doce,'MG',3155009,890.0,890,74.2,74.2,1,77.0,77.0,Pequeno I
2878,2885,315510,3682,3253,71,2669,2740,513,3604.33,3236.0,57.17,2731.5,2788.67,447.33,43252,38832,686,32778,33464,5368,2022,'RIO DO PRADO',Rio do Prado,'MG',3155108,4645.0,4645,387.1,387.1,1,101.0,101.0,Pequeno I
2879,2886,315520,3075,2752,109,2221,2330,422,2977.33,2675.17,122.83,2136.75,2259.58,415.58,35728,32102,1474,25641,27115,4987,2022,'RIO ESPERA',Rio Espera,'MG',3155207,926.0,926,77.2,77.2,1,23.0,23.0,Pequeno I
2880,2887,315530,2185,1921,191,1380,1571,350,2013.58,1776.0,208.25,1218.0,1426.25,349.75,24163,21312,2499,14616,17115,4197,2022,'RIO MANSO',Rio Manso,'MG',3155306,2468.0,2468,205.7,205.7,1,68.0,68.0,Pequeno I
2881,2888,315540,4950,3661,388,1477,1865,1796,4741.92,3603.75,392.67,1478.33,1871.0,1732.75,56903,43245,4712,17740,22452,20793,2022,'RIO NOVO',Rio Novo,'MG',3155405,6221.0,6221,518.4,518.4,1,448.0,448.0,Pequeno I
2882,2889,315550,5652,4370,902,1350,2252,2118,5371.75,4192.58,885.92,1320.25,2206.17,1986.42,64461,50311,10631,15843,26474,23837,2022,'RIO PARANAIBA',Rio Paranaíba,'MG',3155504,7323.0,9564,610.2,797.0,1,974.0,974.0,Pequeno I
2883,2890,315560,21016,19070,1132,13718,14850,4220,20417.25,18606.58,1087.25,13400.08,14487.33,4119.25,245007,223279,13047,160801,173848,49431,2022,'RIO PARDO DE MINAS',Rio Pardo de Minas,'MG',3155603,3915.0,3915,326.2,326.2,2,164.0,164.0,Pequeno II
2884,2891,315570,7066,5496,931,2469,3400,2096,6765.17,5427.33,858.83,2522.58,3381.42,2045.92,81182,65128,10306,30271,40577,24551,2022,'RIO PIRACICABA',Rio Piracicaba,'MG',3155702,2505.0,2505,208.8,208.8,1,185.0,185.0,Pequeno I
2885,2892,315580,8442,7144,1066,2975,4041,3103,8083.33,6876.42,1065.08,2770.25,3835.33,3041.08,97000,82517,12781,33243,46024,36493,2022,'RIO POMBA',Rio Pomba,'MG',3155801,4565.0,11775,380.4,981.2,1,352.0,352.0,Pequeno I
2886,2893,315590,2993,2610,157,1949,2106,504,2764.5,2416.08,161.67,1710.92,1872.58,543.5,33174,28993,1940,20531,22471,6522,2022,'RIO PRETO',Rio Preto,'MG',3155900,2188.0,2188,198.9,198.9,1,114.0,114.0,Pequeno I
2887,2894,315600,8199,6488,1491,2772,4263,2225,8084.5,6490.08,1248.08,3143.92,4392.0,2098.08,97014,77881,14977,37727,52704,25177,2022,'RIO VERMELHO',Rio Vermelho,'MG',3156007,5220.0,5220,435.0,435.0,1,300.0,300.0,Pequeno I
2888,2895,315610,2745,2239,378,962,1340,899,2650.25,2191.0,380.25,948.33,1328.58,862.42,31803,26292,4563,11380,15943,10349,2022,'RITAPOLIS',Ritápolis,'MG',3156106,659.0,659,54.9,54.9,1,61.0,61.0,Pequeno I
2889,2896,315620,1563,1310,109,681,790,520,1507.75,1284.33,140.0,675.5,815.5,468.83,18093,15412,1680,8106,9786,5626,2022,'ROCHEDO DE MINAS',Rochedo de Minas,'MG',3156205,3064.0,3064,255.3,255.3,1,73.0,73.0,Pequeno I
2890,2897,315630,3597,2925,464,1271,1735,1190,3209.92,2655.75,427.83,1212.42,1640.25,1015.5,38519,31869,5134,14549,19683,12186,2022,'RODEIRO',Rodeiro,'MG',3156304,1386.0,15070,115.5,1255.8,1,0.0,1315.0,Pequeno I
2891,2898,315640,1096,961,84,585,669,292,1019.67,895.08,98.75,544.83,643.58,251.5,12236,10741,1185,6538,7723,3018,2022,'ROMARIA',Romaria,'MG',3156403,608.0,608,60.8,60.8,1,178.0,178.0,Pequeno I
2892,2899,315645,2860,2298,390,583,973,1325,2767.25,2241.42,431.75,608.58,1040.33,1201.08,33207,26897,5181,7303,12484,14413,2022,'ROSARIO DA LIMEIRA',Rosário da Limeira,'MG',3156452,2968.0,2968,247.3,247.3,1,119.0,119.0,Pequeno I
2893,2900,315650,4451,3878,146,3068,3214,664,4308.75,3780.25,154.17,2961.92,3116.08,664.17,51705,45363,1850,35543,37393,7970,2022,'RUBELITA',Rubelita,'MG',3156502,2548.0,2548,212.3,212.3,1,260.0,260.0,Pequeno I
2894,2901,315660,5931,4847,505,2740,3245,1602,5880.58,4842.58,444.75,2948.17,3392.92,1449.67,70567,58111,5337,35378,40715,17396,2022,'RUBIM',Rubim,'MG',3156601,3574.0,3574,297.8,297.8,1,189.0,189.0,Pequeno I
2895,2902,315670,49078,41013,7458,19343,26801,14212,45241.25,38298.67,6728.42,18364.42,25092.83,13205.83,542895,459584,80741,220373,301114,158470,2022,'SABARA',Sabará,'MG',3156700,75156.0,75156,6263.0,6263.0,9,5321.0,5321.0,Grande
2896,2903,315680,9688,7954,1173,3934,5107,2847,9509.25,7898.0,1102.0,4003.58,5105.58,2792.42,114111,94776,13224,48043,61267,33509,2022,'SABINOPOLIS',Sabinópolis,'MG',3156809,5212.0,5212,434.3,434.3,1,335.0,335.0,Pequeno I
2897,2904,315690,10785,7638,1517,2255,3772,3866,10168.5,7295.42,1384.0,2275.75,3659.75,3635.67,122022,87545,16608,27309,43917,43628,2022,'SACRAMENTO',Sacramento,'MG',3156908,7856.0,7856,654.7,654.7,1,677.0,677.0,Pequeno II
2898,2905,315700,26002,21080,2239,11170,13409,7671,25095.08,20666.67,2356.83,10575.33,12932.17,7734.5,301141,248000,28282,126904,155186,92814,2022,'SALINAS',Salinas,'MG',3157005,13791.0,13791,1149.2,1149.2,2,893.0,893.0,Pequeno II
2899,2906,315710,4765,3834,224,2406,2630,1204,4766.42,3907.75,219.58,2575.67,2795.25,1112.5,57197,46893,2635,30908,33543,13350,2022,'SALTO DA DIVISA',Salto da Divisa,'MG',3157104,2326.0,2326,193.8,193.8,1,91.0,91.0,Pequeno I
2900,2907,315720,13399,11685,795,7836,8631,3054,12938.92,11401.67,793.67,7718.17,8511.83,2889.83,155267,136820,9524,92618,102142,34678,2022,'SANTA BARBARA',Santa Bárbara,'MG',3157203,1374.0,1374,114.5,114.5,1,82.0,82.0,Pequeno II
2901,2908,315725,6378,5474,497,3767,4264,1210,6212.5,5353.92,493.67,3671.0,4164.67,1189.25,74550,64247,5924,44052,49976,14271,2022,'SANTA BARBARA DO LESTE',Santa Bárbara do Leste,'MG',3157252,839.0,839,69.9,69.9,1,64.0,64.0,Pequeno I
2902,2909,315727,1758,1423,210,671,881,542,1629.67,1334.67,196.92,628.83,825.75,508.92,19556,16016,2363,7546,9909,6107,2022,'SANTA BARBARA DO MONTE VER,Santa Bárbara do Monte Verde,'MG',3157278,1441.0,1441,120.1,120.1,1,40.0,40.0,Pequeno I
2903,2910,315730,2020,1781,390,577,967,814,1974.42,1781.58,413.92,597.42,1011.33,770.25,23693,21379,4967,7169,12136,9243,2022,'SANTA BARBARA DO TUGURIO',Santa Bárbara do Tugúrio,'MG',3157302,1669.0,1669,139.1,139.1,1,36.0,36.0,Pequeno I
2904,2911,315733,4211,3532,595,1502,2097,1435,3891.08,3303.42,542.58,1378.58,1921.17,1382.25,46693,39641,6511,16543,23054,16587,2022,'SANTA CRUZ DE MINAS',Santa Cruz de Minas,'MG',3157336,1270.0,1270,105.8,105.8,1,124.0,124.0,Pequeno I
2905,2912,315737,3491,2776,116,1839,1955,821,3451.92,2792.5,121.42,1877.83,1999.25,793.25,41423,33510,1457,22534,23991,9519,2022,'SANTA CRUZ DE SALINAS',Santa Cruz de Salinas,'MG',3157377,809.0,809,67.4,67.4,1,123.0,123.0,Pequeno I
2906,2913,315740,2633,2265,239,1380,1619,646,2506.75,2155.25,245.58,1345.42,1591.0,564.25,30081,25863,2947,16145,19092,6771,2022,'SANTA CRUZ DO ESCALVADO',Santa Cruz do Escalvado,'MG',3157401,107.0,107,8.9,8.9,1,5.0,5.0,Pequeno I
2907,2914,315750,3669,3095,228,2031,2259,836,3542.25,3050.08,228.0,2027.33,2255.33,794.75,42507,36601,2736,24328,27064,9537,2022,'SANTA EFIGENIA DE MINAS',Santa Efigênia de Minas,'MG',3157500,995.0,995,82.9,82.9,1,95.0,95.0,Pequeno I
2908,2915,315760,3016,2661,94,2158,2252,409,2932.42,2639.58,105.58,2158.67,2264.25,375.33,35189,31675,1267,25904,27171,4504,2022,'SANTA FE DE MINAS',Santa fé de Minas,'MG',3157609,2997.0,2997,249.8,249.8,1,101.0,101.0,Pequeno I
2909,2916,315765,5365,4802,96,4325,4421,381,5277.83,4756.67,100.17,4253.08,4353.25,403.42,63334,57080,1202,51037,52239,4841,2022,'SANTA HELENA DE MINAS',Santa Helena de Minas,'MG',3157658,2672.0,2672,222.7,222.7,1,190.0,190.0,Pequeno I
2910,2917,315770,3781,3379,1267,815,2082,1297,3461.67,3099.17,1180.08,751.67,1931.75,1167.42,41540,37190,14161,9020,23181,14009,2022,'SANTA JULIANA',Santa Juliana,'MG',3157708,35.0,35,7.0,7.0,1,,,Pequeno I
2911,2918,315780,95709,84143,6626,52539,59165,24978,91734.67,81611.83,6369.75,52315.83,58685.58,22926.25,1100816,979342,76437,627790,704227,275115,2022,'SANTA LUZIA',Santa Luzia,'MG',3157807,57740.0,57740,4811.7,4811.7,3,4391.0,4391.0,Grande
2912,2919,315790,11972,10718,971,6615,7586,3132,11638.42,10521.0,999.83,6622.75,7622.58,2898.42,139661,126252,11998,79473,91471,34781,2022,'SANTA MARGARIDA',Santa Margarida,'MG',3157906,7532.0,7532,627.7,627.7,2,594.0,594.0,Pequeno I
2913,2920,315800,4818,3942,612,1478,2090,1852,4657.75,3857.42,604.17,1375.83,1980.0,1877.42,55893,46289,7250,16510,23760,22529,2022,'SANTA MARIA DE ITABIRA',Santa Maria de Itabira,'MG',3158003,1101.0,1101,91.8,91.8,1,63.0,63.0,Pequeno I
2914,2921,315810,3643,3191,161,2448,2609,582,3525.42,3113.58,171.58,2391.42,2563.0,550.58,42305,37363,2059,28697,30756,6607,2022,'SANTA MARIA DO SALTO',Santa Maria do Salto,'MG',3158102,3555.0,3555,296.2,296.2,1,191.0,191.0,Pequeno I
2915,2922,315820,7886,6997,617,4908,5525,1472,7645.17,6815.08,608.67,4901.33,5510.0,1305.08,91742,81781,7304,58816,66120,15661,2022,'SANTA MARIA DO SUACUI',Santa Maria do Suaçuí,'MG',3158201,1670.0,1670,139.2,139.2,1,59.0,59.0,Pequeno I
2916,2923,315830,4184,3078,371,695,1066,2012,3985.75,3001.92,361.0,735.25,1096.25,1905.67,47829,36023,4332,8823,13155,22868,2022,'SANTANA DA VARGEM',Santana da Vargem,'MG',3158300,1960.0,1960,163.3,163.3,1,142.0,142.0,Pequeno I
2917,2924,315840,2332,1843,165,877,1042,801,2282.83,1810.08,147.08,895.83,1042.92,767.17,27394,21721,1765,10750,12515,9206,2022,'SANTANA DE CATAGUASES',Santana de Cataguases,'MG',3158409,2020.0,2020,168.3,168.3,1,95.0,95.0,Pequeno I
2918,2925,315850,3777,3243,502,1654,2156,1087,3670.58,3203.25,482.33,1663.58,2145.92,1057.33,44047,38439,5788,19963,25751,12688,2022,'SANTANA DE PIRAPAMA',Santana de Pirapama,'MG',3158508,1760.0,1760,146.7,146.7,1,97.0,97.0,Pequeno I
2919,2926,315860,1774,1472,318,416,734,738,1617.5,1338.92,290.0,381.33,671.33,667.58,19410,16067,3480,4576,8056,8011,2022,'SANTANA DO DESERTO',Santana do Deserto,'MG',3158607,1332.0,1332,111.0,111.0,1,89.0,89.0,Pequeno I
2920,2927,315870,1384,1202,69,812,881,321,1353.42,1179.92,80.75,802.17,882.92,297.0,16241,14159,969,9626,10595,3564,2022,'SANTANA DO GARAMBEU',Santana do Garambéu,'MG',3158706,1004.0,1004,83.7,83.7,1,97.0,97.0,Pequeno I
2921,2928,315880,3130,2522,349,1007,1356,1166,3048.42,2447.42,358.5,900.58,1259.08,1188.33,36581,29369,4302,10807,15109,14260,2022,'SANTANA DO JACARE',Santana do Jacaré,'MG',3158805,189.0,189,15.8,15.8,1,9.0,9.0,Pequeno I
2922,2929,315890,5599,5048,1659,1903,3562,1486,5391.25,4889.0,1354.42,2261.0,3615.42,1273.58,64695,58668,16253,27132,43385,15283,2022,'SANTANA DO MANHUACU',Santana do Manhuaçu,'MG',3158904,2576.0,2576,214.7,214.7,1,300.0,300.0,Pequeno I
2923,2930,315895,19526,15621,2028,6728,8756,6865,18783.17,15325.0,1866.0,7073.67,8939.67,6385.33,225398,183900,22392,84884,107276,76624,2022,'SANTANA DO PARAISO',Santana do Paraíso,'MG',3158953,10165.0,10165,847.1,847.1,2,699.0,699.0,Pequeno II
2924,2931,315900,2505,2263,367,1219,1586,677,2310.08,2089.25,280.42,1286.75,1567.17,522.08,27721,25071,3365,15441,18806,6265,2022,'SANTANA DO RIACHO',Santana do Riacho,'MG',3159001,1617.0,1617,134.8,134.8,1,56.0,56.0,Pequeno I
2925,2932,315910,1744,1597,137,1242,1379,218,1621.75,1486.75,156.25,1117.5,1273.75,213.0,19461,17841,1875,13410,15285,2556,2022,'SANTANA DOS MONTES',Santana Dos Montes,'MG',3159100,737.0,737,61.4,61.4,1,125.0,125.0,Pequeno I
2926,2933,315920,4098,2761,553,840,1393,1368,3907.33,2681.17,534.5,835.17,1369.67,1311.5,46888,32174,6414,10022,16436,15738,2022,'SANTA RITA DE CALDAS',Santa Rita de Caldas,'MG',3159209,990.0,990,82.5,82.5,1,74.0,74.0,Pequeno I
2927,2934,315930,2851,2261,213,1224,1437,824,2735.17,2175.83,226.67,1140.92,1367.58,808.25,32822,26110,2720,13691,16411,9699,2022,'SANTA RITA DE JACUTINGA',Santa Rita de Jacutinga,'MG',3159308,2437.0,2437,243.7,243.7,1,155.0,155.0,Pequeno I
2928,2935,315935,3621,3121,602,1371,1973,1148,3342.33,2898.5,577.92,1224.92,1802.83,1095.67,40108,34782,6935,14699,21634,13148,2022,'SANTA RITA DE MINAS',Santa Rita de Minas,'MG',3159357,3087.0,3087,257.2,257.2,1,175.0,175.0,Pequeno I
2929,2936,315940,1808,1569,246,776,1022,547,1765.08,1555.42,247.25,783.17,1030.42,525.0,21181,18665,2967,9398,12365,6300,2022,'SANTA RITA DE IBITIPOCA',Santa Rita de Ibitipoca,'MG',3159407,1752.0,1752,159.3,159.3,1,103.0,103.0,Pequeno I
2930,2937,315950,3731,3359,363,2485,2848,511,3529.75,3189.83,320.58,2424.08,2744.67,445.17,42357,38278,3847,29089,32936,5342,2022,'SANTA RITA DO ITUETO',Santa Rita do Itueto,'MG',3159506,625.0,625,52.1,52.1,1,90.0,90.0,Pequeno I
2931,2938,315960,17300,13076,3349,2076,5425,7651,17130.17,13327.42,3467.5,2336.33,5803.83,7523.58,205562,159929,41610,28036,69646,90283,2022,'SANTA RITA DO SAPUCAI',Santa Rita do Sapucaí,'MG',3159605,658.0,658,54.8,54.8,1,24.0,24.0,Pequeno II
2932,2939,315970,1715,1535,221,986,1207,328,1655.0,1486.58,197.33,1011.83,1209.17,277.42,19860,17839,2368,12142,14510,3329,2022,'SANTA ROSA DA SERRA',Santa Rosa da Serra,'MG',3159704,1346.0,1346,112.2,112.2,1,89.0,89.0,Pequeno I
2933,2940,315980,10792,7281,1377,3244,4621,2660,10197.17,6944.42,1275.08,2991.83,4266.92,2677.5,122366,83333,15301,35902,51203,32130,2022,'SANTA VITORIA',Santa Vitória,'MG',3159803,7613.0,28259,634.4,2354.9,2,1715.0,1715.0,Pequeno I
2934,2941,315990,10029,8453,1179,4143,5322,3131,9738.5,8304.25,979.58,4402.5,5382.08,2922.17,116862,99651,11755,52830,64585,35066,2022,'SANTO ANTONIO DO AMPARO',Santo Antônio do Amparo,'MG',3159902,6965.0,6965,580.4,580.4,1,265.0,265.0,Pequeno I
2935,2942,316000,2026,1733,189,1027,1216,517,1884.5,1633.0,168.92,986.58,1155.5,477.5,22614,19596,2027,11839,13866,5730,2022,'SANTO ANTONIO DO AVENTUREI,Santo Antônio do Aventureiro,'MG',3160009,1670.0,1670,139.2,139.2,1,110.0,110.0,Pequeno I
2936,2943,316010,2285,1873,253,654,907,966,2258.42,1865.5,232.25,708.0,940.25,925.25,27101,22386,2787,8496,11283,11103,2022,'SANTO ANTONIO DO GRAMA',Santo Antônio do Grama,'MG',3160108,1049.0,1049,87.4,87.4,1,26.0,26.0,Pequeno I
2937,2944,316020,2862,2443,308,1417,1725,718,2836.5,2445.25,327.58,1387.08,1714.67,730.58,34038,29343,3931,16645,20576,8767,2022,'SANTO ANTONIO DO ITAMBE',Santo Antônio do Itambé,'MG',3160207,1079.0,1079,89.9,89.9,1,55.0,55.0,Pequeno I
2938,2945,316030,8163,6762,1033,4010,5043,1719,8024.17,6729.0,923.92,4209.42,5133.33,1595.67,96290,80748,11087,50513,61600,19148,2022,'SANTO ANTONIO DO JACINTO',Santo Antônio do Jacinto,'MG',3160306,1672.0,1672,139.3,139.3,1,87.0,87.0,Pequeno I
2939,2946,316040,8771,6895,1332,1488,2820,4075,8368.17,6755.5,1364.92,1575.83,2940.75,3814.75,100418,81066,16379,18910,35289,45777,2022,'SANTO ANTONIO DO MONTE',Santo Antônio do Monte,'MG',3160405,3879.0,3879,323.2,323.2,2,269.0,269.0,Pequeno II
2940,2947,316045,5672,5379,224,4781,5005,374,5586.42,5330.75,190.33,4788.67,4979.0,351.75,67037,63969,2284,57464,59748,4221,2022,'SANTO ANTONIO DO RETIRO',Santo Antônio do Retiro,'MG',3160454,4002.0,4002,333.5,333.5,1,65.0,65.0,Pequeno I
2941,2948,316050,1228,1031,80,568,648,383,1175.83,1010.25,103.42,542.17,645.58,364.67,14110,12123,1241,6506,7747,4376,2022,'SANTO ANTONIO DO RIO ABAIX,Santo Antônio do Rio Abaixo,'MG',3160504,949.0,949,94.9,94.9,1,43.0,43.0,Pequeno I
2942,2949,316060,1885,1562,92,1069,1161,401,1837.25,1551.33,92.58,1085.0,1177.58,373.75,22047,18616,1111,13020,14131,4485,2022,'SANTO HIPOLITO',Santo Hipólito,'MG',3160603,1015.0,1015,101.5,101.5,1,79.0,79.0,Pequeno I
2943,2950,316070,18072,15477,2442,7321,9763,5714,16881.67,14635.42,2219.25,7199.33,9418.58,5216.83,202580,175625,26631,86392,113023,62602,2022,'SANTOS DUMONT',Santos Dumont,'MG',3160702,17523.0,17523,1460.2,1460.2,3,1184.0,1184.0,Pequeno II
2944,2951,316080,2710,2309,558,659,1217,1092,2612.08,2235.33,584.92,440.75,1025.67,1209.67,31345,26824,7019,5289,12308,14516,2022,'SAO BENTO ABADE',São Bento Abade,'MG',3160801,3732.0,3732,373.2,373.2,1,190.0,190.0,Pequeno I
2945,2952,316090,1552,1354,148,774,922,432,1398.42,1226.17,151.83,676.0,827.83,398.33,16781,14714,1822,8112,9934,4780,2022,'SAO BRAS DO SUACUI',São Brás do Suaçuí,'MG',3160900,3273.0,3273,272.8,272.8,1,279.0,279.0,Pequeno I
2946,2953,316095,4317,3389,816,1121,1937,1452,4264.0,3457.0,861.75,1281.0,2142.75,1314.25,51168,41484,10341,15372,25713,15771,2022,'SAO DOMINGOS DAS DORES',São Domingos Das Dores,'MG',3160959,1414.0,1414,117.8,117.8,1,66.0,66.0,Pequeno I
2947,2954,316100,7744,6085,1062,2351,3413,2672,7523.25,6060.08,1080.17,2297.83,3378.0,2682.08,90279,72721,12962,27574,40536,32185,2022,'SAO DOMINGOS DO PRATA',São Domingos do Prata,'MG',3161007,8445.0,8445,703.8,703.8,1,582.0,582.0,Pequeno I
2948,2955,316105,2059,1752,129,1146,1275,477,2100.08,1822.0,123.75,1215.25,1339.0,483.0,25201,21864,1485,14583,16068,5796,2022,'SAO FELIX DE MINAS',São Félix de Minas,'MG',3161056,1629.0,1629,135.8,135.8,1,53.0,53.0,Pequeno I
2949,2956,316110,42617,37627,2788,26567,29355,8272,41532.42,37085.08,2880.08,26034.25,28914.33,8170.75,498389,445021,34561,312411,346972,98049,2022,'SAO FRANCISCO',São Francisco,'MG',3161106,14724.0,14724,1227.0,1227.0,3,1002.0,1002.0,Médio
2950,2957,316120,3759,2652,489,753,1242,1410,3646.83,2615.75,472.58,758.92,1231.5,1384.25,43762,31389,5671,9107,14778,16611,2022,'SAO FRANCISCO DE PAULA',São Francisco de Paula,'MG',3161205,2077.0,2077,173.1,173.1,1,79.0,79.0,Pequeno I
2951,2958,316130,3250,2407,243,1314,1557,850,3141.0,2363.92,215.67,1376.83,1592.5,771.42,37692,28367,2588,16522,19110,9257,2022,'SAO FRANCISCO DE SALES',São Francisco de Sales,'MG',3161304,1206.0,1206,100.5,100.5,1,77.0,77.0,Pequeno I
2952,2959,316140,3272,2290,406,766,1172,1118,3328.25,2397.33,396.58,877.0,1273.58,1123.75,39939,28768,4759,10524,15283,13485,2022,'SAO FRANCISCO DO GLORIA',São Francisco do Glória,'MG',3161403,1666.0,1666,138.8,138.8,1,73.0,73.0,Pequeno I
2953,2960,316150,5652,4787,430,2611,3041,1746,5345.42,4594.92,417.75,2441.25,2859.0,1735.92,64145,55139,5013,29295,34308,20831,2022,'SAO GERALDO',São Geraldo,'MG',3161502,3117.0,3117,259.8,259.8,1,222.0,222.0,Pequeno I
2954,2961,316160,2893,2476,143,1734,1877,599,2845.33,2448.42,145.0,1727.92,1872.92,575.5,34144,29381,1740,20735,22475,6906,2022,'SAO GERALDO DA PIEDADE',São Geraldo da Piedade,'MG',3161601,238.0,238,23.8,23.8,1,25.0,25.0,Pequeno I
2955,2962,316165,2340,2018,215,1262,1477,541,2287.83,1982.83,217.0,1254.08,1471.08,511.75,27454,23794,2604,15049,17653,6141,2022,'SAO GERALDO DO BAIXIO',São Geraldo do Baixio,'MG',3161650,1188.0,1188,99.0,99.0,1,116.0,116.0,Pequeno I
2956,2963,316170,3514,2993,219,2039,2258,735,3314.25,2834.17,214.75,1925.17,2139.92,694.25,39771,34010,2577,23102,25679,8331,2022,'SAO GONCALO DO ABAETE',São Gonçalo do Abaeté,'MG',3161700,1971.0,1971,164.2,164.2,1,119.0,119.0,Pequeno I
2957,2964,316180,5057,3926,833,1002,1835,2091,4731.42,3757.42,765.67,919.58,1685.25,2072.17,56777,45089,9188,11035,20223,24866,2022,'SAO GONCALO DO PARA',São Gonçalo do Pará,'MG',3161809,3793.0,3793,316.1,316.1,1,245.0,245.0,Pequeno I
2958,2965,316190,8627,5387,716,1982,2698,2689,8269.67,5358.33,748.67,1952.42,2701.08,2657.25,99236,64300,8984,23429,32413,31887,2022,'SAO GONCALO DO RIO ABAIXO',São Gonçalo do Rio Abaixo,'MG',3161908,899.0,899,74.9,74.9,1,29.0,29.0,Pequeno I
2959,2966,316200,11411,9906,1843,4440,6283,3623,10802.25,9365.42,1846.42,3916.08,5762.5,3602.92,129627,112385,22157,46993,69150,43235,2022,'SAO GONCALO DO SAPUCAI',São Gonçalo do Sapucaí,'MG',3162005,9964.0,9964,830.3,830.3,1,890.0,890.0,Pequeno II
2960,2967,316210,18473,13949,4726,1216,5942,8007,16958.25,12975.33,4673.25,1178.08,5851.33,7124.0,203499,155704,56079,14137,70216,85488,2022,'SAO GOTARDO',São Gotardo,'MG',3162104,13955.0,13955,1162.9,1162.9,1,1131.0,1131.0,Pequeno II
2961,2968,316220,2430,1904,413,392,805,1099,2271.17,1798.25,372.92,345.33,718.25,1080.0,27254,21579,4475,4144,8619,12960,2022,'SAO JOAO BATISTA DO GLORIA,São João Batista do Glória,'MG',3162203,1621.0,1621,135.1,135.1,1,115.0,115.0,Pequeno I
2962,2969,316225,4019,3291,202,2322,2524,767,3896.92,3231.58,180.83,2297.17,2478.0,753.58,46763,38779,2170,27566,29736,9043,2022,'SAO JOAO DA LAGOA',São João da Lagoa,'MG',3162252,1772.0,1772,147.7,147.7,1,134.0,134.0,Pequeno I
2963,2970,316230,1460,1241,305,584,889,352,1389.25,1184.08,264.0,566.5,830.5,353.58,16671,14209,3168,6798,9966,4243,2022,'SAO JOAO DA MATA',São João da Mata,'MG',3162302,1094.0,1094,91.2,91.2,1,54.0,54.0,Pequeno I
2964,2971,316240,17684,16038,1310,11345,12655,3383,17194.67,15723.67,1291.17,11390.08,12681.25,3042.42,206336,188684,15494,136681,152175,36509,2022,'SAO JOAO DA PONTE',São João da Ponte,'MG',3162401,4534.0,4534,377.8,377.8,1,937.0,937.0,Pequeno II
2965,2972,316245,10694,9988,846,6884,7730,2258,10556.17,9974.67,781.25,7409.08,8190.33,1784.33,126674,119696,9375,88909,98284,21412,2022,'SAO JOAO DAS MISSOES',São João Das Missões,'MG',3162450,837.0,837,93.0,93.0,1,,,Pequeno I
2966,2973,316250,30974,25464,4960,10259,15219,10245,29059.92,24116.17,4743.92,9703.58,14447.5,9668.67,348719,289394,56927,116443,173370,116024,2022,'SAO JOAO DEL REI',São João Del Rei,'MG',3162500,16275.0,16275,1356.2,1356.2,4,1709.0,1709.0,Médio
2967,2974,316255,9241,8415,487,6110,6597,1818,8934.08,8196.5,405.25,6112.92,6518.17,1678.33,107209,98358,4863,73355,78218,20140,2022,'SAO JOAO DO MANHUACU',São João do Manhuaçu,'MG',3162559,4297.0,4297,358.1,358.1,1,310.0,310.0,Pequeno I
2968,2975,316257,3916,3177,284,2142,2426,751,3677.42,2988.42,227.0,1977.33,2204.33,784.08,44129,35861,2724,23728,26452,9409,2022,'SAO JOAO DO MANTENINHA',São João do Manteninha,'MG',3162575,2551.0,2551,212.6,212.6,1,156.0,156.0,Pequeno I
2969,2976,316260,6567,5474,521,3551,4072,1402,6168.25,5221.67,508.5,3263.25,3771.75,1449.92,74019,62660,6102,39159,45261,17399,2022,'SAO JOAO DO ORIENTE',São João do Oriente,'MG',3162609,4250.0,4250,354.2,354.2,1,389.0,389.0,Pequeno I
2970,2977,316265,3255,2761,87,1905,1992,769,3220.08,2766.42,85.5,1964.5,2050.0,716.42,38641,33197,1026,23574,24600,8597,2022,'SAO JOAO DO PACUI',São João do Pacuí,'MG',3162658,7271.0,7271,605.9,605.9,1,556.0,556.0,Pequeno I
2971,2978,316270,12630,11137,1516,5746,7262,3875,12191.5,10881.5,1384.83,5775.83,7160.67,3720.83,146298,130578,16618,69310,85928,44650,2022,'SAO JOAO DO PARAISO',São João do Paraíso,'MG',3162708,3777.0,3777,314.8,314.8,2,315.0,315.0,Pequeno II
2972,2979,316280,8979,7866,1036,4217,5253,2613,8800.0,7820.33,1046.17,4344.58,5390.75,2429.58,105600,93844,12554,52135,64689,29155,2022,'SAO JOAO EVANGELISTA',São João Evangelista,'MG',3162807,5343.0,5343,445.2,445.2,1,420.0,420.0,Pequeno I
2973,2980,316290,12038,9882,1305,3802,5107,4775,11288.92,9547.5,1299.25,3717.17,5016.42,4531.08,135467,114570,15591,44606,60197,54373,2022,'SAO JOAO NEPOMUCENO',São João Nepomuceno,'MG',3162906,5808.0,5808,484.0,484.0,1,434.0,434.0,Pequeno II
2974,2981,316292,18151,15846,1979,9859,11838,4008,16701.5,14650.25,1778.42,9299.25,11077.67,3572.58,200418,175803,21341,111591,132932,42871,2022,'SAO JOAQUIM DE BICAS',São Joaquim de Bicas,'MG',3162922,10929.0,10929,910.8,910.8,3,928.0,928.0,Pequeno II
2975,2982,316294,3136,2682,644,701,1345,1337,2915.92,2512.58,529.33,679.33,1208.67,1303.92,34991,30151,6352,8152,14504,15647,2022,'SAO JOSE DA BARRA',São José da Barra,'MG',3162948,1347.0,1347,112.2,112.2,1,102.0,102.0,Pequeno I
2976,2983,316295,11219,9883,956,5952,6908,2975,10471.92,9299.83,799.17,5862.67,6661.83,2638.0,125663,111598,9590,70352,79942,31656,2022,'SAO JOSE DA LAPA',São José da Lapa,'MG',3162955,4813.0,4813,401.1,401.1,1,352.0,352.0,Pequeno I
2977,2984,316300,3224,2804,163,1996,2159,645,3081.42,2697.08,164.67,1881.33,2046.0,651.08,36977,32365,1976,22576,24552,7813,2022,'SAO JOSE DA SAFIRA',São José da Safira,'MG',3163003,2292.0,2292,191.0,191.0,1,201.0,201.0,Pequeno I
2978,2985,316310,2448,1924,469,551,1020,904,2338.75,1850.67,471.08,510.58,981.67,869.0,28065,22208,5653,6127,11780,10428,2022,'SAO JOSE DA VARGINHA',São José da Varginha,'MG',3163102,971.0,971,80.9,80.9,1,42.0,42.0,Pequeno I
2979,2986,316320,2118,1784,378,326,704,1080,2042.42,1759.92,385.83,387.75,773.58,986.33,24509,21119,4630,4653,9283,11836,2022,'SAO JOSE DO ALEGRE',São José do Alegre,'MG',3163201,951.0,951,190.2,190.2,1,130.0,130.0,Pequeno I
2980,2987,316330,2928,2436,160,1798,1958,478,2930.67,2459.75,158.33,1813.58,1971.92,487.83,35168,29517,1900,21763,23663,5854,2022,'SAO JOSE DO DIVINO',São José do Divino,'MG',3163300,625.0,625,52.1,52.1,1,72.0,72.0,Pequeno I
2981,2988,316340,3029,2551,264,1553,1817,734,2896.92,2434.08,278.33,1428.08,1706.42,727.67,34763,29209,3340,17137,20477,8732,2022,'SAO JOSE DO GOIABAL',São José do Goiabal,'MG',3163409,1753.0,1753,159.4,159.4,1,76.0,76.0,Pequeno I
2982,2989,316350,4118,3680,412,2544,2956,724,3977.25,3563.92,438.5,2367.75,2806.25,757.67,47727,42767,5262,28413,33675,9092,2022,'SAO JOSE DO JACURI',São José do Jacuri,'MG',3163508,4484.0,4484,373.7,373.7,1,749.0,749.0,Pequeno I
2983,2990,316360,1889,1697,151,1322,1473,224,1830.5,1650.17,137.92,1303.67,1441.58,208.58,21966,19802,1655,15644,17299,2503,2022,'SAO JOSE DO MANTIMENTO',São José do Mantimento,'MG',3163607,2428.0,2428,202.3,202.3,1,170.0,170.0,Pequeno I
2984,2991,316370,16967,14082,1944,6679,8623,5459,16015.33,13482.25,1858.17,6452.0,8310.17,5172.08,192184,161787,22298,77424,99722,62065,2022,'SAO LOURENCO',São Lourenço,'MG',3163706,5741.0,5741,478.4,478.4,2,376.0,376.0,Pequeno II
2985,2992,316380,4512,3901,197,2816,3013,888,4391.33,3825.83,190.58,2720.58,2911.17,914.67,52696,45910,2287,32647,34934,10976,2022,'SAO MIGUEL DO ANTA',São Miguel do Anta,'MG',3163805,2538.0,2538,211.5,211.5,1,113.0,113.0,Pequeno I
2986,2993,316390,2305,1917,807,347,1154,763,2220.67,1848.75,820.0,316.33,1136.33,712.42,26648,22185,9840,3796,13636,8549,2022,'SAO PEDRO DA UNIAO',São Pedro da União,'MG',3163904,676.0,676,56.3,56.3,1,88.0,88.0,Pequeno I
2987,2994,316400,3855,2778,343,865,1208,1570,3660.92,2755.67,347.33,910.0,1257.33,1498.33,43931,33068,4168,10920,15088,17980,2022,'SAO PEDRO DOS FERROS',São Pedro Dos Ferros,'MG',3164001,2596.0,2596,216.3,216.3,1,82.0,82.0,Pequeno I
2988,2995,316410,3445,3065,120,2475,2595,470,3338.58,3004.67,123.75,2451.08,2574.83,429.83,40063,36056,1485,29413,30898,5158,2022,'SAO PEDRO DO SUACUI',São Pedro do Suaçuí,'MG',3164100,2334.0,2334,194.5,194.5,1,77.0,77.0,Pequeno I
2989,2996,316420,5658,5101,127,3966,4093,1008,5616.33,5159.83,156.58,4095.08,4251.67,908.17,67396,61918,1879,49141,51020,10898,2022,'SAO ROMAO',São Romão,'MG',3164209,7332.0,10802,611.0,900.2,1,703.0,703.0,Pequeno I
2990,2997,316430,2669,2091,374,735,1109,982,2527.25,2005.5,346.75,765.42,1112.17,893.33,30327,24066,4161,9185,13346,10720,2022,'SAO ROQUE DE MINAS',São Roque de Minas,'MG',3164308,1181.0,1181,98.4,98.4,1,56.0,56.0,Pequeno I
2991,2998,316440,2997,2629,553,668,1221,1408,2860.83,2533.17,530.33,661.33,1191.67,1341.5,34330,30398,6364,7936,14300,16098,2022,'SAO SEBASTIAO DA BELA VIST,São Sebastião da Bela Vista,'MG',3164407,4837.0,4837,403.1,403.1,1,264.0,264.0,Pequeno I
2992,2999,316443,1755,1380,343,416,759,621,1693.92,1354.92,349.0,367.92,716.92,638.0,20327,16259,4188,4415,8603,7656,2022,'SAO SEBASTIAO DA VARGEM AL,São Sebastião da Vargem Alegre,'MG',3164431,848.0,848,70.7,70.7,1,66.0,66.0,Pequeno I
2993,3000,316447,5975,5386,99,4661,4760,626,5815.75,5296.75,97.25,4594.33,4691.58,605.17,69789,63561,1167,55132,56299,7262,2022,'SAO SEBASTIAO DO ANTA',São Sebastião do Anta,'MG',3164472,8970.0,8970,747.5,747.5,1,656.0,656.0,Pequeno I
2994,3001,316450,6789,5517,700,3174,3874,1643,6652.0,5511.75,697.92,3243.42,3941.33,1570.42,79824,66141,8375,38921,47296,18845,2022,'SAO SEBASTIAO DO MARANHAO',São Sebastião do Maranhão,'MG',3164506,5551.0,5551,462.6,462.6,1,251.0,251.0,Pequeno I
2995,3002,316460,3996,3490,359,2093,2452,1038,3680.75,3243.08,336.33,2015.83,2352.17,890.92,44169,38917,4036,24190,28226,10691,2022,'SAO SEBASTIAO DO OESTE',São Sebastião do Oeste,'MG',3164605,2285.0,2285,190.4,190.4,1,154.0,154.0,Pequeno I
2996,3003,316470,23854,19289,3017,7743,10760,8529,22621.08,18513.67,2924.08,7570.0,10494.08,8019.58,271453,222164,35089,90840,125929,96235,2022,'SAO SEBASTIAO DO PARAISO',São Sebastião do Paraíso,'MG',3164704,15481.0,15481,1290.1,1290.1,2,697.0,697.0,Médio
2997,3004,316480,633,577,97,305,402,175,589.75,545.83,104.92,301.58,406.5,139.33,7077,6550,1259,3619,4878,1672,2022,'SAO SEBASTIAO DO RIO PRETO,São Sebastião do Rio Preto,'MG',3164803,441.0,441,40.1,40.1,1,82.0,82.0,Pequeno I
2998,3005,316490,1075,840,184,224,408,432,1005.17,809.75,171.67,232.08,403.75,406.0,12062,9717,2060,2785,4845,4872,2022,'SAO SEBASTIAO DO RIO VERDE,São Sebastião do Rio Verde,'MG',3164902,393.0,393,32.8,32.8,1,27.0,27.0,Pequeno I
2999,3006,316500,4519,3361,616,829,1445,1916,4285.0,3229.92,683.5,756.17,1439.67,1790.25,51420,38759,8202,9074,17276,21483,2022,'SAO TIAGO',São Tiago,'MG',3165008,1953.0,1953,162.8,162.8,1,95.0,95.0,Pequeno I
3000,3007,316510,2844,2486,424,1176,1600,886,2787.0,2450.17,409.5,1235.33,1644.83,805.33,33444,29402,4914,14824,19738,9664,2022,'SAO TOMAS DE AQUINO',São Tomás de Aquino,'MG',3165107,2917.0,2917,243.1,243.1,1,125.0,125.0,Pequeno I
3001,3008,316520,3783,3031,538,1099,1637,1394,3641.17,3008.42,508.42,1225.58,1734.0,1274.42,43694,36101,6101,14707,20808,15293,2022,'SAO THOME DAS LETRAS',São Thomé Das Letras,'MG',3165206,5312.0,5312,442.7,442.7,1,364.0,364.0,Pequeno I
3002,3009,316530,3211,2616,349,1316,1665,951,3090.25,2524.25,369.33,1170.33,1539.67,984.58,37083,30291,4432,14044,18476,11815,2022,'SAO VICENTE DE MINAS',São Vicente de Minas,'MG',3165305,1115.0,1115,101.4,101.4,1,120.0,120.0,Pequeno I
3003,3010,316540,2989,2614,502,1102,1604,1010,2791.08,2472.42,409.5,1140.42,1549.92,922.5,33493,29669,4914,13685,18599,11070,2022,'SAPUCAI-MIRIM',Sapucaí-mirim,'MG',3165404,2483.0,2483,275.9,275.9,1,,,Pequeno I
3004,3011,316550,4401,3914,187,3156,3343,571,4239.17,3794.67,182.67,3028.33,3211.0,583.67,50870,45536,2192,36340,38532,7004,2022,'SARDOA',Sardoá,'MG',3165503,2303.0,2303,191.9,191.9,1,150.0,150.0,Pequeno I
3005,3012,316553,15855,12272,1797,4932,6729,5543,14788.75,11654.08,1660.42,4666.25,6326.67,5327.42,177465,139849,19925,55995,75920,63929,2022,'SARZEDO',Sarzedo,'MG',3165537,21887.0,21887,1823.9,1823.9,2,1285.0,1285.0,Pequeno II
3006,3013,316555,8603,8017,329,6648,6977,1040,8429.58,7936.5,313.92,6663.25,6977.17,959.33,101155,95238,3767,79959,83726,11512,2022,'SETUBINHA',Setubinha,'MG',3165552,4135.0,5502,344.6,458.5,1,250.0,250.0,Pequeno I
3007,3014,316556,1457,1158,106,571,677,481,1379.92,1127.33,105.25,583.5,688.75,438.58,16559,13528,1263,7002,8265,5263,2022,'SEM-PEIXE',Sem-peixe,'MG',3165560,1356.0,1356,113.0,113.0,1,22.0,22.0,Pequeno I
3008,3015,316557,4107,3783,1413,1399,2812,971,3799.08,3518.42,1278.08,1294.17,2572.25,946.17,45589,42221,15337,15530,30867,11354,2022,'SENADOR AMARAL',Senador Amaral,'MG',3165578,1713.0,1713,142.8,142.8,1,128.0,128.0,Pequeno I
3009,3016,316560,1388,1108,216,335,551,557,1196.42,988.17,177.25,375.58,552.83,435.33,14357,11858,2127,4507,6634,5224,2022,'SENADOR CORTES',Senador Cortes,'MG',3165602,1133.0,1133,94.4,94.4,1,102.0,102.0,Pequeno I
3010,3017,316570,4468,3952,900,1386,2286,1666,4281.33,3833.0,840.67,1426.92,2267.58,1565.42,51376,45996,10088,17123,27211,18785,2022,'SENADOR FIRMINO',Senador Firmino,'MG',3165701,1884.0,1884,157.0,157.0,1,98.0,98.0,Pequeno I
3011,3018,316580,983,739,84,381,465,274,903.92,676.33,78.0,363.92,441.92,234.42,10847,8116,936,4367,5303,2813,2022,'SENADOR JOSE BENTO',Senador José Bento,'MG',3165800,1251.0,1251,113.7,113.7,1,,,Pequeno I
3012,3019,316590,3639,2727,344,1475,1819,908,3578.75,2728.83,357.25,1463.67,1820.92,907.92,42945,32746,4287,17564,21851,10895,2022,'SENADOR MODESTINO GONCALVE,Senador Modestino Gonçalves,'MG',3165909,992.0,992,82.7,82.7,1,20.0,20.0,Pequeno I
3013,3020,316600,3121,2806,430,1633,2063,743,3041.42,2763.08,429.33,1601.17,2030.5,732.58,36497,33157,5152,19214,24366,8791,2022,'SENHORA DE OLIVEIRA',Senhora de Oliveira,'MG',3166006,1361.0,1361,113.4,113.4,1,15.0,15.0,Pequeno I
3014,3021,316610,2011,1759,202,1009,1211,548,1996.17,1779.33,212.83,1031.08,1243.92,535.42,23954,21352,2554,12373,14927,6425,2022,'SENHORA DO PORTO',Senhora do Porto,'MG',3166105,1033.0,1033,93.9,93.9,1,273.0,273.0,Pequeno I
3015,3022,316620,6208,5687,368,4460,4828,859,6009.5,5548.33,323.92,4410.17,4734.08,814.25,72114,66580,3887,52922,56809,9771,2022,'SENHORA DOS REMEDIOS',Senhora Dos Remédios,'MG',3166204,575.0,575,47.9,47.9,1,33.0,33.0,Pequeno I
3016,3023,316630,5143,4574,1217,2023,3240,1334,4970.42,4442.25,1109.17,2013.42,3122.58,1319.67,59645,53307,13310,24161,37471,15836,2022,'SERICITA',Sericita,'MG',3166303,2154.0,2154,179.5,179.5,1,205.0,205.0,Pequeno I
3017,3024,316640,521,445,95,154,249,196,481.83,424.08,100.75,139.42,240.17,183.92,5782,5089,1209,1673,2882,2207,2022,'SERITINGA',Seritinga,'MG',3166402,907.0,907,75.6,75.6,1,40.0,40.0,Pequeno I
3018,3025,316650,3484,3097,226,2010,2236,861,3414.58,3050.25,242.75,2012.25,2255.0,795.25,40975,36603,2913,24147,27060,9543,2022,'SERRA AZUL DE MINAS',Serra Azul de Minas,'MG',3166501,2910.0,2910,242.5,242.5,1,139.0,139.0,Pequeno I
3019,3026,316660,506,285,31,84,115,170,493.58,268.42,38.58,64.17,102.75,165.67,5923,3221,463,770,1233,1988,2022,'SERRA DA SAUDADE',Serra da Saudade,'MG',3166600,389.0,389,32.4,32.4,1,23.0,23.0,Pequeno I
3020,3027,316670,4611,3867,1054,1092,2146,1721,4580.17,3862.92,1029.33,1218.08,2247.42,1615.5,54962,46355,12352,14617,26969,19386,2022,'SERRA DOS AIMORES',Serra Dos Aimorés,'MG',3166709,1383.0,1383,115.2,115.2,1,51.0,51.0,Pequeno I
3021,3028,316680,6738,5398,490,3501,3991,1407,6474.25,5263.58,463.92,3534.08,3998.0,1265.58,77691,63163,5567,42409,47976,15187,2022,'SERRA DO SALITRE',Serra do Salitre,'MG',3166808,7189.0,7189,599.1,599.1,1,511.0,511.0,Pequeno I
3022,3029,316690,4352,3482,682,491,1173,2309,4256.33,3517.25,669.75,1009.75,1679.5,1837.75,51076,42207,8037,12117,20154,22053,2022,'SERRANIA',Serrania,'MG',3166907,2124.0,2124,193.1,193.1,1,180.0,180.0,Pequeno I
3023,3030,316695,3077,2671,88,1719,1807,864,3066.83,2710.42,84.33,1776.67,1861.0,849.42,36802,32525,1012,21320,22332,10193,2022,'SERRANOPOLIS DE MINAS',Serranópolis de Minas,'MG',3166956,884.0,884,73.7,73.7,1,30.0,30.0,Pequeno I
3024,3031,316700,1058,960,30,824,854,106,1016.67,929.0,27.5,789.75,817.25,111.75,12200,11148,330,9477,9807,1341,2022,'SERRANOS',Serranos,'MG',3167004,2760.0,2760,230.0,230.0,1,244.0,244.0,Pequeno I
3025,3032,316710,11853,10197,1425,5342,6767,3430,11375.92,9841.33,1555.42,5035.58,6591.0,3250.33,136511,118096,18665,60427,79092,39004,2022,'SERRO',Serro,'MG',3167103,5466.0,5466,455.5,455.5,1,314.0,314.0,Pequeno II
3026,3033,316720,69488,57875,9406,27372,36778,21097,63224.58,52951.75,8584.42,24443.0,33027.42,19924.33,758695,635421,103013,293316,396329,239092,2022,'SETE LAGOAS',Sete Lagoas,'MG',3167202,65144.0,79475,5428.7,6622.9,4,6418.0,6418.0,Grande
3027,3034,316730,1441,1228,145,638,783,445,1382.83,1192.5,143.33,603.33,746.67,445.83,16594,14310,1720,7240,8960,5350,2022,'SILVEIRANIA',Silveirânia,'MG',3167301,2382.0,2382,198.5,198.5,1,150.0,150.0,Pequeno I
3028,3035,316740,2650,2459,435,1629,2064,395,2503.0,2320.0,353.33,1568.5,1921.83,398.17,30036,27840,4240,18822,23062,4778,2022,'SILVIANOPOLIS',Silvianópolis,'MG',3167400,978.0,978,88.9,88.9,1,60.0,60.0,Pequeno I
3029,3036,316750,1269,1052,222,402,624,428,1227.92,1037.42,202.67,424.67,627.33,410.08,14735,12449,2432,5096,7528,4921,2022,'SIMAO PEREIRA',Simão Pereira,'MG',3167509,1418.0,1418,118.2,118.2,1,61.0,61.0,Pequeno I
3030,3037,316760,13653,12309,4568,4523,9091,3218,12756.92,11592.0,4261.58,4343.0,8604.58,2987.42,153083,139104,51139,52116,103255,35849,2022,'SIMONESIA',Simonésia,'MG',3167608,507.0,507,46.1,46.1,1,65.0,65.0,Pequeno I
3031,3038,316770,3866,3218,127,2537,2664,554,3813.25,3226.33,99.17,2619.58,2718.75,507.58,45759,38716,1190,31435,32625,6091,2022,'SOBRALIA',Sobrália,'MG',3167707,2865.0,2865,238.8,238.8,1,111.0,111.0,Pequeno I
3032,3039,316780,1991,1743,680,263,943,800,1841.58,1626.08,631.5,328.83,960.33,665.75,22099,19513,7578,3946,11524,7989,2022,'SOLEDADE DE MINAS',Soledade de Minas,'MG',3167806,1654.0,1654,137.8,137.8,1,70.0,70.0,Pequeno I
3033,3040,316790,2187,1759,318,452,770,989,2145.75,1727.25,265.17,505.83,771.0,956.25,25749,20727,3182,6070,9252,11475,2022,'TABULEIRO',Tabuleiro,'MG',3167905,1657.0,1657,138.1,138.1,1,88.0,88.0,Pequeno I
3034,3041,316800,20596,17725,2517,8602,11119,6606,19753.75,17141.67,2285.0,8448.83,10733.83,6407.83,237045,205700,27420,101386,128806,76894,2022,'TAIOBEIRAS',Taiobeiras,'MG',3168002,13004.0,13004,1083.7,1083.7,2,758.0,758.0,Pequeno II
3035,3042,316805,2676,2360,81,1977,2058,302,2531.25,2253.0,93.5,1886.67,1980.17,272.83,30375,27036,1122,22640,23762,3274,2022,'TAPARUBA',Taparuba,'MG',3168051,7011.0,7011,584.2,584.2,1,325.0,325.0,Pequeno I
3036,3043,316810,2256,1875,226,1285,1511,364,2063.25,1701.08,226.92,1109.92,1336.83,364.25,24759,20413,2723,13319,16042,4371,2022,'TAPIRA',Tapira,'MG',3168101,1370.0,1370,114.2,114.2,1,63.0,63.0,Pequeno I
3037,3044,316820,947,656,62,376,438,218,884.92,616.58,61.83,332.08,393.92,222.67,10619,7399,742,3985,4727,2672,2022,'TAPIRAI',Tapiraí,'MG',3168200,2158.0,2158,179.8,179.8,1,235.0,235.0,Pequeno I
3038,3045,316830,2567,2133,248,1268,1516,617,2409.58,2057.42,225.0,1272.0,1497.0,560.42,28915,24689,2700,15264,17964,6725,2022,'TAQUARACU DE MINAS',Taquaraçu de Minas,'MG',3168309,3709.0,3709,309.1,309.1,1,172.0,172.0,Pequeno I
3039,3046,316840,8234,7123,485,5288,5773,1350,7846.5,6834.67,475.0,5033.58,5508.58,1326.08,94158,82016,5700,60403,66103,15913,2022,'TARUMIRIM',Tarumirim,'MG',3168408,1959.0,1959,163.2,163.2,1,203.0,203.0,Pequeno I
3040,3047,316850,6232,5142,510,3031,3541,1601,5834.92,4844.42,532.42,2757.0,3289.42,1555.0,70019,58133,6389,33084,39473,18660,2022,'TEIXEIRAS',Teixeiras,'MG',3168507,6889.0,6889,574.1,574.1,1,555.0,555.0,Pequeno I
3041,3048,316860,64466,54447,8339,27591,35930,18517,59682.5,50577.33,7630.58,25423.92,33054.5,17522.83,716190,606928,91567,305087,396654,210274,2022,'TEOFILO OTONI',Teófilo Otoni,'MG',3168606,28072.0,28072,2339.3,2339.3,6,1724.0,1724.0,Grande
3042,3049,316870,26520,21612,2874,10608,13482,8130,24833.5,20550.92,2784.58,9937.42,12722.0,7828.92,298002,246611,33415,119249,152664,93947,2022,'TIMOTEO',Timóteo,'MG',3168705,19550.0,19550,1629.2,1629.2,4,1384.0,1384.0,Médio
3043,3050,316880,3278,2972,428,1717,2145,827,2998.08,2733.5,375.92,1591.17,1967.08,766.42,35977,32802,4511,19094,23605,9197,2022,'TIRADENTES',Tiradentes,'MG',3168804,2455.0,2455,223.2,223.2,1,127.0,127.0,Pequeno I
3044,3051,316890,3005,2323,346,1349,1695,628,2889.58,2233.92,320.75,1345.33,1666.08,567.83,34675,26807,3849,16144,19993,6814,2022,'TIROS',Tiros,'MG',3168903,2485.0,2485,207.1,207.1,1,74.0,74.0,Pequeno I
3045,3052,316900,7710,6549,1148,2735,3883,2666,7170.25,6137.17,1113.33,2418.5,3531.83,2605.33,86043,73646,13360,29022,42382,31264,2022,'TOCANTINS',Tocantins,'MG',3169000,714.0,714,59.5,59.5,1,75.0,75.0,Pequeno I
3046,3053,316905,1618,1397,649,345,994,403,1584.67,1387.33,444.92,530.42,975.33,412.0,19016,16648,5339,6365,11704,4944,2022,'TOCOS DO MOJI',Tocos do Moji,'MG',3169059,456.0,456,91.2,91.2,1,,,Pequeno I
3047,3054,316910,3043,2379,628,570,1198,1181,2822.33,2214.75,641.17,520.67,1161.83,1052.92,33868,26577,7694,6248,13942,12635,2022,'TOLEDO',Toledo,'MG',3169109,1597.0,1597,133.1,133.1,1,100.0,100.0,Pequeno I
3048,3055,316920,5034,4199,549,2652,3201,998,4797.83,3989.92,559.17,2400.17,2959.33,1030.58,57574,47879,6710,28802,35512,12367,2022,'TOMBOS',Tombos,'MG',3169208,2763.0,2763,230.2,230.2,1,264.0,264.0,Pequeno I
3049,3056,316930,30042,25829,5567,9698,15265,10564,27545.83,23754.75,5203.33,8797.0,14000.33,9754.42,330550,285057,62440,105564,168004,117053,2022,'TRES CORACOES',Três Corações,'MG',3169307,1946.0,1946,243.2,243.2,3,,,Médio
3050,3057,316935,13046,10529,1964,4422,6386,4143,12482.75,10225.17,1859.5,4316.25,6175.75,4049.42,149793,122702,22314,51795,74109,48593,2022,'TRES MARIAS',Três Marias,'MG',3169356,7103.0,7103,591.9,591.9,1,519.0,519.0,Pequeno II
3051,3058,316940,20378,17322,3118,6931,10049,7273,20142.08,17178.0,2769.67,7273.08,10042.75,7135.25,241705,206136,33236,87277,120513,85623,2022,'TRES PONTAS',Três Pontas,'MG',3169406,7310.0,7310,609.2,609.2,2,485.0,485.0,Médio
3052,3059,316950,4976,4231,151,3519,3670,561,4812.0,4135.0,126.0,3460.75,3586.75,548.25,57744,49620,1512,41529,43041,6579,2022,'TUMIRITINGA',Tumiritinga,'MG',3169505,4399.0,4399,366.6,366.6,1,200.0,200.0,Pequeno I
3053,3060,316960,13164,10852,961,7486,8447,2405,12603.17,10471.08,888.25,7297.5,8185.75,2285.33,151238,125653,10659,87570,98229,27424,2022,'TUPACIGUARA',Tupaciguara,'MG',3169604,5447.0,5447,453.9,453.9,2,681.0,681.0,Pequeno II
3054,3061,316970,12562,11204,1613,5305,6918,4286,11945.5,10747.17,1515.0,4908.33,6423.33,4323.83,143346,128966,18180,58900,77080,51886,2022,'TURMALINA',Turmalina,'MG',3169703,9655.0,9655,804.6,804.6,2,610.0,610.0,Pequeno I
3055,3062,316980,2777,2383,733,854,1587,796,2442.58,2099.83,734.17,605.42,1339.58,760.25,29311,25198,8810,7265,16075,9123,2022,'TURVOLANDIA',Turvolândia,'MG',3169802,2010.0,2010,167.5,167.5,1,225.0,225.0,Pequeno I
3056,3063,316990,39471,31864,7974,6397,14371,17493,37496.67,30605.42,7344.25,6100.83,13445.08,17160.33,449960,367265,88131,73210,161341,205924,2022,'UBA',Ubá,'MG',3169901,9372.0,9372,781.0,781.0,5,635.0,635.0,Grande
3057,3064,317000,7937,7407,413,5911,6324,1083,7742.25,7254.67,491.08,5614.58,6105.67,1149.0,92907,87056,5893,67375,73268,13788,2022,'UBAI',Ubaí,'MG',3170008,1609.0,1609,134.1,134.1,1,108.0,108.0,Pequeno I
3058,3065,317005,8152,6735,1182,3304,4486,2249,7799.75,6542.42,1018.75,3468.92,4487.67,2054.75,93597,78509,12225,41627,53852,24657,2022,'UBAPORANGA',Ubaporanga,'MG',3170057,1212.0,1212,101.0,101.0,1,102.0,102.0,Pequeno I
3059,3066,317010,80069,63842,10773,33003,43776,20066,70623.25,55777.42,9790.92,27207.0,36997.92,18779.5,847479,669329,117491,326484,443975,225354,2022,'UBERABA',Uberaba,'MG',3170107,82432.0,82432,6869.3,6869.3,8,5442.0,5442.0,Grande
3060,3067,317020,207406,149886,30989,49413,80402,69484,185971.5,135316.33,26449.58,45578.25,72027.83,63288.5,2231658,1623796,317395,546939,864334,759462,2022,'UBERLANDIA',Uberlândia,'MG',3170206,215039.0,327854,17919.9,27321.2,13,20761.0,34237.0,Grande
3061,3068,317030,1980,1750,64,1277,1341,409,1935.42,1718.08,58.08,1274.83,1332.92,385.17,23225,20617,697,15298,15995,4622,2022,'UMBURATIBA',Umburatiba,'MG',3170305,1340.0,1340,111.7,111.7,1,165.0,165.0,Pequeno I
3062,3069,317040,33593,25978,6735,7429,14164,11814,31598.5,24984.75,6087.25,8373.92,14461.17,10523.58,379182,299817,73047,100487,173534,126283,2022,'UNAI',Unaí,'MG',3170404,7096.0,7096,591.3,591.3,3,479.0,479.0,Médio
3063,3070,317043,2214,1827,86,1442,1528,299,2152.25,1784.33,100.75,1357.5,1458.25,326.08,25827,21412,1209,16290,17499,3913,2022,'UNIAO DE MINAS',União de Minas,'MG',3170438,1358.0,1358,113.2,113.2,1,113.0,113.0,Pequeno I
3064,3071,317047,2968,2302,139,1551,1690,612,2940.5,2314.42,160.75,1564.67,1725.42,589.0,35286,27773,1929,18776,20705,7068,2022,'URUANA DE MINAS',Uruana de Minas,'MG',3170479,2247.0,2247,187.2,187.2,1,230.0,230.0,Pequeno I
3065,3072,317050,4322,3327,583,958,1541,1786,4113.25,3247.17,542.33,1056.42,1598.75,1648.42,49359,38966,6508,12677,19185,19781,2022,'URUCANIA',Urucânia,'MG',3170503,2459.0,2459,204.9,204.9,1,100.0,100.0,Pequeno I
3066,3073,317052,7194,6224,606,4059,4665,1559,7044.83,6163.83,577.92,4167.67,4745.58,1418.25,84538,73966,6935,50012,56947,17019,2022,'URUCUIA',Urucuia,'MG',3170529,3368.0,3368,280.7,280.7,1,100.0,100.0,Pequeno I
3067,3074,317057,5154,4279,98,3295,3393,886,4937.92,4102.25,109.0,3040.75,3149.75,952.5,59255,49227,1308,36489,37797,11430,2022,'VARGEM ALEGRE',Vargem Alegre,'MG',3170578,4495.0,4495,374.6,374.6,1,200.0,200.0,Pequeno I
3068,3075,317060,1507,1010,177,350,527,483,1485.5,1029.5,156.08,361.5,517.58,511.92,17826,12354,1873,4338,6211,6143,2022,'VARGEM BONITA',Vargem Bonita,'MG',3170602,1207.0,1207,100.6,100.6,1,108.0,108.0,Pequeno I
3069,3076,317065,3552,3073,263,1777,2040,1033,3494.83,3056.0,259.08,1795.92,2055.0,1001.0,41938,36672,3109,21551,24660,12012,2022,'VARGEM GRANDE DO RIO PARDO,Vargem Grande do Rio Pardo,'MG',3170651,356.0,356,29.7,29.7,1,22.0,22.0,Pequeno I
3070,3077,317070,26172,22241,3903,9526,13429,8812,23891.58,20119.75,3519.42,8082.58,11602.0,8517.75,286699,241437,42233,96991,139224,102213,2022,'VARGINHA',Varginha,'MG',3170701,12412.0,12412,1034.3,1034.3,5,887.0,887.0,Grande
3071,3078,317075,3110,2627,351,1487,1838,789,2872.83,2412.08,311.92,1301.25,1613.17,798.92,34474,28945,3743,15615,19358,9587,2022,'VARJAO DE MINAS',Varjão de Minas,'MG',3170750,2987.0,2987,248.9,248.9,1,151.0,151.0,Pequeno I
3072,3079,317080,17676,14477,2793,6910,9703,4774,16666.42,13822.92,2828.83,6401.83,9230.67,4592.25,199997,165875,33946,76822,110768,55107,2022,'VARZEA DA PALMA',Várzea da Palma,'MG',3170800,3857.0,3857,321.4,321.4,2,140.0,140.0,Pequeno II
3073,3080,317090,14628,13447,917,9797,10714,2733,14440.0,13400.33,785.58,10051.08,10836.67,2563.67,173280,160804,9427,120613,130040,30764,2022,'VARZELANDIA',Varzelândia,'MG',3170909,6645.0,9545,553.8,795.4,1,578.0,578.0,Pequeno I
3074,3081,317100,7124,5471,1134,2246,3380,2091,6833.75,5260.67,1067.08,2179.58,3246.67,2014.0,82005,63128,12805,26155,38960,24168,2022,'VAZANTE',Vazante,'MG',3171006,3524.0,3524,293.7,293.7,1,328.0,328.0,Pequeno I
3075,3082,317103,6405,5762,414,4481,4895,867,6197.83,5636.33,359.67,4392.92,4752.58,883.75,74374,67636,4316,52715,57031,10605,2022,'VERDELANDIA',Verdelândia,'MG',3171030,3336.0,3336,278.0,278.0,1,214.0,214.0,Pequeno I
3076,3083,317107,4237,3391,160,1965,2125,1266,4140.67,3364.0,184.58,1939.08,2123.67,1240.33,49688,40368,2215,23269,25484,14884,2022,'VEREDINHA',Veredinha,'MG',3171071,2452.0,2452,204.3,204.3,1,175.0,175.0,Pequeno I
3077,3084,317110,1813,1254,235,457,692,562,1740.17,1207.42,247.17,444.0,691.17,516.25,20882,14489,2966,5328,8294,6195,2022,'VERISSIMO',Veríssimo,'MG',3171105,7510.0,8522,625.8,710.2,1,924.0,924.0,Pequeno I
3078,3085,317115,3515,3076,410,1775,2185,891,3400.92,3003.83,361.58,1835.0,2196.58,807.25,40811,36046,4339,22020,26359,9687,2022,'VERMELHO NOVO',Vermelho Novo,'MG',3171154,5289.0,5289,440.8,440.8,1,170.0,170.0,Pequeno I
3079,3086,317120,56764,49845,4276,30986,35262,14583,52293.5,46497.17,3848.75,29595.5,33444.25,13052.92,627522,557966,46185,355146,401331,156635,2022,'VESPASIANO',Vespasiano,'MG',3171204,25290.0,25290,2107.5,2107.5,3,993.0,993.0,Grande
3080,3087,317130,30902,23762,3621,9253,12874,10888,29545.92,22957.33,3440.83,8966.67,12407.5,10549.83,354551,275488,41290,107600,148890,126598,2022,'VICOSA',Viçosa,'MG',3171303,3414.0,3414,284.5,284.5,2,371.0,371.0,Médio
3081,3088,317140,2564,2123,171,1445,1616,507,2458.75,2080.33,152.0,1459.08,1611.08,469.25,29505,24964,1824,17509,19333,5631,2022,'VIEIRAS',Vieiras,'MG',3171402,1799.0,1799,149.9,149.9,1,106.0,106.0,Pequeno I
3082,3089,317150,2658,2263,106,1862,1968,295,2532.33,2203.58,114.83,1774.58,1889.42,314.17,30388,26443,1378,21295,22673,3770,2022,'MATHIAS LOBATO',Mathias Lobato,'MG',3171501,3505.0,3505,292.1,292.1,1,430.0,430.0,Pequeno I
3083,3090,317160,9337,6977,687,3673,4360,2617,9108.42,6955.5,627.83,3830.83,4458.67,2496.83,109301,83466,7534,45970,53504,29962,2022,'VIRGEM DA LAPA',Virgem da Lapa,'MG',3171600,5869.0,9426,489.1,785.5,1,435.0,435.0,Pequeno I
3084,3091,317170,5755,4746,277,2884,3161,1585,5381.08,4448.92,314.33,2636.17,2950.5,1498.42,64573,53387,3772,31634,35406,17981,2022,'VIRGINIA',Virgínia,'MG',3171709,5025.0,5025,418.8,418.8,1,378.0,378.0,Pequeno I
3085,3092,317180,6499,5014,1040,1031,2071,2943,6408.0,5085.75,1066.5,1257.0,2323.5,2762.25,76896,61029,12798,15084,27882,33147,2022,'VIRGINOPOLIS',Virginópolis,'MG',3171808,2812.0,2812,234.3,234.3,1,115.0,115.0,Pequeno I
3086,3093,317190,3331,2740,560,1185,1745,995,3310.5,2779.67,492.92,1368.0,1860.92,918.75,39726,33356,5915,16416,22331,11025,2022,'VIRGOLANDIA',Virgolândia,'MG',3171907,2756.0,2756,229.7,229.7,1,133.0,133.0,Pequeno I
3087,3094,317200,19585,15599,3556,3412,6968,8631,18365.17,14813.42,3161.33,3700.42,6861.75,7951.67,220382,177761,37936,44405,82341,95420,2022,'VISCONDE DO RIO BRANCO',Visconde do Rio Branco,'MG',3172004,2604.0,2604,217.0,217.0,1,136.0,136.0,Pequeno II
3088,3095,317210,3204,2751,153,1939,2092,659,3131.33,2713.58,144.75,1953.0,2097.75,615.83,37576,32563,1737,23436,25173,7390,2022,'VOLTA GRANDE',Volta Grande,'MG',3172103,4535.0,4535,377.9,377.9,1,320.0,320.0,Pequeno I
3089,3096,317220,1026,937,192,498,690,247,974.75,889.83,169.75,478.83,648.58,241.25,11697,10678,2037,5746,7783,2895,2022,'WENCESLAU BRAZ',Wenceslau Braz,'MG',3172202,424.0,424,84.8,84.8,1,52.0,52.0,Pequeno I
3090,3097,320010,16106,13140,2270,6105,8375,4765,15117.5,12609.58,1730.83,6799.83,8530.67,4078.92,181410,151315,20770,81598,102368,48947,2022,'AFONSO CLAUDIO',Afonso Cláudio,'ES',3200102,11374.0,11374,947.8,947.8,1,910.0,910.0,Pequeno II
3091,3098,320013,6452,5005,908,2289,3197,1808,6219.17,4909.33,808.83,2359.08,3167.92,1741.42,74630,58912,9706,28309,38015,20897,2022,'AGUIA BRANCA',Águia Branca,'ES',3200136,4659.0,5872,388.2,489.3,1,929.0,929.0,Pequeno I
3092,3099,320016,8372,7055,595,4614,5209,1846,8061.08,6919.42,558.5,4714.67,5273.17,1646.25,96733,83033,6702,56576,63278,19755,2022,'AGUA DOCE DO NORTE',Água Doce do Norte,'ES',3200169,3393.0,3393,282.8,282.8,1,450.0,450.0,Pequeno I
3093,3100,320020,13938,11519,1902,5875,7777,3742,12767.5,10648.08,1820.25,5158.33,6978.58,3669.5,153210,127777,21843,61900,83743,44034,2022,'ALEGRE',Alegre,'ES',3200201,9671.0,9671,805.9,805.9,1,889.0,889.0,Pequeno II
3094,3101,320030,5508,3971,624,1608,2232,1739,5359.83,3989.08,652.08,1523.33,2175.42,1813.67,64318,47869,7825,18280,26105,21764,2022,'ALFREDO CHAVES',Alfredo Chaves,'ES',3200300,4186.0,4186,348.8,348.8,1,276.0,276.0,Pequeno I
3095,3102,320035,5810,5140,1010,2869,3879,1261,5637.67,5009.92,1019.42,2735.42,3754.83,1255.08,67652,60119,12233,32825,45058,15061,2022,'ALTO RIO NOVO',Alto Rio Novo,'ES',3200359,4376.0,4376,364.7,364.7,1,432.0,432.0,Pequeno I
3096,3103,320040,14359,12593,1856,6537,8393,4200,13651.42,12165.75,1713.67,6510.83,8224.5,3941.25,163817,145989,20564,78130,98694,47295,2022,'ANCHIETA',Anchieta,'ES',3200409,7246.0,7246,603.8,603.8,2,746.0,746.0,Pequeno II
3097,3104,320050,4795,4328,600,2649,3249,1079,4598.5,4185.17,581.08,2523.83,3104.92,1080.25,55182,50222,6973,30286,37259,12963,2022,'APIACA',Apiacá,'ES',3200508,3336.0,3336,278.0,278.0,1,117.0,117.0,Pequeno I
3098,3105,320060,45766,36529,6751,15059,21810,14719,42809.0,34805.67,5974.25,14897.08,20871.33,13934.33,513708,417668,71691,178765,250456,167212,2022,'ARACRUZ',Aracruz,'ES',3200607,26961.0,26961,2246.8,2246.8,9,2538.0,2538.0,Médio
3099,3106,320070,5806,4703,678,2304,2982,1721,5440.58,4430.75,726.58,2051.67,2778.25,1652.5,65287,53169,8719,24620,33339,19830,2022,'ATILIO VIVACQUA',Atilio Vivacqua,'ES',3200706,1470.0,1470,122.5,122.5,1,142.0,142.0,Pequeno I
3100,3107,320080,16502,12489,2314,4872,7186,5303,15901.75,12272.0,2293.0,4825.5,7118.5,5153.5,190821,147264,27516,57906,85422,61842,2022,'BAIXO GUANDU',Baixo Guandu,'ES',3200805,1888.0,1888,157.3,157.3,1,123.0,123.0,Pequeno II
3101,3108,320090,25920,19183,4438,6084,10522,8661,25025.33,18722.17,4184.58,6505.5,10690.08,8032.08,300304,224666,50215,78066,128281,96385,2022,'BARRA DE SAO FRANCISCO',Barra de São Francisco,'ES',3200904,7727.0,7727,643.9,643.9,1,720.0,720.0,Pequeno II
3102,3109,320100,9938,8617,1256,4976,6232,2385,9511.75,8306.83,1218.83,4728.33,5947.17,2359.67,114141,99682,14626,56740,71366,28316,2022,'BOA ESPERANCA',Boa Esperança,'ES',3201001,6683.0,6683,556.9,556.9,1,354.0,354.0,Pequeno I
3103,3110,320110,6121,4941,681,2796,3477,1464,5744.08,4656.42,601.25,2624.08,3225.33,1431.08,68929,55877,7215,31489,38704,17173,2022,'BOM JESUS DO NORTE',Bom Jesus do Norte,'ES',3201100,6678.0,6678,556.5,556.5,1,505.0,505.0,Pequeno I
3104,3111,320115,7779,7109,2345,2907,5252,1857,7410.58,6850.58,2244.75,2992.5,5237.25,1613.33,88927,82207,26937,35910,62847,19360,2022,'BREJETUBA',Brejetuba,'ES',3201159,5304.0,5304,442.0,442.0,1,332.0,332.0,Pequeno I
3105,3112,320120,76973,61093,8913,28606,37519,23574,72586.58,58239.08,8257.67,27591.08,35848.75,22390.33,871039,698869,99092,331093,430185,268684,2022,'CACHOEIRO DE ITAPEMIRIM',Cachoeiro de Itapemirim,'ES',3201209,33006.0,33006,2750.5,2750.5,7,2498.0,2498.0,Grande
3106,3113,320130,175979,153581,20722,89259,109981,43600,162615.58,143443.42,18428.08,84544.58,102972.67,40470.75,1951387,1721321,221137,1014535,1235672,485649,2022,'CARIACICA',Cariacica,'ES',3201308,44861.0,44861,3738.4,3738.4,8,4519.0,4519.0,Grande
3107,3114,320140,12669,10017,1688,4537,6225,3792,11850.92,9330.58,1432.17,4254.25,5686.42,3644.17,142211,111967,17186,51051,68237,43730,2022,'CASTELO',Castelo,'ES',3201407,1387.0,1387,115.6,115.6,1,107.0,107.0,Pequeno II
3108,3115,320150,43950,34601,9167,4782,13949,20652,41699.08,33304.92,8754.67,4998.33,13753.0,19551.92,500389,399659,105056,59980,165036,234623,2022,'COLATINA',Colatina,'ES',3201506,7851.0,7851,654.2,654.2,6,584.0,584.0,Grande
3109,3116,320160,20257,16514,2365,7945,10310,6204,19410.42,16000.83,2245.83,7643.25,9889.08,6111.75,232925,192010,26950,91719,118669,73341,2022,'CONCEICAO DA BARRA',Conceição da Barra,'ES',3201605,7112.0,7112,592.7,592.7,4,1203.0,1203.0,Pequeno II
3110,3117,320170,5886,4613,1227,1580,2807,1806,5659.0,4506.25,1160.92,1738.75,2899.67,1606.58,67908,54075,13931,20865,34796,19279,2022,'CONCEICAO DO CASTELO',Conceição do Castelo,'ES',3201704,3230.0,3230,269.2,269.2,1,190.0,190.0,Pequeno I
3111,3118,320180,2683,2251,764,442,1206,1045,2550.08,2198.08,792.75,534.33,1327.08,871.0,30601,26377,9513,6412,15925,10452,2022,'DIVINO DE SAO LOURENCO',Divino de São Lourenço,'ES',3201803,1008.0,1008,91.6,91.6,1,104.0,104.0,Pequeno I
3112,3119,320190,11258,9014,2148,1613,3761,5253,10533.83,8732.42,2236.58,1810.92,4047.5,4684.92,126406,104789,26839,21731,48570,56219,2022,'DOMINGOS MARTINS',Domingos Martins,'ES',3201902,16629.0,16629,1385.8,1385.8,2,1383.0,1383.0,Pequeno II
3113,3120,320200,4172,3184,699,842,1541,1643,3996.33,3139.67,707.5,933.33,1640.83,1498.83,47956,37676,8490,11200,19690,17986,2022,'DORES DO RIO PRETO',Dores do Rio Preto,'ES',3202009,7638.0,7638,636.5,636.5,1,510.0,510.0,Pequeno I
3114,3121,320210,13449,11232,1905,5715,7620,3612,12846.5,10800.5,1801.67,5557.58,7359.25,3441.25,154158,129606,21620,66691,88311,41295,2022,'ECOPORANGA',Ecoporanga,'ES',3202108,11437.0,18122,1039.7,1647.5,1,1070.0,1070.0,Pequeno II
3115,3122,320220,10498,8657,1870,3541,5411,3246,9840.5,8317.83,1566.83,3812.33,5379.17,2938.67,118086,99814,18802,45748,64550,35264,2022,'FUNDAO',Fundão,'ES',3202207,1898.0,1898,158.2,158.2,1,411.0,411.0,Pequeno I
3116,3123,320225,5362,3997,1253,849,2102,1895,5002.5,3819.58,1244.58,902.08,2146.67,1672.92,60030,45835,14935,10825,25760,20075,2022,'GOVERNADOR LINDENBERG',Governador Lindenberg,'ES',3202256,6668.0,6668,555.7,555.7,1,894.0,894.0,Pequeno I
3117,3124,320230,17090,14232,3541,4108,7649,6583,16253.17,13704.17,3204.25,4549.08,7753.33,5950.83,195038,164450,38451,54589,93040,71410,2022,'GUACUI',Guaçuí,'ES',3202306,16702.0,16702,1391.8,1391.8,1,1470.0,1470.0,Pequeno II
3118,3125,320240,52312,43561,11992,12546,24538,19023,49053.08,41187.33,10919.58,12674.25,23593.83,17593.5,588637,494248,131035,152091,283126,211122,2022,'GUARAPARI',Guarapari,'ES',3202405,9269.0,9269,772.4,772.4,3,723.0,723.0,Grande
3119,3126,320245,11181,8628,2543,1064,3607,5021,10555.58,8452.83,2671.75,1355.08,4026.83,4426.0,126667,101434,32061,16261,48322,53112,2022,'IBATIBA',Ibatiba,'ES',3202454,7504.0,7504,625.3,625.3,1,500.0,500.0,Pequeno II
3120,3127,320250,8499,6119,1067,2536,3603,2516,8176.17,5928.83,1139.08,2283.25,3422.33,2506.5,98114,71146,13669,27399,41068,30078,2022,'IBIRACU',Ibiraçu,'ES',3202504,1566.0,1566,130.5,130.5,1,75.0,75.0,Pequeno I
3121,3128,320255,7211,6571,1151,4241,5392,1179,6820.83,6271.25,1268.83,3760.42,5029.25,1242.0,81850,75255,15226,45125,60351,14904,2022,'IBITIRAMA',Ibitirama,'ES',3202553,3462.0,3462,288.5,288.5,1,275.0,275.0,Pequeno I
3122,3129,320260,4694,3350,849,721,1570,1780,4536.75,3270.42,767.67,710.58,1478.25,1792.17,54441,39245,9212,8527,17739,21506,2022,'ICONHA',Iconha,'ES',3202603,1124.0,1124,93.7,93.7,1,56.0,56.0,Pequeno I
3123,3130,320265,8185,6683,2763,757,3520,3163,8032.67,6815.33,2969.83,1001.0,3970.83,2844.5,96392,81784,35638,12012,47650,34134,2022,'IRUPI',Irupi,'ES',3202652,3770.0,3770,314.2,314.2,1,277.0,277.0,Pequeno I
3124,3131,320270,7208,5869,1685,1722,3407,2462,7012.25,5850.42,1597.67,1961.08,3558.75,2291.67,84147,70205,19172,23533,42705,27500,2022,'ITAGUACU',Itaguaçu,'ES',3202702,5206.0,5206,433.8,433.8,1,408.0,408.0,Pequeno I
3125,3132,320280,25038,21958,3019,13650,16669,5289,23227.0,20451.75,3282.33,11986.75,15269.08,5182.67,278724,245421,39388,143841,183229,62192,2022,'ITAPEMIRIM',Itapemirim,'ES',3202801,5340.0,26485,667.5,3310.6,2,1022.0,1022.0,Pequeno II
3126,3133,320290,4557,3223,948,794,1742,1481,4419.42,3175.42,875.75,797.75,1673.5,1501.92,53033,38105,10509,9573,20082,18023,2022,'ITARANA',Itarana,'ES',3202900,2414.0,2414,201.2,201.2,1,252.0,252.0,Pequeno I
3127,3134,320300,14878,12752,3756,4083,7839,4913,13911.33,12049.42,3471.33,4069.58,7540.92,4508.5,166936,144593,41656,48835,90491,54102,2022,'IUNA',Iúna,'ES',3203007,8501.0,8501,708.4,708.4,1,1238.0,1238.0,Pequeno II
3128,3135,320305,17110,14009,2842,6162,9004,5005,16317.0,13590.0,2707.67,6213.92,8921.58,4668.42,195804,163080,32492,74567,107059,56021,2022,'JAGUARE',Jaguaré,'ES',3203056,7836.0,7836,653.0,653.0,1,1039.0,1039.0,Pequeno II
3129,3136,320310,6472,4960,981,1940,2921,2039,6577.33,5072.0,968.33,2069.25,3037.58,2034.42,78928,60864,11620,24831,36451,24413,2022,'JERONIMO MONTEIRO',Jerônimo Monteiro,'ES',3203106,3084.0,3084,257.0,257.0,1,334.0,334.0,Pequeno I
3130,3137,320313,7140,5323,1141,1675,2816,2507,6853.33,5218.83,1092.17,1578.5,2670.67,2548.17,82240,62626,13106,18942,32048,30578,2022,'JOAO NEIVA',João Neiva,'ES',3203130,2339.0,2339,194.9,194.9,1,124.0,124.0,Pequeno I
3131,3138,320316,5023,4250,645,2329,2974,1276,4942.67,4229.0,655.08,2316.5,2971.58,1257.42,59312,50748,7861,27798,35659,15089,2022,'LARANJA DA TERRA',Laranja da Terra,'ES',3203163,3333.0,3333,277.8,277.8,1,245.0,245.0,Pequeno I
3132,3139,320320,67721,55120,14032,18522,32554,22566,65432.83,53442.0,12618.0,19671.08,32289.08,21152.92,785194,641304,151416,236053,387469,253835,2022,'LINHARES',Linhares,'ES',3203205,20886.0,20886,1740.5,1740.5,7,2507.0,2507.0,Grande
3133,3140,320330,8968,7606,1243,4258,5501,2105,8592.92,7326.08,1173.17,4150.67,5323.83,2002.25,103115,87913,14078,49808,63886,24027,2022,'MANTENOPOLIS',Mantenópolis,'ES',3203304,9235.0,9235,769.6,769.6,1,741.0,741.0,Pequeno I
3134,3141,320332,25843,22180,4471,11243,15714,6466,24876.25,21399.75,4377.58,10418.17,14795.75,6604.0,298515,256797,52531,125018,177549,79248,2022,'MARATAIZES',Marataízes,'ES',3203320,3784.0,3784,473.0,473.0,1,,,Pequeno II
3135,3142,320334,6267,4757,1027,897,1924,2833,5877.0,4528.83,1029.17,895.33,1924.5,2604.33,70524,54346,12350,10744,23094,31252,2022,'MARECHAL FLORIANO',Marechal Floriano,'ES',3203346,3982.0,3982,331.8,331.8,1,253.0,253.0,Pequeno I
3136,3143,320335,6090,4407,1031,1192,2223,2184,5458.0,4089.25,912.0,1191.08,2103.08,1986.17,65496,49071,10944,14293,25237,23834,2022,'MARILANDIA',Marilândia,'ES',3203353,2999.0,2999,249.9,249.9,1,228.0,228.0,Pequeno I
3137,3144,320340,15022,13414,1116,9153,10269,3145,14251.0,12784.17,1171.25,8475.75,9647.0,3137.17,171012,153410,14055,101709,115764,37646,2022,'MIMOSO DO SUL',Mimoso do Sul,'ES',3203403,3656.0,3656,304.7,304.7,1,90.0,90.0,Pequeno II
3138,3145,320350,14740,11296,1375,5758,7133,4163,14390.83,11245.0,1298.92,5871.75,7170.67,4074.33,172690,134940,15587,70461,86048,48892,2022,'MONTANHA',Montanha,'ES',3203502,4987.0,9582,498.7,958.2,1,710.0,710.0,Pequeno I
3139,3146,320360,4059,3117,368,1422,1790,1327,3964.58,3166.33,378.75,1476.92,1855.67,1310.67,47575,37996,4545,17723,22268,15728,2022,'MUCURICI',Mucurici,'ES',3203601,7001.0,7001,583.4,583.4,1,624.0,624.0,Pequeno I
3140,3147,320370,9882,8158,2555,2695,5250,2908,9249.25,7677.17,2349.17,2574.17,4923.33,2753.83,110991,92126,28190,30890,59080,33046,2022,'MUNIZ FREIRE',Muniz Freire,'ES',3203700,6594.0,6594,549.5,549.5,2,645.0,645.0,Pequeno I
3141,3148,320380,8547,7514,765,4993,5758,1756,8092.83,7161.25,790.25,4557.17,5347.42,1813.83,97114,85935,9483,54686,64169,21766,2022,'MUQUI',Muqui,'ES',3203809,4250.0,4250,386.4,386.4,1,130.0,130.0,Pequeno I
3142,3149,320390,24215,19060,4048,7178,11226,7834,22985.0,18353.75,3883.75,7200.0,11083.75,7270.0,275820,220245,46605,86400,133005,87240,2022,'NOVA VENECIA',Nova Venécia,'ES',3203908,4480.0,4480,373.3,373.3,1,802.0,802.0,Pequeno II
3143,3150,320400,10736,8504,2535,2877,5412,3092,10315.83,8286.25,2342.42,2924.67,5267.08,3019.17,123790,99435,28109,35096,63205,36230,2022,'PANCAS',Pancas,'ES',3204005,1242.0,1242,103.5,103.5,1,148.0,148.0,Pequeno II
3144,3151,320405,15651,12874,1963,6636,8599,4275,15166.5,12637.92,1804.33,6649.5,8453.83,4184.08,181998,151655,21652,79794,101446,50209,2022,'PEDRO CANARIO',Pedro Canário,'ES',3204054,12019.0,14088,1001.6,1174.0,3,2086.0,2086.0,Pequeno II
3145,3152,320410,14392,12050,2090,5868,7958,4092,13884.58,11748.67,1999.08,5930.75,7929.83,3818.83,166615,140984,23989,71169,95158,45826,2022,'PINHEIROS',Pinheiros,'ES',3204104,5871.0,5871,489.2,489.2,1,190.0,190.0,Pequeno II
3146,3153,320420,11832,9939,2309,3800,6109,3830,10766.58,9155.33,2125.17,3294.17,5419.33,3736.0,129199,109864,25502,39530,65032,44832,2022,'PIUMA',Piúma,'ES',3204203,5132.0,5132,427.7,427.7,1,968.0,968.0,Pequeno I
3147,3154,320425,5812,4786,359,3101,3460,1326,5689.33,4739.67,403.42,2979.75,3383.17,1356.5,68272,56876,4841,35757,40598,16278,2022,'PONTO BELO',Ponto Belo,'ES',3204252,3001.0,3001,250.1,250.1,1,130.0,130.0,Pequeno I
3148,3155,320430,9138,7759,1143,4544,5687,2072,8944.33,7662.25,1085.25,4520.75,5606.0,2056.25,107332,91947,13023,54249,67272,24675,2022,'PRESIDENTE KENNEDY',Presidente Kennedy,'ES',3204302,2046.0,2046,170.5,170.5,1,248.0,248.0,Pequeno I
3149,3156,320435,8521,7262,2516,2471,4987,2275,7954.17,6769.5,2085.08,2593.67,4678.75,2090.75,95450,81234,25021,31124,56145,25089,2022,'RIO BANANAL',Rio Bananal,'ES',3204351,508.0,508,169.3,169.3,1,133.0,133.0,Pequeno I
3150,3157,320440,4791,3905,720,1543,2263,1642,4709.42,3871.08,709.58,1584.83,2294.42,1576.67,56513,46453,8515,19018,27533,18920,2022,'RIO NOVO DO SUL',Rio Novo do Sul,'ES',3204401,4909.0,4909,409.1,409.1,1,292.0,292.0,Pequeno I
3151,3158,320450,6614,5670,1045,2904,3949,1721,6133.33,5290.17,1037.58,2612.58,3650.17,1640.0,73600,63482,12451,31351,43802,19680,2022,'SANTA LEOPOLDINA',Santa Leopoldina,'ES',3204500,5222.0,5222,435.2,435.2,1,210.0,210.0,Pequeno I
3152,3159,320455,15746,11714,3010,2321,5331,6383,15011.25,11338.92,2971.25,2515.0,5486.25,5852.67,180135,136067,35655,30180,65835,70232,2022,'SANTA MARIA DE JETIBA',Santa Maria de Jetibá,'ES',3204559,17364.0,17364,1447.0,1447.0,2,1166.0,1166.0,Pequeno II
3153,3160,320460,7323,5861,1851,1414,3265,2596,6957.92,5622.08,1662.5,1469.33,3131.83,2490.25,83495,67465,19950,17632,37582,29883,2022,'SANTA TERESA',Santa Teresa,'ES',3204609,9358.0,9358,779.8,779.8,1,1075.0,1075.0,Pequeno II
3154,3161,320465,5104,4022,1075,1570,2645,1377,4696.0,3767.0,838.67,1705.42,2544.08,1222.92,56352,45204,10064,20465,30529,14675,2022,'SAO DOMINGOS DO NORTE',São Domingos do Norte,'ES',3204658,2894.0,2894,241.2,241.2,1,72.0,72.0,Pequeno I
3155,3162,320470,13041,10289,2173,3271,5444,4845,12000.08,9657.25,2092.25,3078.33,5170.58,4486.67,144001,115887,25107,36940,62047,53840,2022,'SAO GABRIEL DA PALHA',São Gabriel da Palha,'ES',3204708,2747.0,2747,228.9,228.9,1,288.0,288.0,Pequeno II
3156,3163,320480,6644,5697,644,3773,4417,1280,6182.17,5366.33,650.92,3459.0,4109.92,1256.42,74186,64396,7811,41508,49319,15077,2022,'SAO JOSE DO CALCADO',São José do Calçado,'ES',3204807,5076.0,8692,423.0,724.3,1,769.0,769.0,Pequeno I
3157,3164,320490,76032,61798,11393,27245,38638,23160,70255.33,58252.92,10188.25,26607.0,36795.25,21457.67,843064,699035,122259,319284,441543,257492,2022,'SAO MATEUS',São Mateus,'ES',3204906,84551.0,130273,7045.9,10856.1,5,9244.0,12464.0,Grande
3158,3165,320495,4491,3528,952,476,1428,2100,4267.58,3408.17,926.75,634.92,1561.67,1846.5,51211,40898,11121,7619,18740,22158,2022,'SAO ROQUE DO CANAA',São Roque do Canaã,'ES',3204955,878.0,878,73.2,73.2,1,62.0,62.0,Pequeno I
3159,3166,320500,203344,174753,23215,101245,124460,50293,182014.58,158537.42,20645.92,92845.33,113491.25,45046.17,2184175,1902449,247751,1114144,1361895,540554,2022,'SERRA',Serra,'ES',3205002,45616.0,45616,3801.3,3801.3,9,3337.0,3337.0,Grande
3160,3167,320501,16397,13270,4055,3126,7181,6089,15696.33,13148.08,4048.25,3713.42,7761.67,5386.42,188356,157777,48579,44561,93140,64637,2022,'SOORETAMA',Sooretama,'ES',3205010,3074.0,3074,256.2,256.2,1,189.0,189.0,Pequeno II
3161,3168,320503,8490,6405,1992,1526,3518,2887,7888.92,5967.92,1800.42,1512.0,3312.42,2655.5,94667,71615,21605,18144,39749,31866,2022,'VARGEM ALTA',Vargem Alta,'ES',3205036,3890.0,3890,324.2,324.2,1,190.0,190.0,Pequeno I
3162,3169,320506,9401,7547,2361,1336,3697,3850,9049.83,7383.42,2341.17,1056.25,3397.42,3986.0,108598,88601,28094,12675,40769,47832,2022,'VENDA NOVA DO IMIGRANTE',Venda Nova do Imigrante,'ES',3205069,6602.0,6602,550.2,550.2,1,473.0,473.0,Pequeno II
3163,3170,320510,37056,31805,4538,17116,21654,10151,34646.83,30321.08,3592.5,17808.83,21401.33,8919.75,415762,363853,43110,213706,256816,107037,2022,'VIANA',Viana,'ES',3205101,10190.0,10190,849.2,849.2,4,330.0,330.0,Médio
3164,3171,320515,5794,4553,1397,1336,2733,1820,5526.5,4494.5,1300.5,1429.92,2730.42,1764.08,66318,53934,15606,17159,32765,21169,2022,'VILA PAVAO',Vila Pavão,'ES',3205150,2413.0,2413,201.1,201.1,1,187.0,187.0,Pequeno I
3165,3172,320517,7569,6444,1987,2367,4354,2090,7147.92,6120.83,1863.67,2203.75,4067.42,2053.42,85775,73450,22364,26445,48809,24641,2022,'VILA VALERIO',Vila Valério,'ES',3205176,610.0,610,152.5,152.5,1,,,Pequeno I
3166,3173,320520,139511,117615,19119,55180,74299,43316,123440.25,104415.17,17091.67,47974.17,65065.83,39349.33,1481283,1252982,205100,575690,780790,472192,2022,'VILA VELHA',Vila Velha,'ES',3205200,54685.0,54685,4557.1,4557.1,6,5134.0,5134.0,Grande
3167,3174,320530,107015,91499,8325,56399,64724,26775,101467.25,87422.67,8168.58,53402.25,61570.83,25851.83,1217607,1049072,98023,640827,738850,310222,2022,'VITORIA',Vitória,'ES',3205309,49686.0,49686,4140.5,4140.5,12,3622.0,3622.0,Grande
3168,3175,330010,81052,71719,6325,50955,57280,14439,74175.92,66313.17,6161.67,47132.25,53293.92,13019.25,890111,795758,73940,565587,639527,156231,2022,'ANGRA DOS REIS',Angra Dos Reis,'RJ',3300100,116388.0,138791,9699.0,11565.9,8,6779.0,6779.0,Grande
3169,3176,330015,4720,3935,618,2315,2933,1002,4166.17,3590.67,561.5,2144.75,2706.25,884.42,49994,43088,6738,25737,32475,10613,2022,'APERIBE',Aperibé,'RJ',3300159,9314.0,9314,776.2,776.2,3,710.0,710.0,Pequeno I
3170,3177,330020,64902,58349,6935,40989,47924,10425,57225.67,51832.17,6059.92,37078.5,43138.42,8693.75,686708,621986,72719,444942,517661,104325,2022,'ARARUAMA',Araruama,'RJ',3300209,20417.0,20417,1701.4,1701.4,5,1352.0,1352.0,Grande
3171,3178,330022,6314,5340,1089,2232,3321,2019,5943.42,5112.58,914.92,2407.92,3322.83,1789.75,71321,61351,10979,28895,39874,21477,2022,'AREAL',Areal,'RJ',3300225,2175.0,2175,181.2,181.2,2,329.0,329.0,Pequeno I
3172,3179,330023,20024,17154,2593,10379,12972,4182,17540.17,15055.0,2216.42,9344.0,11560.42,3494.58,210482,180660,26597,112128,138725,41935,2022,'ARMACAO DOS BUZIOS',Armação Dos Búzios,'RJ',3300233,6371.0,6371,530.9,530.9,2,495.0,495.0,Pequeno II
3173,3180,330025,20564,15583,2800,6604,9404,6179,18925.58,14231.08,2835.33,5236.75,8072.08,6159.0,227107,170773,34024,62841,96865,73908,2022,'ARRAIAL DO CABO',Arraial do Cabo,'RJ',3300258,13269.0,13269,1105.8,1105.8,3,751.0,751.0,Pequeno II
3174,3181,330030,34831,29750,2757,19255,22012,7738,32080.33,27641.17,2487.92,17961.92,20449.83,7191.33,384964,331694,29855,215543,245398,86296,2022,'BARRA DO PIRAI',Barra do Piraí,'RJ',3300308,26224.0,28908,2185.3,2409.0,4,1535.0,1535.0,Médio
3175,3182,330040,55388,48837,2793,35381,38174,10663,49192.33,43564.58,2793.0,31028.17,33821.17,9743.42,590308,522775,33516,372338,405854,116921,2022,'BARRA MANSA',Barra Mansa,'RJ',3300407,101191.0,136627,8432.6,11385.6,6,5715.0,5715.0,Grande
3176,3183,330045,278585,252219,12164,210700,222864,29355,251397.08,228779.0,11684.17,191118.5,202802.67,25976.33,3016765,2745348,140210,2293422,2433632,311716,2022,'BELFORD ROXO',Belford Roxo,'RJ',3300456,114581.0,148194,9548.4,12349.5,13,7564.0,7564.0,Grande
3177,3184,330050,10375,8965,1715,4943,6658,2307,9009.75,7791.42,1439.92,4193.67,5633.58,2157.83,108117,93497,17279,50324,67603,25894,2022,'BOM JARDIM',Bom Jardim,'RJ',3300506,5147.0,5147,428.9,428.9,2,501.0,501.0,Pequeno II
3178,3185,330060,17722,14701,3051,5575,8626,6075,16544.25,13997.08,2894.42,5660.0,8554.42,5442.67,198531,167965,34733,67920,102653,65312,2022,'BOM JESUS DO ITABAPOANA',Bom Jesus do Itabapoana,'RJ',3300605,7802.0,7802,650.2,650.2,3,594.0,594.0,Pequeno II
3179,3186,330070,90101,80842,10463,53411,63874,16968,77651.0,69861.0,8947.33,46295.92,55243.25,14617.75,931812,838332,107368,555551,662919,175413,2022,'CABO FRIO',Cabo Frio,'RJ',3300704,50364.0,50364,4197.0,4197.0,8,3007.0,3007.0,Grande
3180,3187,330080,29757,26775,3352,18150,21502,5273,27271.08,24758.42,2942.5,17055.33,19997.83,4760.58,327253,297101,35310,204664,239974,57127,2022,'CACHOEIRAS DE MACACU',Cachoeiras de Macacu,'RJ',3300803,17360.0,17360,1446.7,1446.7,3,1061.0,1061.0,Médio
3181,3188,330090,8424,6832,512,4741,5253,1579,7968.83,6495.83,418.33,4675.33,5093.67,1402.17,95626,77950,5020,56104,61124,16826,2022,'CAMBUCI',Cambuci,'RJ',3300902,2000.0,2000,166.7,166.7,2,207.0,207.0,Pequeno I
3182,3189,330093,8343,7075,493,5510,6003,1072,7580.67,6534.33,381.67,5122.08,5503.75,1030.58,90968,78412,4580,61465,66045,12367,2022,'CARAPEBUS',Carapebus,'RJ',3300936,8284.0,9501,690.3,791.8,2,680.0,1897.0,Pequeno I
3183,3190,330095,4723,3974,456,2210,2666,1308,4473.75,3795.17,433.25,2105.42,2538.67,1256.5,53685,45542,5199,25265,30464,15078,2022,'COMENDADOR LEVY GASPARIAN',Comendador Levy Gasparian,'RJ',3300951,5860.0,5860,488.3,488.3,2,400.0,400.0,Pequeno I
3184,3191,330100,230749,212327,11640,166814,178454,33873,214679.58,198133.75,10427.83,156293.25,166721.08,31412.67,2576155,2377605,125134,1875519,2000653,376952,2022,'CAMPOS DOS GOYTACAZES',Campos Dos Goytacazes,'RJ',3301009,112748.0,112748,9395.7,9395.7,13,6961.0,6961.0,Grande
3185,3192,330110,7592,6690,810,4260,5070,1620,6908.75,6103.0,793.58,3781.67,4575.25,1527.75,82905,73236,9523,45380,54903,18333,2022,'CANTAGALO',Cantagalo,'RJ',3301108,6456.0,6456,538.0,538.0,3,163.0,163.0,Pequeno I
3186,3193,330115,7965,6371,1150,3337,4487,1884,7528.08,6079.33,1082.42,3166.33,4248.75,1830.58,90337,72952,12989,37996,50985,21967,2022,'CARDOSO MOREIRA',Cardoso Moreira,'RJ',3301157,10529.0,10529,877.4,877.4,2,634.0,634.0,Pequeno I
3187,3194,330120,9149,7822,457,5939,6396,1426,8727.58,7513.58,448.58,5701.42,6150.0,1363.58,104731,90163,5383,68417,73800,16363,2022,'CARMO',Carmo,'RJ',3301207,5663.0,5663,471.9,471.9,2,403.0,403.0,Pequeno I
3188,3195,330130,17222,15375,2131,9525,11656,3719,14783.42,13281.83,1731.83,8556.83,10288.67,2993.17,177401,159382,20782,102682,123464,35918,2022,'CASIMIRO DE ABREU',Casimiro de Abreu,'RJ',3301306,14434.0,14434,1312.2,1312.2,3,1107.0,1107.0,Pequeno II
3189,3196,330140,11953,10667,596,8583,9179,1488,11165.58,10016.92,738.92,7707.33,8446.25,1570.67,133987,120203,8867,92488,101355,18848,2022,'CONCEICAO DE MACABU',Conceição de Macabu,'RJ',3301405,4774.0,4774,397.8,397.8,3,737.0,737.0,Pequeno II
3190,3197,330150,7968,6849,1265,3634,4899,1950,7404.75,6442.75,1111.33,3566.75,4678.08,1764.67,88857,77313,13336,42801,56137,21176,2022,'CORDEIRO',Cordeiro,'RJ',3301504,11713.0,11713,976.1,976.1,3,806.0,806.0,Pequeno II
3191,3198,330160,5034,4258,861,2212,3073,1185,4540.58,3855.0,807.92,1967.33,2775.25,1079.75,54487,46260,9695,23608,33303,12957,2022,'DUAS BARRAS',Duas Barras,'RJ',3301603,1140.0,1140,142.5,142.5,1,,,Pequeno I
3192,3199,330170,431047,389968,44932,285007,329939,60029,371242.92,335836.5,37827.67,246099.58,283927.25,51909.25,4454915,4030038,453932,2953195,3407127,622911,2022,'DUQUE DE CAXIAS',Duque de Caxias,'RJ',3301702,115725.0,152480,9643.8,12706.7,11,7173.0,7173.0,Grande
3193,3200,330180,5995,5268,298,4039,4337,931,5500.17,4826.83,298.92,3588.58,3887.5,939.33,66002,57922,3587,43063,46650,11272,2022,'ENGENHEIRO PAULO DE FRONTI,Engenheiro Paulo de Frontin,'RJ',3301801,3942.0,3942,328.5,328.5,2,240.0,240.0,Pequeno I
3194,3201,330185,33512,30403,1388,25388,26776,3627,30331.33,27565.08,1318.75,22890.83,24209.58,3355.5,363976,330781,15825,274690,290515,40266,2022,'GUAPIMIRIM',Guapimirim,'RJ',3301850,30285.0,30285,2523.8,2523.8,3,1372.0,1372.0,Médio
3195,3202,330187,16794,14219,2029,8678,10707,3512,14843.75,12722.25,1718.08,7870.67,9588.75,3133.5,178125,152667,20617,94448,115065,37602,2022,'IGUABA GRANDE',Iguaba Grande,'RJ',3301876,8661.0,8661,721.8,721.8,2,783.0,783.0,Pequeno II
3196,3203,330190,128283,116899,6077,94567,100644,16255,113939.67,104322.25,5410.0,85186.67,90596.67,13725.58,1367276,1251867,64920,1022240,1087160,164707,2022,'ITABORAI',Itaboraí,'RJ',3301900,86781.0,86781,7231.8,7231.8,7,3972.0,3972.0,Grande
3197,3204,330200,57084,51428,6589,36404,42993,8435,50411.5,45741.25,6064.42,32626.5,38690.92,7050.33,604938,548895,72773,391518,464291,84604,2022,'ITAGUAI',Itaguaí,'RJ',3302007,54729.0,54729,4560.8,4560.8,7,4197.0,4197.0,Grande
3198,3205,330205,6608,5466,428,3468,3896,1570,6251.0,5235.25,412.92,3379.67,3792.58,1442.67,75012,62823,4955,40556,45511,17312,2022,'ITALVA',Italva,'RJ',3302056,5360.0,5360,446.7,446.7,2,263.0,263.0,Pequeno I
3199,3206,330210,9548,7786,1083,4103,5186,2600,9181.25,7567.83,970.83,4022.92,4993.75,2574.08,110175,90814,11650,48275,59925,30889,2022,'ITAOCARA',Itaocara,'RJ',3302106,12979.0,12979,1081.6,1081.6,3,911.0,911.0,Pequeno II
3200,3207,330220,43041,35205,6084,16342,22426,12779,38750.42,31840.58,5589.08,14175.5,19764.58,12076.0,465005,382087,67069,170106,237175,144912,2022,'ITAPERUNA',Itaperuna,'RJ',3302205,24786.0,24786,2065.5,2065.5,6,1445.0,1445.0,Médio
3201,3208,330225,13243,11322,952,7485,8437,2885,11775.42,10145.17,739.08,7120.83,7859.92,2285.25,141305,121742,8869,85450,94319,27423,2022,'ITATIAIA',Itatiaia,'RJ',3302254,8545.0,8545,712.1,712.1,3,488.0,488.0,Pequeno II
3202,3209,330227,57229,52964,1525,46558,48083,4881,50337.08,46480.75,1517.92,40601.17,42119.08,4361.67,604045,557769,18215,487214,505429,52340,2022,'JAPERI',Japeri,'RJ',3302270,16164.0,16164,1347.0,1347.0,6,877.0,877.0,Médio
3203,3210,330230,5198,4085,394,1916,2310,1775,5043.75,4022.42,392.58,1999.42,2392.0,1630.42,60525,48269,4711,23993,28704,19565,2022,'LAJE DO MURIAE',Laje do Muriaé,'RJ',3302304,12603.0,16367,1050.2,1363.9,2,655.0,1835.0,Pequeno I
3204,3211,330240,85674,76939,7490,54478,61968,14971,75148.83,67999.17,6097.58,49189.25,55286.83,12712.33,901786,815990,73171,590271,663442,152548,2022,'MACAE',Macaé,'RJ',3302403,41850.0,41850,3487.5,3487.5,8,4708.0,4708.0,Grande
3205,3212,330245,4983,3551,753,1371,2124,1427,4823.75,3520.25,719.0,1379.42,2098.42,1421.83,57885,42243,8628,16553,25181,17062,2022,'MACUCO',Macuco,'RJ',3302452,6917.0,8265,576.4,688.8,2,209.0,1557.0,Pequeno I
3206,3213,330250,136930,123616,14551,87666,102217,21399,122461.92,110713.92,13740.92,76801.17,90542.08,20171.83,1469543,1328567,164891,921614,1086505,242062,2022,'MAGE',Magé,'RJ',3302502,66114.0,66114,5509.5,5509.5,9,4917.0,4917.0,Grande
3207,3214,330260,17964,15771,1019,12197,13216,2555,14465.08,12572.5,843.0,9648.0,10491.0,2081.5,173581,150870,10116,115776,125892,24978,2022,'MANGARATIBA',Mangaratiba,'RJ',3302601,16270.0,16270,1355.8,1355.8,6,576.0,576.0,Pequeno II
3208,3215,330270,99146,72463,10162,35378,45540,26923,89705.17,65886.67,9608.42,29988.92,39597.33,26289.33,1076462,790640,115301,359867,475168,315472,2022,'MARICA',Maricá,'RJ',3302700,31153.0,31153,2596.1,2596.1,9,2044.0,2044.0,Grande
3209,3216,330280,8283,7034,542,4586,5128,1906,7515.33,6415.92,542.08,4144.5,4686.58,1729.33,90184,76991,6505,49734,56239,20752,2022,'MENDES',Mendes,'RJ',3302809,6468.0,6468,539.0,539.0,3,555.0,555.0,Pequeno I
3210,3217,330285,84847,74890,3707,60173,63880,11010,75148.08,66304.08,3679.75,52142.42,55822.17,10481.92,901777,795649,44157,625709,669866,125783,2022,'MESQUITA',Mesquita,'RJ',3302858,58236.0,58236,4853.0,4853.0,6,3084.0,3084.0,Grande
3211,3218,330290,12895,11344,884,8733,9617,1727,11787.5,10491.17,860.17,7948.67,8808.83,1682.33,141450,125894,10322,95384,105706,20188,2022,'MIGUEL PEREIRA',Miguel Pereira,'RJ',3302908,8030.0,8030,669.2,669.2,2,751.0,751.0,Pequeno II
3212,3219,330300,16498,13588,1069,9722,10791,2797,15455.42,12935.67,1019.08,9182.17,10201.25,2734.42,185465,155228,12229,110186,122415,32813,2022,'MIRACEMA',Miracema,'RJ',3303005,10346.0,10346,862.2,862.2,2,510.0,510.0,Pequeno II
3213,3220,330310,7837,6436,367,4625,4992,1444,7477.5,6168.33,375.08,4361.67,4736.75,1431.58,89730,74020,4501,52340,56841,17179,2022,'NATIVIDADE',Natividade,'RJ',3303104,5153.0,5153,429.4,429.4,2,479.0,479.0,Pequeno I
3214,3221,330320,51979,45597,4659,33653,38312,7285,47483.25,41725.33,3911.25,31268.17,35179.42,6545.92,569799,500704,46935,375218,422153,78551,2022,'NILOPOLIS',Nilópolis,'RJ',3303203,3413.0,3413,853.2,853.2,6,,,Grande
3215,3222,330330,140107,123320,9591,93654,103245,20075,121067.83,106144.67,8143.42,79600.42,87743.83,18400.83,1452814,1273736,97721,955205,1052926,220810,2022,'NITEROI',Niterói,'RJ',3303302,65189.0,65189,5432.4,5432.4,10,4378.0,4378.0,Grande
3216,3223,330340,57500,47946,7444,25645,33089,14857,51399.33,42749.25,6549.67,22461.67,29011.33,13737.92,616792,512991,78596,269540,348136,164855,2022,'NOVA FRIBURGO',Nova Friburgo,'RJ',3303401,60886.0,67360,5073.8,5613.3,4,4436.0,4436.0,Grande
3217,3224,330350,457216,416430,17693,359615,377308,39122,411873.17,375246.92,16480.25,322167.25,338647.5,36599.42,4942478,4502963,197763,3866007,4063770,439193,2022,'NOVA IGUACU',Nova Iguaçu,'RJ',3303500,95299.0,527244,7941.6,43937.0,10,9949.0,34348.0,Grande
3218,3225,330360,21868,20197,731,17506,18237,1960,20459.08,18902.67,691.17,16211.42,16902.58,2000.08,245509,226832,8294,194537,202831,24001,2022,'PARACAMBI',Paracambi,'RJ',3303609,10992.0,10992,1374.0,1374.0,3,1184.0,1184.0,Pequeno II
3219,3226,330370,18874,16233,3221,7946,11167,5066,17048.0,14856.67,2902.58,7479.33,10381.92,4474.75,204576,178280,34831,89752,124583,53697,2022,'PARAIBA DO SUL',Paraíba do Sul,'RJ',3303708,15590.0,15590,1299.2,1299.2,2,1336.0,1336.0,Pequeno II
3220,3227,330380,22075,18976,1750,13115,14865,4111,19140.75,16344.58,1899.5,10568.5,12468.0,3876.58,229689,196135,22794,126822,149616,46519,2022,'PARATI',Parati,'RJ',3303807,3853.0,3853,321.1,321.1,2,197.0,197.0,Pequeno II
3221,3228,330385,14319,12702,2341,6545,8886,3816,13192.0,11867.75,2192.0,6356.83,8548.83,3318.92,158304,142413,26304,76282,102586,39827,2022,'PATY DO ALFERES',Paty do Alferes,'RJ',3303856,7514.0,7514,626.2,626.2,2,784.0,784.0,Pequeno II
3222,3229,330390,110871,92980,10827,58260,69087,23893,95910.33,81147.58,9805.58,50067.92,59873.5,21274.08,1150924,973771,117667,600815,718482,255289,2022,'PETROPOLIS',Petrópolis,'RJ',3303906,91696.0,114025,7641.3,9502.1,10,7176.0,7176.0,Grande
3223,3230,330395,10209,9175,443,7028,7471,1704,9332.67,8418.58,441.08,6448.67,6889.75,1528.83,111992,101023,5293,77384,82677,18346,2022,'PINHEIRAL',Pinheiral,'RJ',3303955,5323.0,5323,443.6,443.6,3,482.0,482.0,Pequeno II
3224,3231,330400,11364,10080,657,7232,7889,2191,10562.0,9513.92,606.08,6905.75,7511.83,2002.08,126744,114167,7273,82869,90142,24025,2022,'PIRAI',Piraí,'RJ',3304003,7952.0,7952,662.7,662.7,2,700.0,700.0,Pequeno II
3225,3232,330410,10249,8445,1287,5212,6499,1946,9863.17,8127.42,1367.83,4587.5,5955.33,2172.08,118358,97529,16414,55050,71464,26065,2022,'PORCIUNCULA',Porciúncula,'RJ',3304102,5080.0,5080,423.3,423.3,3,170.0,170.0,Pequeno I
3226,3233,330411,9409,8096,617,5240,5857,2239,8803.0,7583.08,589.0,5011.08,5600.08,1983.0,105636,90997,7068,60133,67201,23796,2022,'PORTO REAL',Porto Real,'RJ',3304110,9962.0,9962,830.2,830.2,2,720.0,720.0,Pequeno I
3227,3234,330412,5604,4952,455,3250,3705,1247,5252.33,4667.92,421.75,3056.25,3478.0,1189.92,63028,56015,5061,36675,41736,14279,2022,'QUATIS',Quatis,'RJ',3304128,10907.0,14231,908.9,1185.9,2,681.0,681.0,Pequeno I
3228,3235,330414,76334,68424,4972,51840,56812,11612,69796.5,62843.75,4250.67,48256.92,52507.58,10336.17,837558,754125,51008,579083,630091,124034,2022,'QUEIMADOS',Queimados,'RJ',3304144,19875.0,19875,1656.2,1656.2,8,810.0,810.0,Grande
3229,3236,330415,15091,12280,1284,6913,8197,4083,14498.0,11969.83,1251.17,6783.08,8034.25,3935.58,173976,143638,15014,81397,96411,47227,2022,'QUISSAMA',Quissamã,'RJ',3304151,20958.0,28404,1746.5,2367.0,4,664.0,3451.0,Pequeno II
3230,3237,330420,39899,32847,3946,18208,22154,10693,36917.25,30572.08,3598.17,16862.33,20460.5,10111.58,443007,366865,43178,202348,245526,121339,2022,'RESENDE',Resende,'RJ',3304201,48430.0,48430,4035.8,4035.8,7,2606.0,2606.0,Grande
3231,3238,330430,30269,27306,1177,22220,23397,3909,27995.42,25483.5,892.17,21183.83,22076.0,3407.5,335945,305802,10706,254206,264912,40890,2022,'RIO BONITO',Rio Bonito,'RJ',3304300,10062.0,10062,838.5,838.5,3,743.0,743.0,Médio
3232,3239,330440,9110,7636,939,4889,5828,1808,8568.42,7253.92,911.0,4616.92,5527.92,1726.0,102821,87047,10932,55403,66335,20712,2022,'RIO CLARO',Rio Claro,'RJ',3304409,13305.0,15492,1108.8,1291.0,2,1134.0,1134.0,Pequeno I
3233,3240,330450,4851,4182,376,2489,2865,1317,4615.67,4035.67,386.75,2413.42,2800.17,1235.5,55388,48428,4641,28961,33602,14826,2022,'RIO DAS FLORES',Rio Das Flores,'RJ',3304508,3439.0,3439,286.6,286.6,2,207.0,207.0,Pequeno I
3234,3241,330452,62267,55063,5561,38720,44281,10782,55253.33,48926.0,5344.83,33475.0,38819.83,10106.17,663040,587112,64138,401700,465838,121274,2022,'RIO DAS OSTRAS',Rio Das Ostras,'RJ',3304524,47104.0,47104,3925.3,3925.3,4,3818.0,3818.0,Grande
3235,3242,330455,2010074,1784894,187248,1282665,1469913,314981,1737502.25,1537499.17,163731.58,1093709.75,1257441.33,280057.83,20850027,18449990,1964779,13124517,15089296,3360694,2022,'RIO DE JANEIRO',Rio de Janeiro,'RJ',3304557,1455179.0,2097010,121264.9,174750.8,47,104711.0,111090.0,Metrópole
3236,3243,330460,3980,3438,590,1806,2396,1042,3709.08,3230.67,564.58,1744.75,2309.33,921.33,44509,38768,6775,20937,27712,11056,2022,'SANTA MARIA MADALENA',Santa Maria Madalena,'RJ',3304607,1485.0,1485,123.8,123.8,2,220.0,220.0,Pequeno I
3237,3244,330470,17279,14224,3487,5533,9020,5204,15935.17,13197.25,3180.67,5182.42,8363.08,4834.17,191222,158367,38168,62189,100357,58010,2022,'SANTO ANTONIO DE PADUA',Santo Antônio de Pádua,'RJ',3304706,6851.0,6851,570.9,570.9,2,532.0,532.0,Pequeno II
3238,3245,330475,29191,26030,3877,16833,20710,5320,27841.92,25041.25,3577.75,16604.5,20182.25,4859.0,334103,300495,42933,199254,242187,58308,2022,'SAO FRANCISCO DE ITABAPOAN,São Francisco de Itabapoana,'RJ',3304755,9819.0,9819,981.9,981.9,3,973.0,973.0,Pequeno II
3239,3246,330480,17873,16133,1400,10793,12193,3940,17041.42,15496.5,1293.83,10646.67,11940.5,3556.0,204497,185958,15526,127760,143286,42672,2022,'SAO FIDELIS',São Fidélis,'RJ',3304805,18079.0,18079,1506.6,1506.6,2,1487.0,1487.0,Pequeno II
3240,3247,330490,336872,300329,26624,222417,249041,51288,304023.67,271231.92,24545.42,200841.75,225387.17,45844.75,3648284,3254783,294545,2410101,2704646,550137,2022,'SAO GONCALO',São Gonçalo,'RJ',3304904,236232.0,236232,19686.0,19686.0,15,13459.0,13459.0,Metrópole
3241,3248,330500,24899,22464,1534,17066,18600,3864,22855.58,20769.75,1455.83,15794.75,17250.58,3519.17,274267,249237,17470,189537,207007,42230,2022,'SAO JOAO DA BARRA',São João da Barra,'RJ',3305000,18958.0,18958,1579.8,1579.8,6,1399.0,1399.0,Pequeno II
3242,3249,330510,146308,127920,13085,91861,104946,22974,127137.0,110426.83,12545.5,76738.08,89283.58,21143.25,1525644,1325122,150546,920857,1071403,253719,2022,'SAO JOAO DE MERITI',São João de Meriti,'RJ',3305109,29926.0,29926,2493.8,2493.8,4,2676.0,2676.0,Grande
3243,3250,330513,3962,3500,543,2047,2590,910,3765.58,3357.92,499.92,2016.42,2516.33,841.58,45187,40295,5999,24197,30196,10099,2022,'SAO JOSE DE UBA',São José de Ubá,'RJ',3305133,1551.0,1551,129.2,129.2,2,70.0,70.0,Pequeno I
3244,3251,330515,9253,8175,1232,4376,5608,2567,8288.33,7449.75,1089.25,4460.92,5550.17,1899.58,99460,89397,13071,53531,66602,22795,2022,'SAO JOSE DO VALE DO RIO PR,São José do Vale do Rio Preto,'RJ',3305158,8819.0,8819,734.9,734.9,1,980.0,980.0,Pequeno II
3245,3252,330520,45089,40513,4142,27722,31864,8649,39143.17,35288.08,3516.58,24232.67,27749.25,7538.83,469718,423457,42199,290792,332991,90466,2022,'SAO PEDRO DA ALDEIA',São Pedro da Aldeia,'RJ',3305208,15243.0,15243,1270.2,1270.2,6,849.0,849.0,Médio
3246,3253,330530,4903,3934,775,1846,2621,1313,4640.17,3827.92,736.25,1861.83,2598.08,1229.83,55682,45935,8835,22342,31177,14758,2022,'SAO SEBASTIAO DO ALTO',São Sebastião do Alto,'RJ',3305307,4611.0,4611,384.2,384.2,2,500.0,500.0,Pequeno I
3247,3254,330540,9867,8241,1847,3732,5579,2662,8965.33,7606.5,1805.42,3294.83,5100.25,2506.25,107584,91278,21665,39538,61203,30075,2022,'SAPUCAIA',Sapucaia,'RJ',3305406,7763.0,7763,646.9,646.9,2,554.0,554.0,Pequeno I
3248,3255,330550,44962,37858,5715,23471,29186,8672,34623.92,30114.75,5258.33,18003.08,23261.42,6853.33,415487,361377,63100,216037,279137,82240,2022,'SAQUAREMA',Saquarema,'RJ',3305505,27893.0,32452,2324.4,2704.3,5,1738.0,1738.0,Médio
3249,3256,330555,53381,47974,2030,40610,42640,5334,47962.92,43383.83,1714.75,37145.0,38859.75,4524.08,575555,520606,20577,445740,466317,54289,2022,'SEROPEDICA',Seropédica,'RJ',3305554,38963.0,41803,3246.9,3483.6,4,2764.0,2764.0,Médio
3250,3257,330560,12268,10678,1561,6645,8206,2472,11796.25,10347.92,1455.42,6538.17,7993.58,2354.33,141555,124175,17465,78458,95923,28252,2022,'SILVA JARDIM',Silva Jardim,'RJ',3305604,7951.0,7951,662.6,662.6,2,1425.0,1425.0,Pequeno II
3251,3258,330570,9766,9018,1447,6147,7594,1424,8902.17,8245.33,1264.42,5670.83,6935.25,1310.08,106826,98944,15173,68050,83223,15721,2022,'SUMIDOURO',Sumidouro,'RJ',3305703,3963.0,3963,396.3,396.3,1,210.0,210.0,Pequeno I
3252,3259,330575,19161,17261,857,13862,14719,2542,17540.25,15922.08,854.75,12720.08,13574.83,2347.25,210483,191065,10257,152641,162898,28167,2022,'TANGUA',Tanguá,'RJ',3305752,27965.0,27965,2330.4,2330.4,5,1153.0,1153.0,Pequeno II
3253,3260,330580,72230,63349,9396,36795,46191,17158,63654.08,55783.17,8289.75,31338.0,39627.75,16155.42,763849,669398,99477,376056,475533,193865,2022,'TERESOPOLIS',Teresópolis,'RJ',3305802,67611.0,67611,5634.2,5634.2,6,4837.0,4837.0,Grande
3254,3261,330590,4887,4434,543,2951,3494,940,4505.75,4120.0,520.17,2818.5,3338.67,781.33,54069,49440,6242,33822,40064,9376,2022,'TRAJANO DE MORAIS',Trajano de Morais,'RJ',3305901,4698.0,4698,427.1,427.1,2,1706.0,1706.0,Pequeno I
3255,3262,330600,41092,36187,2487,24997,27484,8703,38038.58,33726.58,2523.42,22853.33,25376.75,8349.83,456463,404719,30281,274240,304521,100198,2022,'TRES RIOS',Três Rios,'RJ',3306008,37651.0,37651,3137.6,3137.6,4,2617.0,2617.0,Médio
3256,3263,330610,31062,27287,2847,18067,20914,6373,29320.75,25984.58,2634.75,17253.25,19888.0,6096.58,351849,311815,31617,207039,238656,73159,2022,'VALENCA',Valença,'RJ',3306107,9975.0,9975,906.8,906.8,6,563.0,563.0,Médio
3257,3264,330615,6843,6162,970,4102,5072,1090,6501.83,5854.75,880.92,3982.5,4863.42,991.33,78022,70257,10571,47790,58361,11896,2022,'VARRE-SAI',Varre-sai,'RJ',3306156,815.0,815,81.5,81.5,2,92.0,92.0,Pequeno I
3258,3265,330620,14840,12975,2238,6948,9186,3789,13610.75,11929.0,2413.33,5710.5,8123.83,3805.17,163329,143148,28960,68526,97486,45662,2022,'VASSOURAS',Vassouras,'RJ',3306206,4654.0,4654,387.8,387.8,3,276.0,276.0,Pequeno II
3259,3266,330630,92206,77673,4351,56099,60450,17223,81527.17,69789.08,4114.17,50034.08,54148.25,15640.83,978326,837469,49370,600409,649779,187690,2022,'VOLTA REDONDA',Volta Redonda,'RJ',3306305,135492.0,135492,11291.0,11291.0,31,9638.0,9638.0,Grande
3260,3267,350010,7222,4951,980,1012,1992,2959,6696.67,4628.17,960.83,972.08,1932.92,2695.25,80360,55538,11530,11665,23195,32343,2022,'ADAMANTINA',Adamantina,'SP',3500105,2032.0,2032,169.3,169.3,1,115.0,115.0,Pequeno II
3261,3268,350020,2125,1465,219,450,669,796,2071.5,1460.83,206.08,467.33,673.42,787.42,24858,17530,2473,5608,8081,9449,2022,'ADOLFO',Adolfo,'SP',3500204,1188.0,1188,99.0,99.0,1,57.0,57.0,Pequeno I
3262,3269,350030,11912,10162,2364,4659,7023,3139,11090.75,9521.92,2166.92,4580.67,6747.58,2774.33,133089,114263,26003,54968,80971,33292,2022,'AGUAI',Aguaí,'SP',3500303,5476.0,5476,456.3,456.3,1,871.0,871.0,Pequeno II
3263,3270,350040,2570,1775,304,432,736,1039,2450.92,1722.83,297.75,432.67,730.42,992.42,29411,20674,3573,5192,8765,11909,2022,'AGUAS DA PRATA',Águas da Prata,'SP',3500402,2324.0,2324,193.7,193.7,1,144.0,144.0,Pequeno I
3264,3271,350050,4389,3402,629,964,1593,1809,4042.33,3164.58,628.0,995.75,1623.75,1540.83,48508,37975,7536,11949,19485,18490,2022,'AGUAS DE LINDOIA',Águas de Lindóia,'SP',3500501,3155.0,3155,262.9,262.9,1,263.0,263.0,Pequeno I
3265,3272,350055,2727,2329,396,1201,1597,732,2662.42,2330.92,336.92,1281.17,1618.08,712.83,31949,27971,4043,15374,19417,8554,2022,'AGUAS DE SANTA BARBARA',Águas de Santa Bárbara,'SP',3500550,2913.0,2913,242.8,242.8,1,200.0,200.0,Pequeno I
3266,3273,350060,894,528,103,202,305,223,763.58,466.0,84.17,180.58,264.75,201.25,9163,5592,1010,2167,3177,2415,2022,'AGUAS DE SAO PEDRO',Águas de São Pedro,'SP',3500600,1291.0,1291,107.6,107.6,1,50.0,50.0,Pequeno I
3267,3274,350070,11212,8659,1386,3378,4764,3895,10178.58,7915.58,1415.75,2973.92,4389.67,3525.92,122143,94987,16989,35687,52676,42311,2022,'AGUDOS',Agudos,'SP',3500709,1216.0,1216,121.6,121.6,1,157.0,157.0,Pequeno II
3268,3275,350075,2261,1859,599,362,961,898,2048.0,1713.92,597.0,349.75,946.75,767.17,24576,20567,7164,4197,11361,9206,2022,'ALAMBARI',Alambari,'SP',3500758,2409.0,2409,219.0,219.0,1,217.0,217.0,Pequeno I
3269,3276,350080,2063,1532,155,700,855,677,1955.08,1533.0,173.5,657.92,831.42,701.58,23461,18396,2082,7895,9977,8419,2022,'ALFREDO MARCONDES',Alfredo Marcondes,'SP',3500808,577.0,577,48.1,48.1,1,71.0,71.0,Pequeno I
3270,3277,350090,1656,1240,201,683,884,356,1565.75,1153.83,199.92,584.67,784.58,369.25,18789,13846,2399,7016,9415,4431,2022,'ALTAIR',Altair,'SP',3500907,1227.0,1227,102.2,102.2,1,75.0,75.0,Pequeno I
3271,3278,350100,7909,6418,527,3898,4425,1993,7330.75,5961.75,469.75,3635.67,4105.42,1856.33,87969,71541,5637,43628,49265,22276,2022,'ALTINOPOLIS',Altinópolis,'SP',3501004,2256.0,2256,188.0,188.0,1,150.0,150.0,Pequeno I
3272,3279,350110,1392,1126,48,773,821,305,1351.33,1102.75,52.42,724.67,777.08,325.67,16216,13233,629,8696,9325,3908,2022,'ALTO ALEGRE',Alto Alegre,'SP',3501103,2844.0,2844,237.0,237.0,1,116.0,116.0,Pequeno I
3273,3280,350115,3985,3460,633,1495,2128,1332,3906.25,3412.42,600.92,1600.58,2201.5,1210.92,46875,40949,7211,19207,26418,14531,2022,'ALUMINIO',Alumínio,'SP',3501152,5114.0,5114,426.2,426.2,1,145.0,145.0,Pequeno I
3274,3281,350120,1817,1255,135,629,764,491,1721.5,1195.33,131.42,601.25,732.67,462.67,20658,14344,1577,7215,8792,5552,2022,'ALVARES FLORENCE',Álvares Florence,'SP',3501202,1193.0,1193,99.4,99.4,1,110.0,110.0,Pequeno I
3275,3282,350130,10491,8860,1243,4543,5786,3074,9794.08,8340.17,1290.75,4138.92,5429.67,2910.5,117529,100082,15489,49667,65156,34926,2022,'ALVARES MACHADO',Álvares Machado,'SP',3501301,2352.0,2352,196.0,196.0,2,161.0,161.0,Pequeno II
3276,3283,350140,2237,1770,162,926,1088,682,2236.92,1803.42,159.25,940.08,1099.33,704.08,26843,21641,1911,11281,13192,8449,2022,'ALVARO DE CARVALHO',Álvaro de Carvalho,'SP',3501400,2038.0,2038,203.8,203.8,1,176.0,176.0,Pequeno I
3277,3284,350150,1647,1431,304,401,705,726,1645.58,1458.42,315.42,419.75,735.17,723.25,19747,17501,3785,5037,8822,8679,2022,'ALVINLANDIA',Alvinlândia,'SP',3501509,386.0,386,55.1,55.1,1,,,Pequeno I
3278,3285,350160,38492,30063,4550,16331,20881,9182,35151.08,27433.92,3964.08,15247.33,19211.42,8222.5,421813,329207,47569,182968,230537,98670,2022,'AMERICANA',Americana,'SP',3501608,51400.0,51400,4283.3,4283.3,6,6120.0,6120.0,Grande
3279,3286,350170,9101,7830,1307,3986,5293,2537,8083.92,7062.0,1101.17,3629.0,4730.17,2331.83,97007,84744,13214,43548,56762,27982,2022,'AMERICO BRASILIENSE',Américo Brasiliense,'SP',3501707,1348.0,1348,112.3,112.3,1,97.0,97.0,Pequeno II
3280,3287,350180,2829,1979,264,989,1253,726,2731.5,1903.42,290.5,854.92,1145.42,758.0,32778,22841,3486,10259,13745,9096,2022,'AMERICO DE CAMPOS',Américo de Campos,'SP',3501806,4095.0,4095,341.2,341.2,1,249.0,249.0,Pequeno I
3281,3288,350190,12406,9585,1506,4585,6091,3494,10760.33,8294.58,1383.33,3628.67,5012.0,3282.58,129124,99535,16600,43544,60144,39391,2022,'AMPARO',Amparo,'SP',3501905,3621.0,3621,301.8,301.8,2,225.0,225.0,Médio
3282,3289,350200,1622,1328,104,778,882,446,1471.5,1234.17,86.33,771.17,857.5,376.67,17658,14810,1036,9254,10290,4520,2022,'ANALANDIA',Analândia,'SP',3502002,1065.0,1065,106.5,106.5,1,193.0,193.0,Pequeno I
3283,3290,350210,17949,14184,1308,9297,10605,3579,16316.33,12968.92,1262.17,8265.58,9527.75,3441.17,195796,155627,15146,99187,114333,41294,2022,'ANDRADINA',Andradina,'SP',3502101,6581.0,6581,548.4,548.4,3,502.0,502.0,Médio
3284,3291,350220,10158,7969,1506,3040,4546,3423,9357.33,7411.17,1434.92,2748.5,4183.42,3227.75,112288,88934,17219,32982,50201,38733,2022,'ANGATUBA',Angatuba,'SP',3502200,8129.0,8129,903.2,903.2,1,,,Pequeno II
3285,3293,350240,1978,1305,218,305,523,782,1948.67,1380.58,260.17,331.0,591.17,789.42,23384,16567,3122,3972,7094,9473,2022,'ANHUMAS',Anhumas,'SP',3502408,754.0,754,62.8,62.8,1,42.0,42.0,Pequeno I
3286,3294,350250,11466,9700,2611,2908,5519,4181,10551.0,8966.75,2333.17,2960.83,5294.0,3672.75,126612,107601,27998,35530,63528,44073,2022,'APARECIDA',Aparecida,'SP',3502507,10833.0,10833,902.8,902.8,3,504.0,504.0,Pequeno II
3287,3295,350260,2322,1664,222,892,1114,550,2221.92,1627.83,191.08,911.0,1102.08,525.75,26663,19534,2293,10932,13225,6309,2022,'APARECIDA DOESTE',Aparecida D´oeste,'SP',3502606,428.0,428,35.7,35.7,1,3.0,3.0,Pequeno I
3288,3296,350270,13626,11526,1658,6204,7862,3664,13240.33,11348.67,1631.83,6136.83,7768.67,3580.0,158884,136184,19582,73642,93224,42960,2022,'APIAI',Apiaí,'SP',3502705,2337.0,2337,194.8,194.8,1,126.0,126.0,Pequeno II
3289,3297,350275,8952,8009,718,5728,6446,1563,8020.33,7174.83,785.92,4873.08,5659.0,1515.83,96244,86098,9431,58477,67908,18190,2022,'ARACARIGUAMA',Araçariguama,'SP',3502754,5187.0,5187,432.2,432.2,1,172.0,172.0,Pequeno I
3290,3298,350280,52945,39653,6000,18872,24872,14781,48967.92,36721.92,5740.25,16769.42,22509.67,14212.25,587615,440663,68883,201233,270116,170547,2022,'ARACATUBA',Araçatuba,'SP',3502804,26634.0,26634,2219.5,2219.5,6,3676.0,3676.0,Grande
3291,3299,350290,11390,8916,1692,3556,5248,3668,10390.5,8202.17,1518.17,3445.83,4964.0,3238.17,124686,98426,18218,41350,59568,38858,2022,'ARACOIABA DA SERRA',Araçoiaba da Serra,'SP',3502903,8990.0,8990,749.2,749.2,1,501.0,501.0,Pequeno II
3292,3300,350300,2069,1700,228,1004,1232,468,1975.92,1643.92,216.25,938.42,1154.67,489.25,23711,19727,2595,11261,13856,5871,2022,'ARAMINA',Aramina,'SP',3503000,1537.0,1537,128.1,128.1,1,96.0,96.0,Pequeno I
3293,3301,350310,3147,2609,429,1126,1555,1054,2967.33,2488.5,366.33,1075.92,1442.25,1046.25,35608,29862,4396,12911,17307,12555,2022,'ARANDU',Arandu,'SP',3503109,2097.0,2097,174.8,174.8,1,53.0,53.0,Pequeno I
3294,3302,350315,1727,1385,100,726,826,559,1671.08,1348.83,104.75,698.58,803.33,545.5,20053,16186,1257,8383,9640,6546,2022,'ARAPEI',Arapeí,'SP',3503158,449.0,449,40.8,40.8,1,,,Pequeno I
3295,3303,350320,52715,43769,8226,19614,27840,15929,47849.0,39911.67,7543.33,17529.5,25072.83,14838.83,574188,478940,90520,210354,300874,178066,2022,'ARARAQUARA',Araraquara,'SP',3503208,36869.0,36869,3072.4,3072.4,10,2614.0,2614.0,Grande
3296,3304,350330,41232,32976,3345,20774,24119,8857,38856.83,31177.0,3129.83,19600.67,22730.5,8446.5,466282,374124,37558,235208,272766,101358,2022,'ARARAS',Araras,'SP',3503307,43919.0,43919,3659.9,3659.9,3,2899.0,2899.0,Grande
3297,3305,350335,1205,953,107,417,524,429,1162.25,969.58,122.5,423.5,546.0,423.58,13947,11635,1470,5082,6552,5083,2022,'ARCO-IRIS',Arco-íris,'SP',3503356,94.0,94,7.8,7.8,1,10.0,10.0,Pequeno I
3298,3306,350340,4131,2912,475,1170,1645,1267,3781.83,2716.92,418.08,1122.67,1540.75,1176.17,45382,32603,5017,13472,18489,14114,2022,'AREALVA',Arealva,'SP',3503406,1668.0,1668,139.0,139.0,1,58.0,58.0,Pequeno I
3299,3307,350350,2107,1900,307,1122,1429,471,2040.75,1839.25,270.83,1124.83,1395.67,443.58,24489,22071,3250,13498,16748,5323,2022,'AREIAS',Areias,'SP',3503505,610.0,610,50.8,50.8,1,44.0,44.0,Pequeno I
3300,3308,350360,3967,3391,641,1404,2045,1346,3609.25,3091.83,583.58,1326.33,1909.92,1181.92,43311,37102,7003,15916,22919,14183,2022,'AREIOPOLIS',Areiópolis,'SP',3503604,1441.0,1441,160.1,160.1,1,142.0,142.0,Pequeno I
3301,3309,350370,2069,1614,442,553,995,619,1926.0,1514.17,427.92,525.92,953.83,560.33,23112,18170,5135,6311,11446,6724,2022,'ARIRANHA',Ariranha,'SP',3503703,2542.0,2542,211.8,211.8,1,132.0,132.0,Pequeno I
3302,3310,350380,15914,12443,2900,4046,6946,5497,14712.25,11626.42,2817.25,3869.0,6686.25,4940.17,176547,139517,33807,46428,80235,59282,2022,'ARTUR NOGUEIRA',Artur Nogueira,'SP',3503802,3004.0,3004,250.3,250.3,1,255.0,255.0,Pequeno II
3303,3311,350390,35125,29830,4174,16825,20999,8831,32730.25,28254.5,4109.42,15782.33,19891.75,8362.75,392763,339054,49313,189388,238701,100353,2022,'ARUJA',Arujá,'SP',3503901,26894.0,26894,2241.2,2241.2,2,1738.0,1738.0,Médio
3304,3312,350395,1250,748,83,238,321,427,1236.83,773.33,101.0,243.75,344.75,428.58,14842,9280,1212,2925,4137,5143,2022,'ASPASIA',Aspásia,'SP',3503950,2149.0,2149,179.1,179.1,1,81.0,81.0,Pequeno I
3305,3313,350400,25702,20357,5584,5922,11506,8851,23734.75,19083.17,5035.67,5770.58,10806.25,8276.92,284817,228998,60428,69247,129675,99323,2022,'ASSIS',Assis,'SP',3504008,24248.0,24248,2020.7,2020.7,4,1236.0,1236.0,Médio
3306,3314,350410,36549,29982,6292,11638,17930,12052,33788.92,27986.5,5692.75,11285.17,16977.92,11008.58,405467,335838,68313,135422,203735,132103,2022,'ATIBAIA',Atibaia,'SP',3504107,16267.0,16267,1355.6,1355.6,5,1494.0,1494.0,Grande
3307,3315,350420,3421,2614,474,787,1261,1353,3077.08,2379.0,422.33,671.42,1093.75,1285.25,36925,28548,5068,8057,13125,15423,2022,'AURIFLAMA',Auriflama,'SP',3504206,2559.0,2559,213.2,213.2,1,281.0,281.0,Pequeno I
3308,3316,350430,1996,1713,315,813,1128,585,1927.08,1661.42,247.5,872.92,1120.42,541.0,23125,19937,2970,10475,13445,6492,2022,'AVAI',Avaí,'SP',3504305,150.0,150,30.0,30.0,1,30.0,30.0,Pequeno I
3309,3317,350440,6127,5254,368,3351,3719,1535,5782.0,5085.75,349.42,3322.92,3672.33,1413.42,69384,61029,4193,39875,44068,16961,2022,'AVANHANDAVA',Avanhandava,'SP',3504404,2168.0,2168,197.1,197.1,1,91.0,91.0,Pequeno I
3310,3318,350450,23512,20051,4502,8713,13215,6836,21360.25,18413.5,4084.58,7970.08,12054.67,6358.83,256323,220962,49015,95641,144656,76306,2022,'AVARE',Avaré,'SP',3504503,38341.0,59243,3485.5,5385.7,4,3271.0,6609.0,Médio
3311,3319,350460,6864,4924,841,2043,2884,2040,6143.67,4359.92,680.42,1727.0,2407.42,1952.5,73724,52319,8165,20724,28889,23430,2022,'BADY BASSITT',Bady Bassitt,'SP',3504602,2892.0,2892,241.0,241.0,1,169.0,169.0,Pequeno I
3312,3320,350470,729,611,21,438,459,152,696.42,603.0,28.75,426.92,455.67,147.33,8357,7236,345,5123,5468,1768,2022,'BALBINOS',Balbinos,'SP',3504701,641.0,641,58.3,58.3,1,60.0,60.0,Pequeno I
3313,3321,350480,2860,2114,551,419,970,1144,2747.33,2108.92,529.0,479.08,1008.08,1100.83,32968,25307,6348,5749,12097,13210,2022,'BALSAMO',Bálsamo,'SP',3504800,1656.0,1656,184.0,184.0,1,184.0,184.0,Pequeno I
3314,3322,350490,5868,4820,883,2030,2913,1907,5618.17,4633.75,901.25,1771.92,2673.17,1960.58,67418,55605,10815,21263,32078,23527,2022,'BANANAL',Bananal,'SP',3504909,4407.0,4407,367.2,367.2,1,328.0,328.0,Pequeno I
3315,3323,350500,1940,1537,215,563,778,759,1897.25,1548.0,206.5,602.08,808.58,739.42,22767,18576,2478,7225,9703,8873,2022,'BARAO DE ANTONINA',Barão de Antonina,'SP',3505005,1705.0,1705,155.0,155.0,1,171.0,171.0,Pequeno I
3316,3324,350510,3543,2915,306,1673,1979,936,3392.0,2817.25,280.42,1671.42,1951.83,865.42,40704,33807,3365,20057,23422,10385,2022,'BARBOSA',Barbosa,'SP',3505104,3168.0,3168,288.0,288.0,1,,,Pequeno I
3317,3325,350520,8285,7069,1117,3031,4148,2921,7758.08,6721.83,1116.17,2848.08,3964.25,2757.58,93097,80662,13394,34177,47571,33091,2022,'BARIRI',Bariri,'SP',3505203,1583.0,1583,131.9,131.9,1,147.0,147.0,Pequeno II
3318,3326,350530,9504,7721,722,4396,5118,2603,8727.17,7150.08,714.67,4041.75,4756.42,2393.67,104726,85801,8576,48501,57077,28724,2022,'BARRA BONITA',Barra Bonita,'SP',3505302,612.0,612,122.4,122.4,1,78.0,78.0,Pequeno II
3319,3327,350535,4617,4155,669,2487,3156,999,4476.33,4079.83,633.42,2494.5,3127.92,951.92,53716,48958,7601,29934,37535,11423,2022,'BARRA DO CHAPEU',Barra do Chapéu,'SP',3505351,3250.0,3250,270.8,270.8,1,150.0,150.0,Pequeno I
3320,3328,350540,5123,4293,513,2893,3406,887,5002.58,4211.25,428.58,2860.17,3288.75,922.5,60031,50535,5143,34322,39465,11070,2022,'BARRA DO TURVO',Barra do Turvo,'SP',3505401,5127.0,9630,466.1,875.5,1,514.0,514.0,Pequeno I
3321,3329,350550,27649,21815,2474,11971,14445,7370,24309.83,19347.17,2217.17,10708.0,12925.17,6422.0,291718,232166,26606,128496,155102,77064,2022,'BARRETOS',Barretos,'SP',3505500,35238.0,35238,2936.5,2936.5,4,2543.0,2543.0,Grande
3322,3330,350560,13656,12178,776,8900,9676,2502,12450.17,11086.58,820.83,7749.75,8570.58,2516.0,149402,133039,9850,92997,102847,30192,2022,'BARRINHA',Barrinha,'SP',3505609,6987.0,6987,582.2,582.2,1,800.0,800.0,Pequeno II
3323,3331,350570,100332,87273,14907,44469,59376,27897,89704.42,78791.25,13193.0,41125.83,54318.83,24472.42,1076453,945495,158316,493510,651826,293669,2022,'BARUERI',Barueri,'SP',3505708,96547.0,96547,8045.6,8045.6,6,7192.0,7192.0,Grande
3324,3332,350580,6935,5047,1620,1118,2738,2309,6416.33,4702.25,1393.5,1129.75,2523.25,2179.0,76996,56427,16722,13557,30279,26148,2022,'BASTOS',Bastos,'SP',3505807,5996.0,5996,499.7,499.7,1,473.0,473.0,Pequeno II
3325,3333,350590,16488,13024,1800,7331,9131,3893,15094.75,11990.42,1607.17,6774.08,8381.25,3609.17,181137,143885,19286,81289,100575,43310,2022,'BATATAIS',Batatais,'SP',3505906,4966.0,4966,413.8,413.8,3,664.0,664.0,Médio
3326,3334,350600,95988,70252,12104,30177,42281,27971,90062.75,66341.75,10707.17,29516.58,40223.75,26118.0,1080753,796101,128486,354199,482685,313416,2022,'BAURU',Bauru,'SP',3506003,34042.0,34042,2836.8,2836.8,9,2551.0,2551.0,Grande
3327,3335,350610,23562,18798,2527,9931,12458,6340,21980.92,17620.25,2550.25,8998.0,11548.25,6072.0,263771,211443,30603,107976,138579,72864,2022,'BEBEDOURO',Bebedouro,'SP',3506102,18841.0,18841,1570.1,1570.1,4,1160.0,1160.0,Médio
3328,3336,350620,1240,962,119,509,628,334,1196.92,918.67,111.17,482.92,594.08,324.58,14363,11024,1334,5795,7129,3895,2022,'BENTO DE ABREU',Bento de Abreu,'SP',3506201,2059.0,2059,205.9,205.9,1,91.0,91.0,Pequeno I
3329,3337,350630,4844,3838,311,2520,2831,1007,4414.5,3604.17,291.5,2327.75,2619.25,984.92,52974,43250,3498,27933,31431,11819,2022,'BERNARDINO DE CAMPOS',Bernardino de Campos,'SP',3506300,2124.0,2124,177.0,177.0,1,179.0,179.0,Pequeno I
3330,3338,350635,31638,26603,3106,17474,20580,6023,28182.25,23773.58,2864.67,15235.83,18100.5,5673.08,338187,285283,34376,182830,217206,68077,2022,'BERTIOGA',Bertioga,'SP',3506359,8154.0,8154,679.5,679.5,2,416.0,416.0,Pequeno II
3331,3339,350640,2874,1763,293,459,752,1011,2775.25,1761.83,309.83,450.33,760.17,1001.67,33303,21142,3718,5404,9122,12020,2022,'BILAC',Bilac,'SP',3506409,757.0,757,68.8,68.8,1,55.0,55.0,Pequeno I
3332,3340,350650,27872,22067,4136,8780,12916,9151,26350.0,20861.92,3815.5,8405.0,12220.5,8641.42,316200,250343,45786,100860,146646,103697,2022,'BIRIGUI',Birigui,'SP',3506508,6348.0,6348,577.1,577.1,4,553.0,553.0,Grande
3333,3341,350660,14957,12724,1466,7879,9345,3379,13820.33,11878.5,1412.83,7256.0,8668.83,3209.67,165844,142542,16954,87072,104026,38516,2022,'BIRITIBA-MIRIM',Biritiba-mirim,'SP',3506607,6244.0,6244,624.4,624.4,1,148.0,148.0,Pequeno II
3334,3343,350680,3588,2720,444,1057,1501,1219,3377.67,2625.33,427.5,1069.58,1497.08,1128.25,40532,31504,5130,12835,17965,13539,2022,'BOCAINA',Bocaina,'SP',3506805,2983.0,2983,248.6,248.6,1,224.0,224.0,Pequeno I
3335,3344,350690,4557,3713,682,1872,2554,1159,4068.58,3303.08,558.08,1717.08,2275.17,1027.92,48823,39637,6697,20605,27302,12335,2022,'BOFETE',Bofete,'SP',3506904,1498.0,1498,124.8,124.8,1,153.0,153.0,Pequeno I
3336,3345,350700,15230,12942,2939,6415,9354,3588,13965.25,11944.17,2457.92,6064.83,8522.75,3421.42,167583,143330,29495,72778,102273,41057,2022,'BOITUVA',Boituva,'SP',3507001,9122.0,9122,760.2,760.2,2,509.0,509.0,Pequeno II
3337,3346,350710,9537,8455,1712,4262,5974,2481,8928.33,8022.5,1636.67,4067.42,5704.08,2318.42,107140,96270,19640,48809,68449,27821,2022,'BOM JESUS DOS PERDOES',Bom Jesus Dos Perdões,'SP',3507100,5423.0,5423,451.9,451.9,2,325.0,325.0,Pequeno I
3338,3347,350715,2443,2177,527,888,1415,762,2390.25,2165.17,489.42,953.08,1442.5,722.67,28683,25982,5873,11437,17310,8672,2022,'BOM SUCESSO DE ITARARE',Bom Sucesso de Itararé,'SP',3507159,3245.0,3245,270.4,270.4,1,117.0,117.0,Pequeno I
3339,3348,350720,483,396,60,102,162,234,461.17,384.0,62.17,119.0,181.17,202.83,5534,4608,746,1428,2174,2434,2022,'BORA',Borá,'SP',3507209,220.0,220,18.3,18.3,1,20.0,20.0,Pequeno I
3340,3349,350730,2127,1733,186,840,1026,707,1972.17,1682.0,153.25,938.92,1092.17,589.83,23666,20184,1839,11267,13106,7078,2022,'BORACEIA',Boracéia,'SP',3507308,1933.0,1933,175.7,175.7,1,128.0,128.0,Pequeno I
3341,3350,350740,5099,3726,681,1175,1856,1870,5001.42,3806.5,683.75,1291.92,1975.67,1830.83,60017,45678,8205,15503,23708,21970,2022,'BORBOREMA',Borborema,'SP',3507407,1042.0,1042,86.8,86.8,1,25.0,25.0,Pequeno I
3342,3351,350745,1897,1274,141,565,706,568,1758.83,1197.08,124.0,526.58,650.58,546.5,21106,14365,1488,6319,7807,6558,2022,'BOREBI',Borebi,'SP',3507456,2181.0,2181,181.8,181.8,1,41.0,41.0,Pequeno I
3343,3352,350750,36066,31018,5911,14145,20056,10962,32042.58,27719.67,5302.58,12932.42,18235.0,9484.67,384511,332636,63631,155189,218820,113816,2022,'BOTUCATU',Botucatu,'SP',3507506,59269.0,59269,4939.1,4939.1,5,4446.0,4446.0,Grande
3344,3353,350760,52213,42816,6600,23158,29758,13058,46110.25,38104.33,6545.25,19223.42,25768.67,12335.67,553323,457252,78543,230681,309224,148028,2022,'BRAGANCA PAULISTA',Bragança Paulista,'SP',3507605,54019.0,54019,4501.6,4501.6,4,5335.0,5335.0,Grande
3345,3354,350770,2997,2206,242,1268,1510,696,2896.08,2119.42,208.83,1196.58,1405.42,714.0,34753,25433,2506,14359,16865,8568,2022,'BRAUNA',Braúna,'SP',3507704,612.0,612,51.0,51.0,1,23.0,23.0,Pequeno I
3346,3355,350775,1931,1474,210,754,964,510,1821.0,1447.58,185.92,755.83,941.75,505.83,21852,17371,2231,9070,11301,6070,2022,'BREJO ALEGRE',Brejo Alegre,'SP',3507753,2559.0,2559,213.2,213.2,1,457.0,457.0,Pequeno I
3347,3356,350780,6815,5711,1360,2396,3756,1955,6470.75,5458.0,1320.58,2420.75,3741.33,1716.67,77649,65496,15847,29049,44896,20600,2022,'BRODOWSKI',Brodowski,'SP',3507803,4929.0,4929,410.8,410.8,1,650.0,650.0,Pequeno II
3348,3357,350790,6826,4988,1085,1075,2160,2828,6446.08,4824.67,1002.25,1194.83,2197.08,2627.58,77353,57896,12027,14338,26365,31531,2022,'BROTAS',Brotas,'SP',3507902,12198.0,12198,1016.5,1016.5,1,896.0,896.0,Pequeno II
3349,3358,350800,11553,10415,1170,6437,7607,2808,11307.17,10279.42,884.83,6891.83,7776.67,2502.75,135686,123353,10618,82702,93320,30033,2022,'BURI',Buri,'SP',3508009,4511.0,4511,375.9,375.9,1,228.0,228.0,Pequeno I
3350,3359,350810,8213,6800,1605,2914,4519,2281,7842.17,6616.75,1314.33,3090.75,4405.08,2211.67,94106,79401,15772,37089,52861,26540,2022,'BURITAMA',Buritama,'SP',3508108,4561.0,4561,456.1,456.1,1,461.0,461.0,Pequeno I
3351,3360,350820,2531,1737,148,973,1121,616,2470.0,1714.5,194.42,873.5,1067.92,646.58,29640,20574,2333,10482,12815,7759,2022,'BURITIZAL',Buritizal,'SP',3508207,1818.0,1818,151.5,151.5,1,156.0,156.0,Pequeno I
3352,3361,350830,2673,1742,335,474,809,933,2600.17,1740.58,324.5,449.58,774.08,966.5,31202,20887,3894,5395,9289,11598,2022,'CABRALIA PAULISTA',Cabrália Paulista,'SP',3508306,1969.0,1969,164.1,164.1,1,106.0,106.0,Pequeno I
3353,3362,350840,12556,10608,2236,4258,6494,4114,11549.42,9868.25,2015.25,4218.17,6233.42,3634.83,138593,118419,24183,50618,74801,43618,2022,'CABREUVA',Cabreúva,'SP',3508405,13604.0,13604,1133.7,1133.7,3,575.0,575.0,Pequeno II
3354,3363,350850,27070,22911,4069,11800,15869,7042,25135.75,21644.0,3734.08,11367.5,15101.58,6542.42,301629,259728,44809,136410,181219,78509,2022,'CACAPAVA',Caçapava,'SP',3508504,14382.0,14382,1198.5,1198.5,2,726.0,726.0,Médio
3355,3365,350870,8739,7235,1187,3544,4731,2504,8284.33,6987.17,995.58,3719.5,4715.08,2272.08,99412,83846,11947,44634,56581,27265,2022,'CACONDE',Caconde,'SP',3508702,838.0,838,69.8,69.8,1,34.0,34.0,Pequeno I
3356,3366,350880,5115,4426,1187,1585,2772,1654,4588.58,3979.83,1085.92,1243.83,2329.75,1650.08,55063,47758,13031,14926,27957,19801,2022,'CAFELANDIA',Cafelândia,'SP',3508801,4526.0,4526,377.2,377.2,1,368.0,368.0,Pequeno I
3357,3367,350890,1560,1109,188,309,497,612,1477.42,1076.58,161.17,332.42,493.58,583.0,17729,12919,1934,3989,5923,6996,2022,'CAIABU',Caiabu,'SP',3508900,700.0,700,100.0,100.0,1,80.0,80.0,Pequeno I
3358,3368,350900,30398,23717,3880,11900,15780,7937,27234.42,21203.17,3630.0,10069.08,13699.08,7504.08,326813,254438,43560,120829,164389,90049,2022,'CAIEIRAS',Caieiras,'SP',3509007,17087.0,17087,1423.9,1423.9,2,801.0,801.0,Médio
3359,3369,350910,2589,2298,218,1700,1918,380,2480.83,2236.5,211.75,1690.92,1902.67,333.83,29770,26838,2541,20291,22832,4006,2022,'CAIUA',Caiuá,'SP',3509106,421.0,421,105.2,105.2,1,,,Pequeno I
3360,3370,350920,37898,33662,1798,25558,27356,6306,34647.5,31169.75,1455.33,24602.67,26058.0,5111.75,415770,374037,17464,295232,312696,61341,2022,'CAJAMAR',Cajamar,'SP',3509205,44174.0,52012,3681.2,4334.3,4,2091.0,7080.0,Médio
3361,3371,350925,13594,11123,2028,5277,7305,3818,12548.25,10317.25,1885.0,4924.0,6809.0,3508.25,150579,123807,22620,59088,81708,42099,2022,'CAJATI',Cajati,'SP',3509254,7821.0,7821,651.8,651.8,2,583.0,583.0,Pequeno II
3362,3372,350930,4482,3376,282,1748,2030,1346,4306.0,3318.67,274.25,1838.25,2112.5,1206.17,51672,39824,3291,22059,25350,14474,2022,'CAJOBI',Cajobi,'SP',3509304,2951.0,2951,245.9,245.9,1,199.0,199.0,Pequeno I
3363,3373,350940,8004,6907,679,4739,5418,1489,7168.25,6218.17,662.75,4067.33,4730.08,1488.08,86019,74618,7953,48808,56761,17857,2022,'CAJURU',Cajuru,'SP',3509403,4192.0,4192,349.3,349.3,1,340.0,340.0,Pequeno II
3364,3374,350945,3076,2428,432,931,1363,1065,2839.75,2349.0,396.92,1030.42,1427.33,921.67,34077,28188,4763,12365,17128,11060,2022,'CAMPINA DO MONTE ALEGRE',Campina do Monte Alegre,'SP',3509452,1101.0,1101,122.3,122.3,1,99.0,99.0,Pequeno I
3365,3375,350950,299780,248263,33341,143738,177079,71184,274115.17,229475.33,29130.0,137938.33,167068.33,62407.0,3289382,2753704,349560,1655260,2004820,748884,2022,'CAMPINAS',Campinas,'SP',3509502,37758.0,37758,3146.5,3146.5,13,1707.0,1707.0,Metrópole
3366,3376,350960,22752,18737,3148,8917,12065,6672,20217.83,16987.5,2594.58,8997.67,11592.25,5395.25,242614,203850,31135,107972,139107,64743,2022,'CAMPO LIMPO PAULISTA',Campo Limpo Paulista,'SP',3509601,7954.0,7954,662.8,662.8,3,248.0,248.0,Médio
3367,3377,350970,12893,10464,3054,2721,5775,4689,11593.92,9492.75,2858.5,2461.17,5319.67,4173.08,139127,113913,34302,29534,63836,50077,2022,'CAMPOS DO JORDAO',Campos do Jordão,'SP',3509700,843.0,843,70.2,70.2,1,135.0,135.0,Pequeno II
3368,3378,350980,2265,1984,348,1115,1463,521,2104.25,1855.17,373.75,961.08,1334.83,520.33,25251,22262,4485,11533,16018,6244,2022,'CAMPOS NOVOS PAULISTA',Campos Novos Paulista,'SP',3509809,630.0,630,52.5,52.5,1,32.0,32.0,Pequeno I
3369,3379,350990,6487,5541,1459,2341,3800,1741,5973.75,5102.67,1301.75,2021.08,3322.83,1779.83,71685,61232,15621,24253,39874,21358,2022,'CANANEIA',Cananéia,'SP',3509908,3327.0,3327,277.2,277.2,1,264.0,264.0,Pequeno I
3370,3380,350995,3046,2847,262,1853,2115,732,2884.33,2706.25,277.42,1754.92,2032.33,673.92,34612,32475,3329,21059,24388,8087,2022,'CANAS',Canas,'SP',3509957,1559.0,1559,194.9,194.9,1,,,Pequeno I
3371,3381,351000,9980,7112,1590,2019,3609,3503,9064.83,6783.83,1549.42,2150.67,3700.08,3083.75,108778,81406,18593,25808,44401,37005,2022,'CANDIDO MOTA',Cândido Mota,'SP',3510005,13449.0,17852,1120.8,1487.7,1,1287.0,1287.0,Pequeno II
3372,3382,351010,1184,829,148,383,531,298,1087.17,797.42,133.5,362.33,495.83,301.58,13046,9569,1602,4348,5950,3619,2022,'CANDIDO RODRIGUES',Cândido Rodrigues,'SP',3510104,5232.0,5232,436.0,436.0,1,330.0,330.0,Pequeno I
3373,3383,351015,3432,2964,604,1089,1693,1271,3174.42,2786.75,536.75,1105.25,1642.0,1144.75,38093,33441,6441,13263,19704,13737,2022,'CANITAR',Canitar,'SP',3510153,6826.0,6826,568.8,568.8,1,540.0,540.0,Pequeno I
3374,3384,351020,26197,21680,4301,10242,14543,7137,25526.5,21499.92,4385.33,10246.58,14631.92,6868.0,306318,257999,52624,122959,175583,82416,2022,'CAPAO BONITO',Capão Bonito,'SP',3510203,7179.0,7179,598.2,598.2,1,419.0,419.0,Pequeno II
3375,3386,351040,16027,14145,662,11099,11761,2384,14569.0,13064.0,612.67,10457.25,11069.92,1994.08,174828,156768,7352,125487,132839,23929,2022,'CAPIVARI',Capivari,'SP',3510401,11155.0,11155,929.6,929.6,2,635.0,635.0,Pequeno II
3376,3387,351050,52809,44618,7945,23485,31430,13188,48369.83,41009.75,7001.33,21644.5,28645.83,12363.92,580438,492117,84016,259734,343750,148367,2022,'CARAGUATATUBA',Caraguatatuba,'SP',3510500,82466.0,115198,6872.2,9599.8,6,6386.0,6386.0,Grande
3377,3388,351060,149741,125143,12322,82588,94910,30233,140001.58,118013.92,11276.67,78786.58,90063.25,27950.67,1680019,1416167,135320,945439,1080759,335408,2022,'CARAPICUIBA',Carapicuíba,'SP',3510609,24955.0,24955,2079.6,2079.6,5,1938.0,1938.0,Grande
3378,3389,351070,4320,3059,859,513,1372,1687,3978.5,2830.58,808.08,491.67,1299.75,1530.83,47742,33967,9697,5900,15597,18370,2022,'CARDOSO',Cardoso,'SP',3510708,1059.0,1059,132.4,132.4,1,132.0,132.0,Pequeno I
3379,3390,351080,8071,6976,986,4176,5162,1814,7596.0,6593.17,831.75,4196.0,5027.75,1565.42,91152,79118,9981,50352,60333,18785,2022,'CASA BRANCA',Casa Branca,'SP',3510807,1232.0,1232,102.7,102.7,1,21.0,21.0,Pequeno II
3380,3391,351090,1078,895,173,324,497,398,1020.25,861.67,173.0,303.5,476.5,385.17,12243,10340,2076,3642,5718,4622,2022,'CASSIA DOS COQUEIROS',Cássia Dos Coqueiros,'SP',3510906,189.0,189,15.8,15.8,1,11.0,11.0,Pequeno I
3381,3392,351100,9181,6544,1411,2131,3542,3002,8483.42,6276.17,1407.92,2037.42,3445.33,2830.83,101801,75314,16895,24449,41344,33970,2022,'CASTILHO',Castilho,'SP',3511003,8878.0,8878,739.8,739.8,1,747.0,747.0,Pequeno I
3382,3393,351110,18248,14612,2604,7127,9731,4881,17883.25,14151.92,2394.5,6765.08,9159.58,4992.33,214599,169823,28734,81181,109915,59908,2022,'CATANDUVA',Catanduva,'SP',3511102,25587.0,25587,2132.2,2132.2,4,1941.0,1941.0,Grande
3383,3394,351120,2243,1698,310,542,852,846,2137.75,1678.0,301.83,570.08,871.92,806.08,25653,20136,3622,6841,10463,9673,2022,'CATIGUA',Catiguá,'SP',3511201,1792.0,1792,149.3,149.3,1,205.0,205.0,Pequeno I
3384,3395,351130,3741,1982,392,369,761,1221,3457.25,1903.33,360.58,428.75,789.33,1114.0,41487,22840,4327,5145,9472,13368,2022,'CEDRAL',Cedral,'SP',3511300,6644.0,7674,553.7,639.5,1,689.0,689.0,Pequeno I
3385,3396,351140,7413,6115,1429,2279,3708,2407,7035.5,5879.0,1356.25,2376.42,3732.67,2146.33,84426,70548,16275,28517,44792,25756,2022,'CERQUEIRA CESAR',Cerqueira César,'SP',3511409,7155.0,7155,596.2,596.2,2,345.0,345.0,Pequeno I
3386,3397,351150,9747,7510,1317,2668,3985,3525,9302.75,7227.92,1180.0,2555.5,3735.5,3492.42,111633,86735,14160,30666,44826,41909,2022,'CERQUILHO',Cerquilho,'SP',3511508,9489.0,9489,790.8,790.8,2,523.0,523.0,Pequeno II
3387,3398,351160,5021,3824,805,676,1481,2343,4142.83,3306.17,723.83,671.67,1395.5,1910.67,49714,39674,8686,8060,16746,22928,2022,'CESARIO LANGE',Cesário Lange,'SP',3511607,466.0,466,66.6,66.6,1,82.0,82.0,Pequeno I
3388,3399,351170,5046,4496,435,2964,3399,1097,4517.83,4090.25,397.25,2729.25,3126.5,963.75,54214,49083,4767,32751,37518,11565,2022,'CHARQUEADA',Charqueada,'SP',3511706,1029.0,1029,102.9,102.9,1,25.0,25.0,Pequeno I
3389,3400,351190,3264,2473,581,685,1266,1207,3110.67,2413.92,533.5,766.5,1300.0,1113.92,37328,28967,6402,9198,15600,13367,2022,'CLEMENTINA',Clementina,'SP',3511904,836.0,836,69.7,69.7,1,60.0,60.0,Pequeno I
3390,3401,351200,4563,3789,412,2313,2725,1064,4372.5,3701.0,328.33,2441.42,2769.75,931.25,52470,44412,3940,29297,33237,11175,2022,'COLINA',Colina,'SP',3512001,3083.0,3083,256.9,256.9,1,233.0,233.0,Pequeno I
3391,3402,351210,4378,3243,270,1836,2106,1137,4156.5,3102.25,271.83,1693.92,1965.75,1136.5,49878,37227,3262,20327,23589,13638,2022,'COLOMBIA',Colômbia,'SP',3512100,3574.0,3574,297.8,297.8,1,354.0,354.0,Pequeno I
3392,3403,351220,11689,10520,1097,6779,7876,2644,10812.17,9876.92,921.92,6704.17,7626.08,2250.83,129746,118523,11063,80450,91513,27010,2022,'CONCHAL',Conchal,'SP',3512209,3981.0,3981,331.8,331.8,1,335.0,335.0,Pequeno II
3393,3404,351230,6758,5645,1143,2281,3424,2221,6197.08,5253.92,1013.25,2342.17,3355.42,1898.5,74365,63047,12159,28106,40265,22782,2022,'CONCHAS',Conchas,'SP',3512308,1866.0,1866,155.5,155.5,1,121.0,121.0,Pequeno I
3394,3405,351240,7208,5018,1312,1045,2357,2661,6915.17,4900.17,1228.92,1308.5,2537.42,2362.75,82982,58802,14747,15702,30449,28353,2022,'CORDEIROPOLIS',Cordeirópolis,'SP',3512407,8173.0,8173,743.0,743.0,2,719.0,719.0,Pequeno II
3395,3406,351250,3263,2192,306,705,1011,1181,3164.92,2168.67,265.33,783.75,1049.08,1119.58,37979,26024,3184,9405,12589,13435,2022,'COROADOS',Coroados,'SP',3512506,3214.0,3214,267.8,267.8,1,253.0,253.0,Pequeno I
3396,3407,351260,2438,1873,380,674,1054,819,2431.58,1923.25,390.67,704.67,1095.33,827.92,29179,23079,4688,8456,13144,9935,2022,'CORONEL MACEDO',Coronel Macedo,'SP',3512605,6981.0,6981,581.8,581.8,1,337.0,337.0,Pequeno I
3397,3408,351270,1687,1299,146,517,663,636,1599.17,1235.83,153.25,500.83,654.08,581.75,19190,14830,1839,6010,7849,6981,2022,'CORUMBATAI',Corumbataí,'SP',3512704,2497.0,2497,227.0,227.0,1,280.0,280.0,Pequeno I
3398,3409,351280,12597,10316,2390,3757,6147,4169,11615.5,9720.75,2053.17,3894.17,5947.33,3773.42,139386,116649,24638,46730,71368,45281,2022,'COSMOPOLIS',Cosmópolis,'SP',3512803,7181.0,7181,598.4,598.4,3,497.0,497.0,Médio
3399,3410,351290,4204,3161,329,2130,2459,702,3874.33,2954.42,340.92,1907.75,2248.67,705.75,46492,35453,4091,22893,26984,8469,2022,'COSMORAMA',Cosmorama,'SP',3512902,3878.0,3878,323.2,323.2,1,430.0,430.0,Pequeno I
3400,3411,351300,70994,57243,11211,25906,37117,20126,62731.92,50650.92,9473.5,23349.25,32822.75,17828.17,752783,607811,113682,280191,393873,213938,2022,'COTIA',Cotia,'SP',3513009,51831.0,51831,4319.2,4319.2,6,4846.0,4846.0,Grande
3401,3412,351310,10849,9033,553,6372,6925,2108,9883.67,8348.58,529.08,5927.25,6456.33,1892.25,118604,100183,6349,71127,77476,22707,2022,'CRAVINHOS',Cravinhos,'SP',3513108,5752.0,5752,479.3,479.3,1,611.0,611.0,Pequeno II
3402,3413,351320,2744,2145,377,508,885,1260,2800.33,2253.75,436.17,600.0,1036.17,1217.58,33604,27045,5234,7200,12434,14611,2022,'CRISTAIS PAULISTA',Cristais Paulista,'SP',3513207,1079.0,1079,134.9,134.9,1,144.0,144.0,Pequeno I
3403,3414,351330,1072,815,63,418,481,334,1262.0,1021.83,81.92,621.17,703.08,318.75,15144,12262,983,7454,8437,3825,2022,'CRUZALIA',Cruzália,'SP',3513306,707.0,707,58.9,58.9,1,21.0,21.0,Pequeno I
3404,3415,351340,24207,21335,4212,11960,16172,5163,21593.58,19168.17,3840.67,10405.92,14246.58,4921.58,259123,230018,46088,124871,170959,59059,2022,'CRUZEIRO',Cruzeiro,'SP',3513405,20485.0,20485,1707.1,1707.1,2,782.0,782.0,Médio
3405,3416,351350,39412,34467,2938,25022,27960,6507,35345.58,31297.25,2446.25,23133.25,25579.5,5717.75,424147,375567,29355,277599,306954,68613,2022,'CUBATAO',Cubatão,'SP',3513504,17503.0,17503,1591.2,1591.2,4,1215.0,1215.0,Grande
3406,3417,351360,12083,10715,2187,5122,7309,3406,11474.5,10276.5,2200.42,4856.25,7056.67,3219.83,137694,123318,26405,58275,84680,38638,2022,'CUNHA',Cunha,'SP',3513603,5625.0,5625,468.8,468.8,1,189.0,189.0,Pequeno II
3407,3418,351370,6701,4869,1199,910,2109,2760,6410.25,4860.58,1238.5,1173.0,2411.5,2449.08,76923,58327,14862,14076,28938,29389,2022,'DESCALVADO',Descalvado,'SP',3513702,2785.0,2785,232.1,232.1,1,253.0,253.0,Pequeno II
3408,3419,351380,136963,108448,12368,66135,78503,29945,126829.08,101573.0,11719.0,60921.17,72640.17,28932.83,1521949,1218876,140628,731054,871682,347194,2022,'DIADEMA',Diadema,'SP',3513801,69449.0,69449,5787.4,5787.4,5,3514.0,3514.0,Grande
3409,3420,351385,1165,591,88,245,333,258,1135.67,580.83,84.33,207.17,291.5,289.33,13628,6970,1012,2486,3498,3472,2022,'DIRCE REIS',Dirce Reis,'SP',3513850,2023.0,2023,168.6,168.6,1,177.0,177.0,Pequeno I
3410,3421,351390,4005,3264,203,2527,2730,534,3715.75,2964.08,271.0,2080.33,2351.33,612.75,44589,35569,3252,24964,28216,7353,2022,'DIVINOLANDIA',Divinolândia,'SP',3513900,681.0,681,75.7,75.7,1,55.0,55.0,Pequeno I
3411,3422,351400,3709,3132,475,1575,2050,1082,3291.33,2841.83,346.25,1648.67,1994.92,846.92,39496,34102,4155,19784,23939,10163,2022,'DOBRADA',Dobrada,'SP',3514007,3483.0,3483,290.2,290.2,1,298.0,298.0,Pequeno I
3412,3423,351410,8629,7036,1337,2882,4219,2817,8115.33,6659.75,1173.5,2782.17,3955.67,2704.08,97384,79917,14082,33386,47468,32449,2022,'DOIS CORREGOS',Dois Córregos,'SP',3514106,1762.0,1762,146.8,146.8,1,140.0,140.0,Pequeno II
3413,3424,351420,1413,1007,118,562,680,327,1341.08,952.67,106.83,537.17,644.0,308.67,16093,11432,1282,6446,7728,3704,2022,'DOLCINOPOLIS',Dolcinópolis,'SP',3514205,1255.0,1255,104.6,104.6,1,32.0,32.0,Pequeno I
3414,3425,351430,3083,2711,207,1935,2142,569,2886.67,2555.25,171.5,1848.5,2020.0,535.25,34640,30663,2058,22182,24240,6423,2022,'DOURADO',Dourado,'SP',3514304,1263.0,1263,180.4,180.4,1,,,Pequeno I
3415,3426,351440,11119,8214,1559,2168,3727,4487,10321.67,7755.42,1568.33,2030.33,3598.67,4156.75,123860,93065,18820,24364,43184,49881,2022,'DRACENA',Dracena,'SP',3514403,5567.0,5567,506.1,506.1,1,517.0,517.0,Pequeno II
3416,3427,351450,5292,4113,991,872,1863,2250,5081.75,4013.58,940.0,798.67,1738.67,2274.92,60981,48163,11280,9584,20864,27299,2022,'DUARTINA',Duartina,'SP',3514502,1269.0,1269,105.8,105.8,1,195.0,195.0,Pequeno I
3417,3428,351460,3077,2719,415,1598,2013,706,2792.5,2472.08,359.92,1512.83,1872.75,599.33,33510,29665,4319,18154,22473,7192,2022,'DUMONT',Dumont,'SP',3514601,5556.0,5556,505.1,505.1,1,532.0,532.0,Pequeno I
3418,3429,351470,3649,3076,246,1886,2132,944,3448.42,2961.83,234.42,1885.33,2119.75,842.08,41381,35542,2813,22624,25437,10105,2022,'ECHAPORA',Echaporã,'SP',3514700,3168.0,3168,264.0,264.0,1,256.0,256.0,Pequeno I
3419,3430,351480,8167,7123,1347,3245,4592,2531,7791.5,6851.75,1296.33,3099.67,4396.0,2455.75,93498,82221,15556,37196,52752,29469,2022,'ELDORADO',Eldorado,'SP',3514809,7362.0,7362,613.5,613.5,1,536.0,536.0,Pequeno I
3420,3431,351490,7272,6555,301,5046,5347,1208,6652.92,6051.58,301.75,4725.33,5027.08,1024.5,79835,72619,3621,56704,60325,12294,2022,'ELIAS FAUSTO',Elias Fausto,'SP',3514908,2200.0,2200,244.4,244.4,1,69.0,69.0,Pequeno I
3421,3432,351492,1071,938,26,706,732,206,1029.25,911.0,20.0,690.33,710.33,200.67,12351,10932,240,8284,8524,2408,2022,'ELISIARIO',Elisiário,'SP',3514924,1170.0,1170,97.5,97.5,1,87.0,87.0,Pequeno I
3422,3433,351495,695,587,57,307,364,223,630.75,539.5,47.08,304.33,351.42,188.08,7569,6474,565,3652,4217,2257,2022,'EMBAUBA',Embaúba,'SP',3514957,445.0,445,44.5,44.5,1,,,Pequeno I
3423,3434,351500,125570,105696,14429,66349,80778,24918,114105.08,96671.0,12799.42,60525.67,73325.08,23345.92,1369261,1160052,153593,726308,879901,280151,2022,'EMBU DAS ARTES',Embu,'SP',3515004,92622.0,92622,7718.5,7718.5,9,7330.0,7330.0,Grande
3424,3435,351510,38856,31696,3843,19723,23566,8130,35997.58,29538.17,3529.67,18563.92,22093.58,7444.58,431971,354458,42356,222767,265123,89335,2022,'EMBU-GUACU',Embu-guaçu,'SP',3515103,19728.0,19728,1644.0,1644.0,3,1173.0,1173.0,Médio
3425,3436,351512,1477,1095,231,318,549,546,1424.42,1101.42,219.08,366.83,585.92,515.5,17093,13217,2629,4402,7031,6186,2022,'EMILIANOPOLIS',Emilianópolis,'SP',3515129,716.0,716,59.7,59.7,1,22.0,22.0,Pequeno I
3426,3437,351515,9172,6499,1326,1624,2950,3549,8570.67,6293.25,1287.08,1740.08,3027.17,3266.08,102848,75519,15445,20881,36326,39193,2022,'ENGENHEIRO COELHO',Engenheiro Coelho,'SP',3515152,2655.0,2655,221.2,221.2,1,192.0,192.0,Pequeno I
3427,3438,351518,6300,4712,886,1652,2538,2174,6758.42,5145.75,842.83,2098.83,2941.67,2204.08,81101,61749,10114,25186,35300,26449,2022,'ESPIRITO SANTO DO PINHAL',Espírito Santo do Pinhal,'SP',3515186,4212.0,4212,351.0,351.0,1,339.0,339.0,Pequeno II
3428,3439,351519,1970,1379,332,258,590,789,1887.67,1380.33,295.33,244.75,540.08,840.25,22652,16564,3544,2937,6481,10083,2022,'ESPIRITO SANTO DO TURVO',Espírito Santo do Turvo,'SP',3515194,960.0,960,80.0,80.0,1,45.0,45.0,Pequeno I
3429,3440,351520,3522,2046,271,839,1110,936,3477.83,2008.58,254.42,867.5,1121.92,886.67,41734,24103,3053,10410,13463,10640,2022,'ESTRELA DOESTE',Estrela D´oeste,'SP',3515202,2156.0,2156,179.7,179.7,1,234.0,234.0,Pequeno I
3430,3442,351535,4920,3773,633,1569,2202,1571,4738.08,3772.58,627.08,1734.5,2361.58,1411.0,56857,45271,7525,20814,28339,16932,2022,'EUCLIDES DA CUNHA PAULISTA,Euclides da Cunha Paulista,'SP',3515350,1413.0,1413,117.8,117.8,1,43.0,43.0,Pequeno I
3431,3443,351540,7524,5699,690,2643,3333,2366,7334.17,5648.0,699.58,2562.75,3262.33,2385.67,88010,67776,8395,30753,39148,28628,2022,'FARTURA',Fartura,'SP',3515400,6433.0,6433,536.1,536.1,2,456.0,456.0,Pequeno I
3432,3444,351550,22177,17102,2186,8691,10877,6225,20721.08,16170.83,1860.67,8505.0,10365.67,5805.17,248653,194050,22328,102060,124388,69662,2022,'FERNANDOPOLIS',Fernandópolis,'SP',3515509,47189.0,47189,3932.4,3932.4,4,3193.0,3193.0,Médio
3433,3445,351560,1750,1444,300,467,767,677,1600.58,1367.58,346.33,416.75,763.08,604.5,19207,16411,4156,5001,9157,7254,2022,'FERNANDO PRESTES',Fernando Prestes,'SP',3515608,1573.0,1573,131.1,131.1,1,83.0,83.0,Pequeno I
3434,3446,351565,872,728,129,248,377,351,792.83,684.83,156.58,192.42,349.0,335.83,9514,8218,1879,2309,4188,4030,2022,'FERNAO',Fernão,'SP',3515657,1116.0,1116,93.0,93.0,1,87.0,87.0,Pequeno I
3435,3447,351570,71682,59963,5561,38764,44325,15638,66214.92,55573.83,5411.58,35308.92,40720.5,14853.33,794579,666886,64939,423707,488646,178240,2022,'FERRAZ DE VASCONCELOS',Ferraz de Vasconcelos,'SP',3515707,36978.0,36978,3081.5,3081.5,4,2369.0,2369.0,Grande
3436,3449,351590,1235,771,68,371,439,332,1215.08,760.33,73.42,392.75,466.17,294.17,14581,9124,881,4713,5594,3530,2022,'FLOREAL',Floreal,'SP',3515905,386.0,386,32.2,32.2,1,26.0,26.0,Pequeno I
3437,3450,351600,4198,3411,603,1415,2018,1393,4001.67,3324.92,542.83,1556.83,2099.67,1225.25,48020,39899,6514,18682,25196,14703,2022,'FLORIDA PAULISTA',Flórida Paulista,'SP',3516002,464.0,464,42.2,42.2,1,36.0,36.0,Pequeno I
3438,3451,351610,1853,1318,150,665,815,503,1857.08,1360.67,127.0,710.0,837.0,523.67,22285,16328,1524,8520,10044,6284,2022,'FLORINIA',Florínia,'SP',3516101,5990.0,9296,544.5,845.1,1,917.0,917.0,Pequeno I
3439,3452,351620,76950,63632,10852,27678,38530,25102,71383.0,59637.92,10165.83,26737.5,36903.33,22734.58,856596,715655,121990,320850,442840,272815,2022,'FRANCA',Franca,'SP',3516200,22892.0,22892,1907.7,1907.7,5,1713.0,1713.0,Grande
3440,3453,351630,88290,76969,7590,51937,59527,17442,82820.17,72654.58,7588.33,48749.08,56337.42,16317.17,993842,871855,91060,584989,676049,195806,2022,'FRANCISCO MORATO',Francisco Morato,'SP',3516309,48026.0,48026,4002.2,4002.2,5,2926.0,2926.0,Grande
3441,3454,351640,60147,51716,4097,35786,39883,11833,54517.58,47022.08,3854.83,32327.17,36182.0,10840.08,654211,564265,46258,387926,434184,130081,2022,'FRANCO DA ROCHA',Franco da Rocha,'SP',3516408,50802.0,55036,4233.5,4586.3,4,3056.0,3056.0,Grande
3442,3455,351650,1236,632,126,120,246,386,1151.42,659.5,113.58,150.08,263.67,395.83,13817,7914,1363,1801,3164,4750,2022,'GABRIEL MONTEIRO',Gabriel Monteiro,'SP',3516507,1323.0,1323,110.2,110.2,1,35.0,35.0,Pequeno I
3443,3456,351660,2079,1542,282,355,637,905,2087.67,1572.92,284.08,330.5,614.58,958.33,25052,18875,3409,3966,7375,11500,2022,'GALIA',Gália,'SP',3516606,2584.0,2584,258.4,258.4,1,448.0,448.0,Pequeno I
3444,3457,351670,19736,13939,2889,5360,8249,5690,18624.17,13495.08,2730.25,5250.58,7980.83,5514.25,223490,161941,32763,63007,95770,66171,2022,'GARCA',Garça,'SP',3516705,4728.0,4728,394.0,394.0,2,356.0,356.0,Pequeno II
3445,3458,351680,1336,994,208,253,461,533,1311.25,985.17,193.08,234.0,427.08,558.08,15735,11822,2317,2808,5125,6697,2022,'GASTAO VIDIGAL',Gastão Vidigal,'SP',3516804,535.0,535,44.6,44.6,1,15.0,15.0,Pequeno I
3446,3459,351685,1529,1327,249,466,715,612,1398.17,1231.83,260.67,448.08,708.75,523.08,16778,14782,3128,5377,8505,6277,2022,'GAVIAO PEIXOTO',Gavião Peixoto,'SP',3516853,3755.0,3755,312.9,312.9,1,306.0,306.0,Pequeno I
3447,3460,351690,3554,2362,315,913,1228,1134,3376.5,2302.92,307.25,962.83,1270.08,1032.83,40518,27635,3687,11554,15241,12394,2022,'GENERAL SALGADO',General Salgado,'SP',3516903,660.0,660,55.0,55.0,1,55.0,55.0,Pequeno I
3448,3461,351700,3919,3163,644,1508,2152,1011,3706.67,3023.83,596.33,1475.58,2071.92,951.92,44480,36286,7156,17707,24863,11423,2022,'GETULINA',Getulina,'SP',3517000,1016.0,1016,101.6,101.6,1,69.0,69.0,Pequeno I
3449,3462,351710,2337,1909,190,964,1154,755,2281.67,1893.67,192.75,999.67,1192.42,701.25,27380,22724,2313,11996,14309,8415,2022,'GLICERIO',Glicério,'SP',3517109,2754.0,2754,229.5,229.5,1,125.0,125.0,Pequeno I
3450,3463,351720,4667,3682,663,1572,2235,1447,4362.25,3462.33,593.75,1493.25,2087.0,1375.33,52347,41548,7125,17919,25044,16504,2022,'GUAICARA',Guaiçara,'SP',3517208,2383.0,2383,198.6,198.6,1,202.0,202.0,Pequeno I
3451,3464,351730,2956,2577,202,1497,1699,878,2806.0,2483.75,217.5,1456.42,1673.92,809.83,33672,29805,2610,17477,20087,9718,2022,'GUAIMBE',Guaimbê,'SP',3517307,1343.0,1343,111.9,111.9,1,108.0,108.0,Pequeno I
3452,3465,351740,9932,8509,1265,4580,5845,2664,9459.33,8150.58,1268.83,4275.5,5544.33,2606.25,113512,97807,15226,51306,66532,31275,2022,'GUAIRA',Guaíra,'SP',3517406,7574.0,7574,688.5,688.5,3,911.0,911.0,Pequeno II
3453,3466,351750,5629,4028,574,1826,2400,1628,4846.75,3513.08,532.08,1578.0,2110.08,1403.0,58161,42157,6385,18936,25321,16836,2022,'GUAPIACU',Guapiaçu,'SP',3517505,2866.0,2866,477.7,477.7,1,349.0,349.0,Pequeno I
3454,3467,351760,10598,8724,1745,3793,5538,3186,10155.08,8429.58,1747.0,3651.17,5398.17,3031.42,121861,101155,20964,43814,64778,36377,2022,'GUAPIARA',Guapiara,'SP',3517604,6485.0,7622,540.4,635.2,1,236.0,236.0,Pequeno I
3455,3468,351770,6400,5556,1415,2742,4157,1399,6084.17,5343.5,1088.0,2910.33,3998.33,1345.17,73010,64122,13056,34924,47980,16142,2022,'GUARA',Guará,'SP',3517703,2476.0,2476,247.6,247.6,1,238.0,238.0,Pequeno I
3456,3469,351780,3347,2223,309,841,1150,1073,3295.25,2304.33,343.75,889.5,1233.25,1071.08,39543,27652,4125,10674,14799,12853,2022,'GUARACAI',Guaraçaí,'SP',3517802,1358.0,1358,113.2,113.2,1,124.0,124.0,Pequeno I
3457,3470,351790,4259,3587,576,2088,2664,923,3939.33,3403.75,481.67,2093.0,2574.67,829.08,47272,40845,5780,25116,30896,9949,2022,'GUARACI',Guaraci,'SP',3517901,3347.0,3347,278.9,278.9,1,118.0,118.0,Pequeno I
3458,3471,351800,1230,736,98,238,336,400,1252.5,773.83,103.17,266.33,369.5,404.33,15030,9286,1238,3196,4434,4852,2022,'GUARANI DOESTE',Guarani D´oeste,'SP',3518008,1185.0,1185,107.7,107.7,1,48.0,48.0,Pequeno I
3459,3472,351810,3413,3037,785,1296,2081,956,3231.33,2905.0,519.25,1525.92,2045.17,859.83,38776,34860,6231,18311,24542,10318,2022,'GUARANTA',Guarantã,'SP',3518107,299.0,299,24.9,24.9,1,18.0,18.0,Pequeno I
3460,3473,351820,9801,7905,1797,2682,4479,3426,8912.0,7243.17,1775.75,2211.17,3986.92,3256.25,106944,86918,21309,26534,47843,39075,2022,'GUARARAPES',Guararapes,'SP',3518206,6782.0,6782,565.2,565.2,1,697.0,697.0,Pequeno II
3461,3474,351830,15011,12513,1188,7828,9016,3497,13867.17,11696.67,1154.83,7208.0,8362.83,3333.83,166406,140360,13858,86496,100354,40006,2022,'GUARAREMA',Guararema,'SP',3518305,1948.0,1948,162.3,162.3,1,151.0,151.0,Pequeno II
3462,3475,351840,30504,25800,2910,15031,17941,7859,27888.0,23647.08,2932.92,13277.83,16210.75,7436.33,334656,283765,35195,159334,194529,89236,2022,'GUARATINGUETA',Guaratinguetá,'SP',3518404,42625.0,42625,3552.1,3552.1,4,2258.0,2258.0,Grande
3463,3476,351850,4943,3593,679,889,1568,2025,4649.08,3478.33,649.92,978.75,1628.67,1849.67,55789,41740,7799,11745,19544,22196,2022,'GUAREI',Guareí,'SP',3518503,6132.0,6132,766.5,766.5,1,,,Pequeno I
3464,3477,351860,9115,7773,2003,3550,5553,2220,8512.25,7268.17,1235.92,4039.5,5275.42,1992.75,102147,87218,14831,48474,63305,23913,2022,'GUARIBA',Guariba,'SP',3518602,1895.0,1895,157.9,157.9,1,235.0,235.0,Pequeno II
3465,3478,351870,82078,69325,15043,32175,47218,22107,73283.25,62042.75,13546.25,28727.83,42274.08,19768.67,879399,744513,162555,344734,507289,237224,2022,'GUARUJA',Guarujá,'SP',3518701,55425.0,55425,4618.8,4618.8,4,4179.0,4179.0,Grande
3466,3479,351880,489730,414508,69721,240784,310505,104003,436060.67,369820.58,64175.75,209198.92,273374.67,96445.92,5232728,4437847,770109,2510387,3280496,1157351,2022,'GUARULHOS',Guarulhos,'SP',3518800,305394.0,348166,25449.5,29013.8,12,19651.0,19651.0,Metrópole
3467,3480,351885,3054,2684,170,1882,2052,632,2807.67,2464.42,185.5,1678.08,1863.58,600.83,33692,29573,2226,20137,22363,7210,2022,'GUATAPARA',Guatapará,'SP',3518859,3137.0,3137,285.2,285.2,1,179.0,179.0,Pequeno I
3468,3481,351890,2527,1908,388,381,769,1139,2461.08,1897.0,409.58,389.83,799.42,1097.58,29533,22764,4915,4678,9593,13171,2022,'GUZOLANDIA',Guzolândia,'SP',3518909,1928.0,1928,175.3,175.3,1,,,Pequeno I
3469,3482,351900,3885,3323,288,2111,2399,924,3611.83,3112.58,277.33,1972.08,2249.42,863.17,43342,37351,3328,23665,26993,10358,2022,'HERCULANDIA',Herculândia,'SP',3519006,583.0,583,48.6,48.6,1,26.0,26.0,Pequeno I
3470,3483,351905,2038,1642,214,614,828,814,1689.67,1378.83,175.25,574.0,749.25,629.58,20276,16546,2103,6888,8991,7555,2022,'HOLAMBRA',Holambra,'SP',3519055,560.0,560,140.0,140.0,1,,,Pequeno I
3471,3484,351907,71636,60581,7475,36582,44057,16524,65472.83,56014.92,6487.0,35163.08,41650.08,14364.83,785674,672179,77844,421957,499801,172378,2022,'HORTOLANDIA',Hortolândia,'SP',3519071,49928.0,49928,4160.7,4160.7,4,3329.0,3329.0,Grande
3472,3485,351910,5054,3938,436,2044,2480,1458,4770.83,3719.33,366.17,1943.17,2309.33,1410.0,57250,44632,4394,23318,27712,16920,2022,'IACANGA',Iacanga,'SP',3519105,1528.0,1528,127.3,127.3,1,85.0,85.0,Pequeno I
3473,3486,351920,2753,2257,376,868,1244,1013,2610.83,2174.5,354.25,841.67,1195.92,978.58,31330,26094,4251,10100,14351,11743,2022,'IACRI',Iacri,'SP',3519204,838.0,838,69.8,69.8,1,33.0,33.0,Pequeno I
3474,3487,351925,3046,2596,312,1382,1694,902,2819.25,2419.33,329.92,1307.92,1637.83,781.5,33831,29032,3959,15695,19654,9378,2022,'IARAS',Iaras,'SP',3519253,6380.0,6380,531.7,531.7,1,215.0,215.0,Pequeno I
3475,3488,351930,12661,11789,1341,9089,10430,1359,10955.25,10229.42,1078.83,7883.5,8962.33,1267.08,131463,122753,12946,94602,107548,15205,2022,'IBATE',Ibaté,'SP',3519303,1255.0,1255,156.9,156.9,1,168.0,168.0,Pequeno II
3476,3489,351940,3339,2647,525,1079,1604,1043,3120.25,2517.25,456.17,1159.0,1615.17,902.08,37443,30207,5474,13908,19382,10825,2022,'IBIRA',Ibirá,'SP',3519402,1642.0,1642,136.8,136.8,1,61.0,61.0,Pequeno I
3477,3490,351950,4133,3454,217,2385,2602,852,4055.67,3429.83,196.25,2398.92,2595.17,834.67,48668,41158,2355,28787,31142,10016,2022,'IBIRAREMA',Ibirarema,'SP',3519501,2119.0,2119,176.6,176.6,1,100.0,100.0,Pequeno I
3478,3491,351960,16448,13510,3447,5164,8611,4899,14906.5,12326.08,2995.25,5007.33,8002.58,4323.5,178878,147913,35943,60088,96031,51882,2022,'IBITINGA',Ibitinga,'SP',3519600,8336.0,8336,694.7,694.7,1,351.0,351.0,Médio
3479,3492,351970,33054,29384,4270,18345,22615,6769,28301.25,25125.5,3921.83,15057.5,18979.33,6146.17,339615,301506,47062,180690,227752,73754,2022,'IBIUNA',Ibiúna,'SP',3519709,17586.0,51204,1465.5,4267.0,3,521.0,3521.0,Médio
3480,3493,351980,3043,2275,370,1027,1397,878,2838.17,2176.92,327.42,1121.17,1448.58,728.33,34058,26123,3929,13454,17383,8740,2022,'ICEM',Icém,'SP',3519808,1276.0,1276,106.3,106.3,1,74.0,74.0,Pequeno I
3481,3494,351990,3963,3278,202,1604,1806,1472,3823.5,3182.17,200.67,1512.92,1713.58,1468.58,45882,38186,2408,18155,20563,17623,2022,'IEPE',Iepê,'SP',3519907,149.0,149,13.5,13.5,1,,,Pequeno I
3482,3495,352000,8730,7709,807,4939,5746,1963,8356.92,7502.08,803.5,4821.17,5624.67,1877.42,100283,90025,9642,57854,67496,22529,2022,'IGARACU DO TIETE',Igaraçu do Tietê,'SP',3520004,4973.0,4973,414.4,414.4,1,424.0,424.0,Pequeno II
3483,3496,352010,7176,6190,1819,1734,3553,2637,6854.42,6023.5,1762.83,1722.08,3484.92,2538.58,82253,72282,21154,20665,41819,30463,2022,'IGARAPAVA',Igarapava,'SP',3520103,1789.0,1789,149.1,149.1,1,136.0,136.0,Pequeno II
3484,3497,352020,5182,4379,725,2253,2978,1401,4668.58,4011.5,716.58,2007.25,2723.83,1287.67,56023,48138,8599,24087,32686,15452,2022,'IGARATA',Igaratá,'SP',3520202,2074.0,2074,188.5,188.5,1,57.0,57.0,Pequeno I
3485,3498,352030,18334,15935,2232,9888,12120,3815,17281.42,15080.67,2203.17,9062.17,11265.33,3815.33,207377,180968,26438,108746,135184,45784,2022,'IGUAPE',Iguape,'SP',3520301,2924.0,2924,243.7,243.7,1,175.0,175.0,Pequeno II
3486,3499,352040,13232,10365,1891,3577,5468,4897,12072.92,9520.5,1700.5,3266.5,4967.0,4553.5,144875,114246,20406,39198,59604,54642,2022,'ILHABELA',Ilhabela,'SP',3520400,11009.0,11009,1000.8,1000.8,1,1314.0,1314.0,Pequeno II
3487,3500,352042,10333,8154,1018,5188,6206,1948,9206.17,7312.0,1035.75,4295.42,5331.17,1980.83,110474,87744,12429,51545,63974,23770,2022,'ILHA COMPRIDA',Ilha Comprida,'SP',3520426,4497.0,12140,374.8,1011.7,1,0.0,1010.0,Pequeno I
3488,3501,352044,6385,4435,777,862,1639,2796,6282.5,4493.75,817.67,904.0,1721.67,2772.08,75390,53925,9812,10848,20660,33265,2022,'ILHA SOLTEIRA',Ilha Solteira,'SP',3520442,5226.0,5226,435.5,435.5,1,436.0,436.0,Pequeno II
3489,3502,352050,41989,31593,9672,5812,15484,16109,40515.67,30845.67,8598.58,6354.25,14952.83,15892.83,486188,370148,103183,76251,179434,190714,2022,'INDAIATUBA',Indaiatuba,'SP',3520509,23474.0,23474,1956.2,1956.2,6,1395.0,1395.0,Grande
3490,3503,352060,2365,1935,386,834,1220,715,2253.75,1883.0,355.0,781.58,1136.58,746.42,27045,22596,4260,9379,13639,8957,2022,'INDIANA',Indiana,'SP',3520608,984.0,984,123.0,123.0,1,179.0,179.0,Pequeno I
3491,3504,352070,2394,1857,170,966,1136,721,2167.33,1693.58,129.75,919.75,1049.5,644.08,26008,20323,1557,11037,12594,7729,2022,'INDIAPORA',Indiaporã,'SP',3520707,70.0,70,17.5,17.5,1,,,Pequeno I
3492,3505,352080,1378,966,117,267,384,582,1332.83,957.83,112.75,287.42,400.17,557.67,15994,11494,1353,3449,4802,6692,2022,'INUBIA PAULISTA',Inúbia Paulista,'SP',3520806,916.0,916,76.3,76.3,1,57.0,57.0,Pequeno I
3493,3506,352090,5232,4597,630,2082,2712,1885,5051.17,4500.0,600.0,2059.08,2659.08,1840.92,60614,54000,7200,24709,31909,22091,2022,'IPAUSSU',Ipaussu,'SP',3520905,3946.0,3946,328.8,328.8,2,209.0,209.0,Pequeno I
3494,3507,352100,12577,10438,2036,4426,6462,3976,11561.67,9833.83,1912.92,4377.92,6290.83,3543.0,138740,118006,22955,52535,75490,42516,2022,'IPERO',Iperó,'SP',3521002,3122.0,3122,260.2,260.2,1,244.0,244.0,Pequeno II
3495,3508,352110,2382,1911,404,701,1105,806,2203.42,1817.67,372.58,688.25,1060.83,756.83,26441,21812,4471,8259,12730,9082,2022,'IPEUNA',Ipeúna,'SP',3521101,1588.0,1588,144.4,144.4,1,183.0,183.0,Pequeno I
3496,3510,352120,2770,2307,226,1327,1553,754,2725.92,2328.0,241.92,1330.25,1572.17,755.83,32711,27936,2903,15963,18866,9070,2022,'IPORANGA',Iporanga,'SP',3521200,3634.0,3634,302.8,302.8,1,270.0,270.0,Pequeno I
3497,3511,352130,6424,4244,605,1764,2369,1875,6198.0,4284.67,619.42,1753.67,2373.08,1911.58,74376,51416,7433,21044,28477,22939,2022,'IPUA',Ipuã,'SP',3521309,947.0,947,78.9,78.9,1,137.0,137.0,Pequeno I
3498,3512,352140,4276,3341,678,1306,1984,1357,3764.42,2981.33,558.08,1280.08,1838.17,1143.17,45173,35776,6697,15361,22058,13718,2022,'IRACEMAPOLIS',Iracemápolis,'SP',3521408,1530.0,1530,127.5,127.5,1,167.0,167.0,Pequeno II
3499,3513,352150,2605,2117,305,1217,1522,595,2567.5,2127.58,262.83,1330.08,1592.92,534.67,30810,25531,3154,15961,19115,6416,2022,'IRAPUA',Irapuã,'SP',3521507,3149.0,3149,286.3,286.3,1,156.0,156.0,Pequeno I
3500,3514,352160,2721,2170,259,1011,1270,900,2638.83,2141.25,253.92,1058.08,1312.0,829.25,31666,25695,3047,12697,15744,9951,2022,'IRAPURU',Irapuru,'SP',3521606,261.0,261,26.1,26.1,1,32.0,32.0,Pequeno I
3501,3515,352170,9317,7608,1392,3255,4647,2961,8898.83,7500.42,1133.0,3892.08,5025.08,2475.33,106786,90005,13596,46705,60301,29704,2022,'ITABERA',Itaberá,'SP',3521705,938.0,938,78.2,78.2,1,55.0,55.0,Pequeno I
3502,3516,352180,8858,7415,1616,2730,4346,3069,7835.92,6631.75,1476.33,2492.08,3968.42,2663.33,94031,79581,17716,29905,47621,31960,2022,'ITAI',Itaí,'SP',3521804,8565.0,8565,713.8,713.8,2,703.0,703.0,Pequeno II
3503,3517,352190,4851,4199,802,2170,2972,1227,4267.92,3737.92,630.75,2064.67,2695.42,1042.5,51215,44855,7569,24776,32345,12510,2022,'ITAJOBI',Itajobi,'SP',3521903,2730.0,2730,273.0,273.0,1,100.0,100.0,Pequeno I
3504,3518,352200,1234,984,163,318,481,503,1119.92,920.58,137.33,336.0,473.33,447.25,13439,11047,1648,4032,5680,5367,2022,'ITAJU',Itaju,'SP',3522000,103.0,103,8.6,8.6,1,7.0,7.0,Pequeno I
3505,3519,352210,62390,54169,3405,42069,45474,8695,55753.67,48690.0,2946.0,37890.17,40836.17,7853.83,669044,584280,35352,454682,490034,94246,2022,'ITANHAEM',Itanhaém,'SP',3522109,7112.0,7112,592.7,592.7,4,531.0,531.0,Médio
3506,3520,352215,1911,1583,276,792,1068,515,1861.33,1605.5,285.5,830.0,1115.5,490.0,22336,19266,3426,9960,13386,5880,2022,'ITAOCA',Itaóca,'SP',3522158,1405.0,1405,117.1,117.1,1,124.0,124.0,Pequeno I
3507,3521,352220,78577,64643,9676,37214,46890,17753,69685.42,57225.42,8897.83,31570.0,40467.83,16757.58,836225,686705,106774,378840,485614,201091,2022,'ITAPECERICA DA SERRA',Itapecerica da Serra,'SP',3522208,37417.0,37417,3118.1,3118.1,4,2016.0,2016.0,Grande
3508,3522,352230,52700,44770,12286,15202,27488,17282,49400.42,42428.25,11033.25,15246.58,26279.83,16148.42,592805,509139,132399,182959,315358,193781,2022,'ITAPETININGA',Itapetininga,'SP',3522307,26634.0,26634,6658.5,6658.5,4,3851.0,3851.0,Grande
3509,3523,352240,32615,27599,5564,13153,18717,8882,30286.17,25854.17,5195.33,12200.08,17395.42,8458.75,363434,310250,62344,146401,208745,101505,2022,'ITAPEVA',Itapeva,'SP',3522406,49678.0,49678,4139.8,4139.8,3,3334.0,3334.0,Médio
3510,3524,352250,82642,73300,10260,46136,56396,16904,73959.0,65971.75,8416.5,43234.75,51651.25,14320.5,887508,791661,100998,518817,619815,171846,2022,'ITAPEVI',Itapevi,'SP',3522505,57050.0,64892,4754.2,5407.7,4,4261.0,4261.0,Grande
3511,3525,352260,15233,11568,2076,5612,7688,3880,14291.67,10927.25,1736.5,5749.75,7486.25,3441.0,171500,131127,20838,68997,89835,41292,2022,'ITAPIRA',Itapira,'SP',3522604,7742.0,7742,645.2,645.2,3,581.0,581.0,Médio
3512,3526,352265,2908,2720,490,1475,1965,755,2813.33,2640.83,435.08,1528.0,1963.08,677.75,33760,31690,5221,18336,23557,8133,2022,'ITAPIRAPUA PAULISTA',Itapirapuã Paulista,'SP',3522653,1338.0,1338,111.5,111.5,1,70.0,70.0,Pequeno I
3513,3527,352270,6974,5812,1205,2227,3432,2380,5974.42,4995.75,1060.83,1848.33,2909.17,2086.58,71693,59949,12730,22180,34910,25039,2022,'ITAPOLIS',Itápolis,'SP',3522703,6785.0,6785,565.4,565.4,1,499.0,499.0,Pequeno II
3514,3528,352280,6863,5783,870,2984,3854,1929,6528.42,5583.5,761.67,3013.25,3774.92,1808.58,78341,67002,9140,36159,45299,21703,2022,'ITAPORANGA',Itaporanga,'SP',3522802,3044.0,3044,253.7,253.7,1,144.0,144.0,Pequeno I
3515,3530,352300,2901,2009,226,961,1187,822,2729.42,2008.83,238.58,1009.58,1248.17,760.67,32753,24106,2863,12115,14978,9128,2022,'ITAPURA',Itapura,'SP',3523008,1935.0,1935,161.2,161.2,1,181.0,181.0,Pequeno I
3516,3531,352310,127688,108650,18076,63140,81216,27434,120667.75,102528.75,18217.67,56739.92,74957.58,27571.17,1448013,1230345,218612,680879,899491,330854,2022,'ITAQUAQUECETUBA',Itaquaquecetuba,'SP',3523107,48390.0,56107,4032.5,4675.6,5,6877.0,6877.0,Grande
3517,3532,352320,20466,17196,2497,9438,11935,5261,19377.5,16368.17,2366.25,8841.67,11207.92,5160.25,232530,196418,28395,106100,134495,61923,2022,'ITARARE',Itararé,'SP',3523206,13718.0,13718,1143.2,1143.2,2,702.0,702.0,Pequeno II
3518,3533,352330,7689,6704,845,4127,4972,1732,7039.08,6161.08,910.08,3755.33,4665.42,1495.67,84469,73933,10921,45064,55985,17948,2022,'ITARIRI',Itariri,'SP',3523305,2526.0,2526,210.5,210.5,2,240.0,240.0,Pequeno I
3519,3534,352340,23803,19431,3468,9183,12651,6780,20884.33,17339.42,3000.33,8387.08,11387.42,5952.0,250612,208073,36004,100645,136649,71424,2022,'ITATIBA',Itatiba,'SP',3523404,60047.0,60047,5003.9,5003.9,5,4506.0,4506.0,Grande
3520,3535,352350,8010,6764,431,4710,5141,1623,7396.33,6214.0,460.08,4152.5,4612.58,1601.42,88756,74568,5521,49830,55351,19217,2022,'ITATINGA',Itatinga,'SP',3523503,1418.0,1418,118.2,118.2,1,20.0,20.0,Pequeno I
3521,3536,352360,4649,3958,381,2518,2899,1059,4174.42,3588.42,323.33,2433.42,2756.75,831.67,50093,43061,3880,29201,33081,9980,2022,'ITIRAPINA',Itirapina,'SP',3523602,591.0,591,147.8,147.8,1,162.0,162.0,Pequeno I
3522,3537,352370,3383,3026,148,2201,2349,677,3268.67,2982.0,114.58,2288.0,2402.58,579.42,39224,35784,1375,27456,28831,6953,2022,'ITIRAPUA',Itirapuã,'SP',3523701,3483.0,3483,290.2,290.2,1,175.0,175.0,Pequeno I
3523,3538,352380,2898,2369,530,746,1276,1093,2639.75,2206.75,472.33,807.92,1280.25,926.5,31677,26481,5668,9695,15363,11118,2022,'ITOBI',Itobi,'SP',3523800,42.0,42,8.4,8.4,1,,,Pequeno I
3524,3539,352390,41800,32872,5693,17674,23367,9505,41784.58,32627.0,5470.42,17322.58,22793.0,9834.0,501415,391524,65645,207871,273516,118008,2022,'ITU',Itu,'SP',3523909,42176.0,42176,3514.7,3514.7,5,2613.0,2613.0,Grande
3525,3540,352400,12308,10240,2696,3090,5786,4454,11344.33,9742.42,2665.92,3692.67,6358.58,3383.83,136132,116909,31991,44312,76303,40606,2022,'ITUPEVA',Itupeva,'SP',3524006,16109.0,16109,1342.4,1342.4,2,971.0,971.0,Pequeno II
3526,3541,352410,11104,9321,1134,5462,6596,2725,10147.17,8656.75,893.25,5218.58,6111.83,2544.92,121766,103881,10719,62623,73342,30539,2022,'ITUVERAVA',Ituverava,'SP',3524105,4598.0,4598,418.0,418.0,1,174.0,174.0,Pequeno II
3527,3542,352420,2496,1916,382,618,1000,916,2369.08,1868.5,415.5,596.75,1012.25,856.25,28429,22422,4986,7161,12147,10275,2022,'JABORANDI',Jaborandi,'SP',3524204,2282.0,2282,190.2,190.2,1,172.0,172.0,Pequeno I
3528,3543,352430,25079,20404,3077,10911,13988,6416,23409.42,19191.58,2972.75,10199.25,13172.0,6019.58,280913,230299,35673,122391,158064,72235,2022,'JABOTICABAL',Jaboticabal,'SP',3524303,41339.0,44089,3444.9,3674.1,3,1912.0,4662.0,Médio
3529,3544,352440,63336,52134,12310,18297,30607,21527,58743.08,48888.08,11365.33,18359.58,29724.92,19163.17,704917,586657,136384,220315,356699,229958,2022,'JACAREI',Jacareí,'SP',3524402,13832.0,13832,1152.7,1152.7,5,1011.0,1011.0,Grande
3530,3545,352450,2332,1559,273,545,818,741,2172.0,1470.75,230.42,519.92,750.33,720.42,26064,17649,2765,6239,9004,8645,2022,'JACI',Jaci,'SP',3524501,1476.0,1476,123.0,123.0,1,120.0,120.0,Pequeno I
3531,3546,352460,8633,7051,1418,2886,4304,2747,9026.08,7321.5,1428.25,3063.33,4491.58,2829.92,108313,87858,17139,36760,53899,33959,2022,'JACUPIRANGA',Jacupiranga,'SP',3524600,8004.0,8004,667.0,667.0,1,125.0,125.0,Pequeno I
3532,3547,352470,9565,8245,827,4864,5691,2554,9416.25,8069.83,813.67,4874.25,5687.92,2381.92,112995,96838,9764,58491,68255,28583,2022,'JAGUARIUNA',Jaguariúna,'SP',3524709,15810.0,15810,1317.5,1317.5,3,1026.0,1026.0,Pequeno II
3533,3548,352480,12711,9549,1518,4329,5847,3702,11568.92,8797.5,1346.83,4041.08,5387.92,3409.58,138827,105570,16162,48493,64655,40915,2022,'JALES',Jales,'SP',3524808,9289.0,9289,928.9,928.9,1,919.0,919.0,Pequeno II
3534,3549,352490,2708,2318,518,911,1429,889,2576.17,2236.58,452.0,964.25,1416.25,820.33,30914,26839,5424,11571,16995,9844,2022,'JAMBEIRO',Jambeiro,'SP',3524907,2905.0,2905,242.1,242.1,1,350.0,350.0,Pequeno I
3535,3550,352500,34694,26768,11280,3661,14941,11827,31940.92,24918.25,10805.08,3307.58,14112.67,10805.58,383291,299019,129661,39691,169352,129667,2022,'JANDIRA',Jandira,'SP',3525003,25644.0,25644,2137.0,2137.0,4,520.0,520.0,Grande
3536,3551,352510,13857,11838,1404,7587,8991,2847,12580.58,10724.58,1578.0,6211.17,7789.17,2935.42,150967,128695,18936,74534,93470,35225,2022,'JARDINOPOLIS',Jardinópolis,'SP',3525102,2879.0,2879,239.9,239.9,1,225.0,225.0,Pequeno II
3537,3552,352520,9372,7865,1585,3792,5377,2488,8576.92,7297.33,1282.08,3839.5,5121.58,2175.75,102923,87568,15385,46074,61459,26109,2022,'JARINU',Jarinu,'SP',3525201,5837.0,5837,530.6,530.6,1,435.0,435.0,Pequeno II
3538,3553,352530,36016,27811,6215,8632,14847,12964,33384.58,26127.83,5530.17,8484.58,14014.75,12113.08,400615,313534,66362,101815,168177,145357,2022,'JAU',Jaú,'SP',3525300,9200.0,9200,766.7,766.7,4,703.0,703.0,Grande
3539,3554,352540,1801,1435,196,627,823,612,1778.92,1462.5,226.0,568.17,794.17,668.33,21347,17550,2712,6818,9530,8020,2022,'JERIQUARA',Jeriquara,'SP',3525409,330.0,330,27.5,27.5,1,37.0,37.0,Pequeno I
3540,3555,352550,3147,2416,558,794,1352,1064,2948.0,2332.58,483.42,786.25,1269.67,1062.92,35376,27991,5801,9435,15236,12755,2022,'JOANOPOLIS',Joanópolis,'SP',3525508,895.0,895,74.6,74.6,1,30.0,30.0,Pequeno I
3541,3556,352560,2003,1752,157,1156,1313,439,1877.67,1642.58,188.5,1021.92,1210.42,432.17,22532,19711,2262,12263,14525,5186,2022,'JOAO RAMALHO',João Ramalho,'SP',3525607,329.0,329,27.4,27.4,1,16.0,16.0,Pequeno I
3542,3557,352570,6897,5138,1434,420,1854,3284,7057.08,5334.08,1391.17,495.58,1886.75,3447.33,84685,64009,16694,5947,22641,41368,2022,'JOSE BONIFACIO',José Bonifácio,'SP',3525706,10979.0,10979,914.9,914.9,1,875.0,875.0,Pequeno II
3543,3559,352585,1209,976,139,444,583,393,1101.5,902.92,118.67,452.92,571.58,331.33,13218,10835,1424,5435,6859,3976,2022,'JUMIRIM',Jumirim,'SP',3525854,1018.0,1018,92.5,92.5,1,29.0,29.0,Pequeno I
3544,3560,352590,41627,33728,7209,16647,23856,9872,39576.75,31985.75,6806.42,15905.67,22712.08,9273.67,474921,383829,81677,190868,272545,111284,2022,'JUNDIAI',Jundiaí,'SP',3525904,22446.0,22446,1870.5,1870.5,6,1300.0,1300.0,Grande
3545,3561,352600,6036,5256,587,3284,3871,1385,5884.33,5119.33,506.17,3180.42,3686.58,1432.75,70612,61432,6074,38165,44239,17193,2022,'JUNQUEIROPOLIS',Junqueirópolis,'SP',3526001,2041.0,2041,170.1,170.1,1,141.0,141.0,Pequeno I
3546,3562,352610,9061,7610,1391,3435,4826,2784,8358.5,7070.25,1371.58,3210.92,4582.5,2487.75,100302,84843,16459,38531,54990,29853,2022,'JUQUIA',Juquiá,'SP',3526100,6802.0,11982,566.8,998.5,1,617.0,617.0,Pequeno I
3547,3563,352620,17152,14598,3484,6688,10172,4426,16086.0,13840.25,3207.58,6604.5,9812.08,4028.17,193032,166083,38491,79254,117745,48338,2022,'JUQUITIBA',Juquitiba,'SP',3526209,11242.0,11242,936.8,936.8,1,610.0,610.0,Pequeno II
3548,3564,352630,2425,2066,408,946,1354,712,2349.33,2010.17,344.67,969.5,1314.17,696.0,28192,24122,4136,11634,15770,8352,2022,'LAGOINHA',Lagoinha,'SP',3526308,846.0,846,120.9,120.9,1,,,Pequeno I
3549,3565,352640,9858,7826,847,4460,5307,2519,8972.75,7256.42,768.0,4107.25,4875.25,2381.17,107673,87077,9216,49287,58503,28574,2022,'LARANJAL PAULISTA',Laranjal Paulista,'SP',3526407,11639.0,11639,969.9,969.9,2,907.0,907.0,Pequeno II
3550,3566,352650,1829,1327,227,466,693,634,1815.58,1385.17,217.25,514.17,731.42,653.75,21787,16622,2607,6170,8777,7845,2022,'LAVINIA',Lavínia,'SP',3526506,763.0,763,63.6,63.6,1,85.0,85.0,Pequeno I
3551,3567,352660,3649,3152,356,1929,2285,867,3476.67,3081.75,375.5,1874.42,2249.92,831.83,41720,36981,4506,22493,26999,9982,2022,'LAVRINHAS',Lavrinhas,'SP',3526605,4629.0,4629,385.8,385.8,1,383.0,383.0,Pequeno I
3552,3568,352670,33968,26623,5186,11160,16346,10277,31202.08,24640.42,4974.42,10285.0,15259.42,9381.0,374425,295685,59693,123420,183113,112572,2022,'LEME',Leme,'SP',3526704,16327.0,16327,1360.6,1360.6,6,1287.0,1287.0,Médio
3553,3569,352680,11215,8818,2043,3481,5524,3294,10531.75,8283.75,1658.25,3429.25,5087.5,3196.25,126381,99405,19899,41151,61050,38355,2022,'LENCOIS PAULISTA',Lençóis Paulista,'SP',3526803,17494.0,17494,1457.8,1457.8,3,1127.0,1127.0,Médio
3554,3570,352690,79978,68396,3813,48008,51821,16575,75670.58,65226.67,3750.75,45932.92,49683.67,15543.0,908047,782720,45009,551195,596204,186516,2022,'LIMEIRA',Limeira,'SP',3526902,15138.0,15138,1261.5,1261.5,6,1058.0,1058.0,Grande
3555,3571,352700,2382,1952,306,920,1226,726,2091.42,1758.92,329.08,793.67,1122.75,636.17,25097,21107,3949,9524,13473,7634,2022,'LINDOIA',Lindóia,'SP',3527009,2332.0,2332,233.2,233.2,1,281.0,281.0,Pequeno I
3556,3572,352710,16786,13544,3821,5016,8837,4707,15808.0,12806.5,3297.58,5124.0,8421.58,4384.92,189696,153678,39571,61488,101059,52619,2022,'LINS',Lins,'SP',3527108,18576.0,18576,1548.0,1548.0,3,903.0,903.0,Médio
3557,3573,352720,30184,25908,4460,13648,18108,7800,27283.33,23564.42,4629.42,11425.33,16054.75,7509.67,327400,282773,55553,137104,192657,90116,2022,'LORENA',Lorena,'SP',3527207,3066.0,3066,255.5,255.5,2,209.0,209.0,Médio
3558,3574,352725,1439,973,50,530,580,393,1418.83,967.67,63.75,512.33,576.08,391.58,17026,11612,765,6148,6913,4699,2022,'LOURDES',Lourdes,'SP',3527256,871.0,871,72.6,72.6,1,44.0,44.0,Pequeno I
3559,3575,352730,15629,14483,2058,5893,7951,6532,16576.33,15299.17,2146.75,6371.75,8518.5,6780.67,198916,183590,25761,76461,102222,81368,2022,'LOUVEIRA',Louveira,'SP',3527306,4721.0,4721,393.4,393.4,2,360.0,360.0,Pequeno II
3560,3576,352740,6780,5704,849,2708,3557,2147,6388.92,5419.5,654.83,2962.33,3617.17,1802.33,76667,65034,7858,35548,43406,21628,2022,'LUCELIA',Lucélia,'SP',3527405,871.0,871,72.6,72.6,1,60.0,60.0,Pequeno I
3561,3577,352750,1195,899,110,368,478,421,1187.58,893.5,126.25,371.92,498.17,395.33,14251,10722,1515,4463,5978,4744,2022,'LUCIANOPOLIS',Lucianópolis,'SP',3527504,849.0,849,70.8,70.8,1,53.0,53.0,Pequeno I
3562,3578,352760,5122,4291,551,2193,2744,1547,5139.17,4387.17,486.58,2332.0,2818.58,1568.58,61670,52646,5839,27984,33823,18823,2022,'LUIS ANTONIO',Luís Antônio,'SP',3527603,3300.0,3300,300.0,300.0,1,220.0,220.0,Pequeno I
3563,3579,352770,2879,2240,330,1050,1380,860,2717.25,2159.33,326.33,995.83,1322.17,837.17,32607,25912,3916,11950,15866,10046,2022,'LUIZIANIA',Luiziânia,'SP',3527702,56.0,56,14.0,14.0,1,20.0,20.0,Pequeno I
3564,3581,352790,1225,967,123,358,481,486,1212.5,994.33,116.58,387.5,504.08,490.25,14550,11932,1399,4650,6049,5883,2022,'LUTECIA',Lutécia,'SP',3527900,1383.0,1383,125.7,125.7,1,94.0,94.0,Pequeno I
3565,3582,352800,4732,3587,758,477,1235,2352,4553.58,3519.17,874.08,535.33,1409.42,2109.75,54643,42230,10489,6424,16913,25317,2022,'MACATUBA',Macatuba,'SP',3528007,4628.0,4628,385.7,385.7,1,455.0,455.0,Pequeno I
3566,3583,352810,3336,2482,443,1237,1680,802,3218.42,2404.5,358.75,1306.33,1665.08,739.42,38621,28854,4305,15676,19981,8873,2022,'MACAUBAL',Macaubal,'SP',3528106,2930.0,2930,244.2,244.2,1,194.0,194.0,Pequeno I
3567,3584,352820,1474,1226,279,247,526,700,1408.0,1174.75,260.08,268.5,528.58,646.17,16896,14097,3121,3222,6343,7754,2022,'MACEDONIA',Macedônia,'SP',3528205,1114.0,1114,101.3,101.3,1,,,Pequeno I
3568,3585,352830,1649,948,73,295,368,580,1588.67,939.25,84.42,268.67,353.08,586.17,19064,11271,1013,3224,4237,7034,2022,'MAGDA',Magda,'SP',3528304,1095.0,1095,91.2,91.2,1,41.0,41.0,Pequeno I
3569,3586,352840,12918,11244,2843,4682,7525,3719,12508.67,11014.58,2906.08,4742.92,7649.0,3365.58,150104,132175,34873,56915,91788,40387,2022,'MAIRINQUE',Mairinque,'SP',3528403,6950.0,6950,868.8,868.8,2,500.0,500.0,Pequeno II
3570,3587,352850,36935,30172,6266,14819,21085,9087,32624.5,26691.5,5949.42,12040.17,17989.58,8701.92,391494,320298,71393,144482,215875,104423,2022,'MAIRIPORA',Mairiporã,'SP',3528502,37534.0,40786,3127.8,3398.8,3,2622.0,2622.0,Médio
3571,3588,352860,3750,3085,592,1069,1661,1424,3446.0,2896.17,534.58,1064.75,1599.33,1296.83,41352,34754,6415,12777,19192,15562,2022,'MANDURI',Manduri,'SP',3528601,2399.0,2399,199.9,199.9,1,300.0,300.0,Pequeno I
3572,3589,352870,2528,1870,235,1058,1293,577,2425.17,1831.92,199.75,1093.58,1293.33,538.58,29102,21983,2397,13123,15520,6463,2022,'MARABA PAULISTA',Marabá Paulista,'SP',3528700,483.0,483,40.2,40.2,1,12.0,12.0,Pequeno I
3573,3590,352880,4786,3679,628,1320,1948,1731,4556.33,3555.67,591.83,1402.17,1994.0,1561.67,54676,42668,7102,16826,23928,18740,2022,'MARACAI',Maracaí,'SP',3528809,1452.0,1452,132.0,132.0,1,204.0,204.0,Pequeno I
3574,3591,352885,1114,932,142,542,684,248,1016.0,865.5,125.5,504.08,629.58,235.92,12192,10386,1506,6049,7555,2831,2022,'MARAPOAMA',Marapoama,'SP',3528858,658.0,658,54.8,54.8,1,42.0,42.0,Pequeno I
3575,3592,352890,1916,1390,137,824,961,429,1846.0,1368.83,114.83,791.42,906.25,462.58,22152,16426,1378,9497,10875,5551,2022,'MARIAPOLIS',Mariápolis,'SP',3528908,270.0,270,27.0,27.0,1,,,Pequeno I
3576,3593,352900,59677,44759,7700,17167,24867,19892,55262.33,41817.92,6930.42,16867.42,23797.83,18020.08,663148,501815,83165,202409,285574,216241,2022,'MARILIA',Marília,'SP',3529005,18211.0,18211,1517.6,1517.6,5,1489.0,1489.0,Grande
3577,3594,352910,1120,717,60,247,307,410,1116.25,735.08,56.33,250.67,307.0,428.08,13395,8821,676,3008,3684,5137,2022,'MARINOPOLIS',Marinópolis,'SP',3529104,552.0,552,46.0,46.0,1,35.0,35.0,Pequeno I
3578,3595,352920,8290,6930,448,4758,5206,1724,7839.33,6592.75,390.67,4540.92,4931.58,1661.17,94072,79113,4688,54491,59179,19934,2022,'MARTINOPOLIS',Martinópolis,'SP',3529203,3857.0,3857,321.4,321.4,1,477.0,477.0,Pequeno II
3579,3596,352930,17933,14701,2624,6366,8990,5711,17669.5,14580.42,2677.25,6549.42,9226.67,5353.75,212034,174965,32127,78593,110720,64245,2022,'MATAO',Matão,'SP',3529302,28120.0,28120,2343.3,2343.3,6,2104.0,2104.0,Médio
3580,3597,352940,85449,71864,11658,40581,52239,19625,75687.42,62894.25,10491.33,34245.5,44736.83,18157.42,908249,754731,125896,410946,536842,217889,2022,'MAUA',Mauá,'SP',3529401,29431.0,29431,2452.6,2452.6,8,2816.0,2816.0,Grande
3581,3598,352950,1685,1229,289,281,570,659,1654.67,1226.5,283.58,279.58,563.17,663.33,19856,14718,3403,3355,6758,7960,2022,'MENDONCA',Mendonça,'SP',3529500,3436.0,3436,286.3,286.3,1,106.0,106.0,Pequeno I
3582,3599,352960,2268,1481,188,381,569,912,2169.0,1461.0,212.75,372.08,584.83,876.17,26028,17532,2553,4465,7018,10514,2022,'MERIDIANO',Meridiano,'SP',3529609,1722.0,1722,143.5,143.5,1,69.0,69.0,Pequeno I
3583,3600,352965,796,607,124,158,282,325,788.17,615.75,144.17,154.58,298.75,317.0,9458,7389,1730,1855,3585,3804,2022,'MESOPOLIS',Mesópolis,'SP',3529658,261.0,261,23.7,23.7,1,28.0,28.0,Pequeno I
3584,3601,352970,9498,8224,287,6806,7093,1131,8368.58,7168.0,370.67,5545.08,5915.75,1252.25,100423,86016,4448,66541,70989,15027,2022,'MIGUELOPOLIS',Miguelópolis,'SP',3529708,424.0,424,60.6,60.6,1,66.0,66.0,Pequeno II
3585,3602,352980,4225,3643,895,1902,2797,846,3889.5,3401.33,782.83,1853.5,2636.33,765.0,46674,40816,9394,22242,31636,9180,2022,'MINEIROS DO TIETE',Mineiros do Tietê,'SP',3529807,1409.0,1409,117.4,117.4,1,131.0,131.0,Pequeno I
3586,3603,352990,13456,11272,2126,5865,7991,3281,12959.92,10942.33,1997.33,5796.33,7793.67,3148.67,155519,131308,23968,69556,93524,37784,2022,'MIRACATU',Miracatu,'SP',3529906,1849.0,1849,154.1,154.1,1,150.0,150.0,Pequeno II
3587,3604,353000,1418,902,138,276,414,488,1419.33,932.58,166.08,252.67,418.75,513.83,17032,11191,1993,3032,5025,6166,2022,'MIRA ESTRELA',Mira Estrela,'SP',3530003,1647.0,1647,137.2,137.2,1,72.0,72.0,Pequeno I
3588,3605,353010,7675,5874,1200,2491,3691,2183,7340.17,5640.17,1150.75,2402.92,3553.67,2086.5,88082,67682,13809,28835,42644,25038,2022,'MIRANDOPOLIS',Mirandópolis,'SP',3530102,2222.0,2222,185.2,185.2,1,174.0,174.0,Pequeno II
3589,3606,353020,9965,6849,1219,2404,3623,3226,9743.58,6780.5,1135.58,2421.33,3556.92,3223.58,116923,81366,13627,29056,42683,38683,2022,'MIRANTE DO PARANAPANEMA',Mirante do Paranapanema,'SP',3530201,2012.0,2012,167.7,167.7,1,32.0,32.0,Pequeno I
3590,3607,353030,14314,11178,2876,3026,5902,5276,13436.33,10570.58,2638.25,3000.25,5638.5,4932.08,161236,126847,31659,36003,67662,59185,2022,'MIRASSOL',Mirassol,'SP',3530300,6088.0,6088,507.3,507.3,2,456.0,456.0,Médio
3591,3608,353040,1997,1629,200,1009,1209,420,1781.58,1453.0,213.75,828.08,1041.83,411.17,21379,17436,2565,9937,12502,4934,2022,'MIRASSOLANDIA',Mirassolândia,'SP',3530409,8757.0,8757,729.8,729.8,2,741.0,741.0,Pequeno I
3592,3609,353050,17379,13584,2546,6557,9103,4481,16458.0,13077.5,2369.33,6313.58,8682.92,4394.58,197496,156930,28432,75763,104195,52735,2022,'MOCOCA',Mococa,'SP',3530508,4760.0,4760,396.7,396.7,1,530.0,530.0,Médio
3593,3610,353060,149738,132290,9968,95556,105524,26766,140140.17,124745.67,9303.25,91505.42,100808.67,23937.0,1681682,1496948,111639,1098065,1209704,287244,2022,'MOGI DAS CRUZES',Moji Das Cruzes,'SP',3530607,84269.0,84269,7022.4,7022.4,7,5378.0,5378.0,Grande
3594,3611,353070,36628,29038,5311,12481,17792,11246,33493.08,26762.58,4723.08,11669.17,16392.25,10370.33,401917,321151,56677,140030,196707,124444,2022,'MOGI GUACU',Mogi Guaçu,'SP',3530706,17547.0,17547,1462.2,1462.2,3,1150.0,1150.0,Grande
3595,3612,353080,16031,12300,2841,4284,7125,5175,14567.25,11269.25,2466.42,4007.42,6473.83,4795.42,174807,135231,29597,48089,77686,57545,2022,'MOGI-MIRIM',Moji-mirim,'SP',3530805,13062.0,13062,1088.5,1088.5,3,562.0,562.0,Médio
3596,3613,353090,2007,1718,179,961,1140,578,1977.25,1742.75,152.17,1076.08,1228.25,514.5,23727,20913,1826,12913,14739,6174,2022,'MOMBUCA',Mombuca,'SP',3530904,1823.0,1823,151.9,151.9,1,123.0,123.0,Pequeno I
3597,3614,353100,893,451,107,106,213,238,864.92,469.08,104.5,108.08,212.58,256.5,10379,5629,1254,1297,2551,3078,2022,'MONCOES',Monções,'SP',3531001,813.0,813,67.8,67.8,1,68.0,68.0,Pequeno I
3598,3615,353110,24577,21707,4987,11112,16099,5608,22535.83,20051.33,4548.5,10525.58,15074.08,4977.25,270430,240616,54582,126307,180889,59727,2022,'MONGAGUA',Mongaguá,'SP',3531100,12809.0,12809,1067.4,1067.4,2,473.0,473.0,Pequeno II
3599,3616,353120,1455,1208,207,544,751,457,1281.83,1073.75,179.42,485.42,664.83,408.92,15382,12885,2153,5825,7978,4907,2022,'MONTE ALEGRE DO SUL',Monte Alegre do Sul,'SP',3531209,1021.0,1021,145.9,145.9,1,210.0,210.0,Pequeno I
3600,3617,353130,8466,6333,1648,2460,4108,2225,7545.75,5682.75,1462.92,2093.0,3555.92,2126.83,90549,68193,17555,25116,42671,25522,2022,'MONTE ALTO',Monte Alto,'SP',3531308,10929.0,10929,910.8,910.8,2,920.0,920.0,Pequeno II
3601,3618,353140,8544,7061,797,4343,5140,1921,7850.58,6547.25,569.33,4319.08,4888.42,1658.83,94207,78567,6832,51829,58661,19906,2022,'MONTE APRAZIVEL',Monte Aprazível,'SP',3531407,8463.0,8463,705.2,705.2,1,949.0,949.0,Pequeno II
3602,3619,353150,4605,3744,845,1462,2307,1437,4303.25,3532.0,747.92,1512.67,2260.58,1271.42,51639,42384,8975,18152,27127,15257,2022,'MONTE AZUL PAULISTA',Monte Azul Paulista,'SP',3531506,2614.0,2614,237.6,237.6,1,167.0,167.0,Pequeno I
3603,3620,353160,1882,1473,226,567,793,680,1866.33,1517.33,232.33,630.42,862.75,654.58,22396,18208,2788,7565,10353,7855,2022,'MONTE CASTELO',Monte Castelo,'SP',3531605,3749.0,3749,312.4,312.4,1,232.0,232.0,Pequeno I
3604,3621,353170,1901,1611,238,832,1070,541,1663.25,1447.33,248.58,733.5,982.08,465.25,19959,17368,2983,8802,11785,5583,2022,'MONTEIRO LOBATO',Monteiro Lobato,'SP',3531704,244.0,244,48.8,48.8,1,80.0,80.0,Pequeno I
3605,3622,353180,28425,24010,6215,9840,16055,7955,27660.92,23671.0,5295.25,11813.5,17108.75,6562.25,331931,284052,63543,141762,205305,78747,2022,'MONTE MOR',Monte Mor,'SP',3531803,29379.0,36138,2448.2,3011.5,2,1434.0,1434.0,Pequeno II
3606,3623,353190,10861,8883,1184,4638,5822,3061,10223.92,8550.67,1159.58,4706.83,5866.42,2684.25,122687,102608,13915,56482,70397,32211,2022,'MORRO AGUDO',Morro Agudo,'SP',3531902,3039.0,3039,253.2,253.2,1,241.0,241.0,Pequeno II
3607,3624,353200,5482,3958,642,1358,2000,1958,5270.58,3796.17,628.58,1227.58,1856.17,1940.0,63247,45554,7543,14731,22274,23280,2022,'MORUNGABA',Morungaba,'SP',3532009,1234.0,1234,102.8,102.8,1,49.0,49.0,Pequeno I
3608,3625,353205,1555,1335,142,675,817,518,1476.83,1292.92,149.67,673.83,823.5,469.42,17722,15515,1796,8086,9882,5633,2022,'MOTUCA',Motuca,'SP',3532058,200.0,200,200.0,200.0,1,200.0,200.0,Pequeno I
3609,3626,353210,2366,1704,77,1212,1289,415,2263.33,1681.92,71.83,1198.83,1270.67,411.25,27160,20183,862,14386,15248,4935,2022,'MURUTINGA DO SUL',Murutinga do Sul,'SP',3532108,1218.0,1218,152.2,152.2,1,136.0,136.0,Pequeno I
3610,3627,353215,1228,1048,155,414,569,479,1159.0,1000.58,154.75,419.17,573.92,426.67,13908,12007,1857,5030,6887,5120,2022,'NANTES',Nantes,'SP',3532157,273.0,273,27.3,27.3,1,68.0,68.0,Pequeno I
3611,3628,353220,2430,1826,315,480,795,1031,2287.92,1760.25,338.58,422.5,761.08,999.17,27455,21123,4063,5070,9133,11990,2022,'NARANDIBA',Narandiba,'SP',3532207,161.0,161,23.0,23.0,1,10.0,10.0,Pequeno I
3612,3630,353240,7748,6918,1104,3861,4965,1953,7142.5,6444.25,957.25,3795.0,4752.25,1692.0,85710,77331,11487,45540,57027,20304,2022,'NAZARE PAULISTA',Nazaré Paulista,'SP',3532405,3871.0,3871,322.6,322.6,1,267.0,267.0,Pequeno I
3613,3631,353250,3549,2724,398,1548,1946,778,3273.0,2491.75,337.83,1375.25,1713.08,778.67,39276,29901,4054,16503,20557,9344,2022,'NEVES PAULISTA',Neves Paulista,'SP',3532504,1511.0,1511,167.9,167.9,1,93.0,93.0,Pequeno I
3614,3632,353260,3046,2085,489,766,1255,830,3006.5,2093.67,378.67,871.0,1249.67,844.0,36078,25124,4544,10452,14996,10128,2022,'NHANDEARA',Nhandeara,'SP',3532603,2156.0,2156,215.6,215.6,1,161.0,161.0,Pequeno I
3615,3633,353270,2367,2057,297,1161,1458,599,2134.83,1889.17,241.0,1161.42,1402.42,486.75,25618,22670,2892,13937,16829,5841,2022,'NIPOA',Nipoã,'SP',3532702,186.0,186,46.5,46.5,1,,,Pequeno I
3616,3634,353280,2224,1823,399,633,1032,791,2100.83,1738.17,396.58,582.92,979.5,758.67,25210,20858,4759,6995,11754,9104,2022,'NOVA ALIANCA',Nova Aliança,'SP',3532801,2793.0,2793,232.8,232.8,1,155.0,155.0,Pequeno I
3617,3635,353282,5482,4808,482,2757,3239,1569,5463.67,4886.17,512.58,2907.67,3420.25,1465.92,65564,58634,6151,34892,41043,17591,2022,'NOVA CAMPINA',Nova Campina,'SP',3532827,2566.0,2566,213.8,213.8,1,174.0,174.0,Pequeno I
3618,3636,353284,1019,673,62,218,280,393,984.0,652.17,75.67,252.42,328.08,324.08,11808,7826,908,3029,3937,3889,2022,'NOVA CANAA PAULISTA',Nova Canaã Paulista,'SP',3532843,1109.0,1109,92.4,92.4,1,144.0,144.0,Pequeno I
3619,3637,353286,508,366,75,66,141,225,482.42,357.33,73.25,78.17,151.42,205.92,5789,4288,879,938,1817,2471,2022,'NOVA CASTILHO',Nova Castilho,'SP',3532868,4227.0,4227,352.2,352.2,1,27.0,27.0,Pequeno I
3620,3638,353290,3810,2507,434,654,1088,1419,4046.75,2818.75,479.42,799.0,1278.42,1540.33,48561,33825,5753,9588,15341,18484,2022,'NOVA EUROPA',Nova Europa,'SP',3532900,2369.0,2369,197.4,197.4,1,237.0,237.0,Pequeno I
3621,3639,353300,6743,5374,975,2104,3079,2295,6397.33,5165.42,957.67,2102.42,3060.08,2105.33,76768,61985,11492,25229,36721,25264,2022,'NOVA GRANADA',Nova Granada,'SP',3533007,1957.0,1957,163.1,163.1,1,124.0,124.0,Pequeno I
3622,3640,353310,1129,929,92,530,622,307,1081.25,891.58,82.17,524.83,607.0,284.58,12975,10699,986,6298,7284,3415,2022,'NOVA GUATAPORANGA',Nova Guataporanga,'SP',3533106,669.0,669,60.8,60.8,1,70.0,70.0,Pequeno I
3623,3641,353320,2023,1792,140,1050,1190,602,1957.42,1774.25,89.58,1251.17,1340.75,433.5,23489,21291,1075,15014,16089,5202,2022,'NOVA INDEPENDENCIA',Nova Independência,'SP',3533205,4120.0,4120,412.0,412.0,1,483.0,483.0,Pequeno I
3624,3642,353325,2576,1984,345,824,1169,815,2335.67,1840.83,310.17,742.92,1053.08,787.75,28028,22090,3722,8915,12637,9453,2022,'NOVAIS',Novais,'SP',3533254,1205.0,1205,100.4,100.4,1,163.0,163.0,Pequeno I
3625,3643,353330,1846,1353,204,587,791,562,1760.75,1328.17,216.33,605.83,822.17,506.0,21129,15938,2596,7270,9866,6072,2022,'NOVA LUZITANIA',Nova Luzitânia,'SP',3533304,449.0,449,37.4,37.4,1,24.0,24.0,Pequeno I
3626,3644,353340,10937,9117,1669,4536,6205,2912,9915.17,8294.0,1570.58,4056.17,5626.75,2667.25,118982,99528,18847,48674,67521,32007,2022,'NOVA ODESSA',Nova Odessa,'SP',3533403,532.0,532,88.7,88.7,1,,,Médio
3627,3645,353350,12549,9989,2523,2732,5255,4734,11254.0,9049.08,2119.75,2785.25,4905.0,4144.08,135048,108589,25437,33423,58860,49729,2022,'NOVO HORIZONTE',Novo Horizonte,'SP',3533502,7745.0,7745,645.4,645.4,1,374.0,374.0,Pequeno II
3628,3646,353360,2230,1941,264,1121,1385,556,2094.25,1818.17,234.17,1036.0,1270.17,548.0,25131,21818,2810,12432,15242,6576,2022,'NUPORANGA',Nuporanga,'SP',3533601,141.0,141,11.8,11.8,1,16.0,16.0,Pequeno I
3629,3647,353370,1947,1717,151,1067,1218,499,1818.75,1627.08,145.5,1070.92,1216.42,410.67,21825,19525,1746,12851,14597,4928,2022,'OCAUCU',Ocauçu,'SP',3533700,2456.0,2456,245.6,245.6,1,218.0,218.0,Pequeno I
3630,3648,353380,1012,877,139,418,557,320,975.08,851.25,126.58,386.25,512.83,338.42,11701,10215,1519,4635,6154,4061,2022,'OLEO',Óleo,'SP',3533809,2836.0,2836,236.3,236.3,1,270.0,270.0,Pequeno I
3631,3649,353390,19160,15755,1552,8987,10539,5216,17873.17,14887.42,1393.33,8832.17,10225.5,4661.92,214478,178649,16720,105986,122706,55943,2022,'OLIMPIA',Olímpia,'SP',3533908,31026.0,88766,2585.5,7397.2,3,1965.0,5921.0,Médio
3632,3650,353400,1723,1432,286,471,757,675,1580.42,1319.67,258.5,449.42,707.92,611.75,18965,15836,3102,5393,8495,7341,2022,'ONDA VERDE',Onda Verde,'SP',3534005,2404.0,2404,200.3,200.3,1,132.0,132.0,Pequeno I
3633,3651,353410,1608,1284,359,544,903,381,1529.67,1253.58,235.08,657.67,892.75,360.83,18356,15043,2821,7892,10713,4330,2022,'ORIENTE',Oriente,'SP',3534104,2095.0,2095,174.6,174.6,1,117.0,117.0,Pequeno I
3634,3652,353420,1421,1045,183,211,394,651,1363.5,1005.83,187.83,163.25,351.08,654.75,16362,12070,2254,1959,4213,7857,2022,'ORINDIUVA',Orindiúva,'SP',3534203,1002.0,1002,83.5,83.5,1,30.0,30.0,Pequeno I
3635,3653,353430,7540,6449,1296,2801,4097,2352,7106.58,6111.58,1169.58,2878.83,4048.42,2063.17,85279,73339,14035,34546,48581,24758,2022,'ORLANDIA',Orlândia,'SP',3534302,3395.0,3395,308.6,308.6,1,249.0,249.0,Pequeno II
3636,3654,353440,240342,193904,28772,108423,137195,56709,214696.75,175351.5,26130.83,97891.5,124022.33,51329.17,2576361,2104218,313570,1174698,1488268,615950,2022,'OSASCO',Osasco,'SP',3534401,39431.0,39431,3285.9,3285.9,9,2185.0,2185.0,Grande
3637,3655,353450,1121,887,164,381,545,342,1080.42,859.33,147.58,388.25,535.83,323.5,12965,10312,1771,4659,6430,3882,2022,'OSCAR BRESSANE',Oscar Bressane,'SP',3534500,856.0,856,77.8,77.8,1,110.0,110.0,Pequeno I
3638,3656,353460,10492,8312,1935,1659,3594,4718,10012.5,8230.17,1728.92,1898.75,3627.67,4602.5,120150,98762,20747,22785,43532,55230,2022,'OSVALDO CRUZ',Osvaldo Cruz,'SP',3534609,5948.0,5948,495.7,495.7,2,409.0,409.0,Pequeno II
3639,3657,353470,28445,22828,4257,9482,13739,9089,26317.17,21322.42,3847.67,9167.83,13015.5,8306.92,315806,255869,46172,110014,156186,99683,2022,'OURINHOS',Ourinhos,'SP',3534708,20569.0,20569,1714.1,1714.1,4,663.0,663.0,Grande
3640,3658,353475,4732,3540,422,1672,2094,1446,4626.92,3517.17,434.92,1764.58,2199.5,1317.67,55523,42206,5219,21175,26394,15812,2022,'OUROESTE',Ouroeste,'SP',3534757,313.0,313,26.1,26.1,1,27.0,27.0,Pequeno I
3641,3659,353480,4784,4237,345,2842,3187,1050,4609.33,4089.08,285.75,2843.08,3128.83,960.25,55312,49069,3429,34117,37546,11523,2022,'OURO VERDE',Ouro Verde,'SP',3534807,2346.0,2346,469.2,469.2,1,,,Pequeno I
3642,3660,353490,3252,2625,355,1189,1544,1081,3108.75,2499.92,362.08,1084.75,1446.83,1053.08,37305,29999,4345,13017,17362,12637,2022,'PACAEMBU',Pacaembu,'SP',3534906,526.0,526,43.8,43.8,1,20.0,20.0,Pequeno I
3643,3661,353500,3455,2770,662,1295,1957,813,3020.67,2465.25,532.92,1304.08,1837.0,628.25,36248,29583,6395,15649,22044,7539,2022,'PALESTINA',Palestina,'SP',3535002,191.0,191,63.7,63.7,1,100.0,100.0,Pequeno I
3644,3662,353510,3310,2556,484,768,1252,1304,3005.33,2363.33,548.5,711.0,1259.5,1103.83,36064,28360,6582,8532,15114,13246,2022,'PALMARES PAULISTA',Palmares Paulista,'SP',3535101,3160.0,3160,263.3,263.3,1,100.0,100.0,Pequeno I
3645,3663,353520,3297,2441,373,903,1276,1165,3047.42,2305.08,289.42,950.83,1240.25,1064.83,36569,27661,3473,11410,14883,12778,2022,'PALMEIRA DOESTE',Palmeira D´oeste,'SP',3535200,4295.0,4295,390.5,390.5,1,,,Pequeno I
3646,3664,353530,7591,6521,891,3615,4506,2015,7230.5,6244.25,840.33,3376.17,4216.5,2027.75,86766,74931,10084,40514,50598,24333,2022,'PALMITAL',Palmital,'SP',3535309,3015.0,3015,251.2,251.2,1,183.0,183.0,Pequeno II
3647,3665,353540,6620,5851,1055,3186,4241,1610,6247.17,5555.92,887.67,3176.25,4063.92,1492.0,74966,66671,10652,38115,48767,17904,2022,'PANORAMA',Panorama,'SP',3535408,525.0,525,43.8,43.8,1,48.0,48.0,Pequeno I
3648,3666,353550,18144,15565,2575,8711,11286,4279,17080.33,14949.75,2186.75,8782.33,10969.08,3980.67,204964,179397,26241,105388,131629,47768,2022,'PARAGUACU PAULISTA',Paraguaçu Paulista,'SP',3535507,12122.0,12122,1010.2,1010.2,3,598.0,598.0,Pequeno II
3649,3667,353560,7322,6365,1941,1995,3936,2429,6809.42,5936.42,1696.0,1944.5,3640.5,2295.92,81713,71237,20352,23334,43686,27551,2022,'PARAIBUNA',Paraibuna,'SP',3535606,3778.0,3778,343.5,343.5,1,217.0,217.0,Pequeno I
3650,3668,353570,2001,1443,283,458,741,702,1937.67,1463.42,283.25,549.67,832.92,630.5,23252,17561,3399,6596,9995,7566,2022,'PARAISO',Paraíso,'SP',3535705,114.0,114,19.0,19.0,1,18.0,18.0,Pequeno I
3651,3669,353580,7474,6291,1139,3314,4453,1838,6773.17,5672.58,1041.0,2875.42,3916.42,1756.17,81278,68071,12492,34505,46997,21074,2022,'PARANAPANEMA',Paranapanema,'SP',3535804,5500.0,5500,458.3,458.3,1,375.0,375.0,Pequeno I
3652,3670,353590,2187,1796,223,973,1196,600,2046.92,1671.17,200.33,942.33,1142.67,528.5,24563,20054,2404,11308,13712,6342,2022,'PARANAPUA',Paranapuã,'SP',3535903,120.0,120,40.0,40.0,1,27.0,27.0,Pequeno I
3653,3671,353600,4632,3703,513,1770,2283,1420,4510.58,3733.83,479.83,1953.33,2433.17,1300.67,54127,44806,5758,23440,29198,15608,2022,'PARAPUA',Parapuã,'SP',3536000,2360.0,2360,196.7,196.7,1,198.0,198.0,Pequeno I
3654,3672,353610,2633,2158,347,905,1252,906,2388.33,1948.67,356.92,792.0,1148.92,799.75,28660,23384,4283,9504,13787,9597,2022,'PARDINHO',Pardinho,'SP',3536109,1456.0,1456,121.3,121.3,1,171.0,171.0,Pequeno I
3655,3673,353620,8958,7253,1665,2015,3680,3573,8410.92,6871.75,1475.08,2212.17,3687.25,3184.5,100931,82461,17701,26546,44247,38214,2022,'PARIQUERA-ACU',Pariquera-açu,'SP',3536208,2923.0,2923,265.7,265.7,1,301.0,301.0,Pequeno I
3656,3674,353625,1785,1205,170,595,765,440,1659.92,1166.5,163.83,587.67,751.5,415.0,19919,13998,1966,7052,9018,4980,2022,'PARISI',Parisi,'SP',3536257,3255.0,3255,271.2,271.2,1,86.0,86.0,Pequeno I
3657,3675,353630,5316,4705,736,2382,3118,1587,4969.75,4479.0,763.33,2210.67,2974.0,1505.0,59637,53748,9160,26528,35688,18060,2022,'PATROCINIO PAULISTA',Patrocínio Paulista,'SP',3536307,1633.0,1633,204.1,204.1,1,186.0,186.0,Pequeno I
3658,3676,353640,4221,3508,475,2095,2570,938,3831.42,3300.58,461.58,1961.67,2423.25,877.33,45977,39607,5539,23540,29079,10528,2022,'PAULICEIA',Paulicéia,'SP',3536406,2045.0,2045,170.4,170.4,1,147.0,147.0,Pequeno I
3659,3677,353650,23421,19701,2885,10234,13119,6582,22503.75,19073.75,2542.08,10279.92,12822.0,6251.75,270045,228885,30505,123359,153864,75021,2022,'PAULINIA',Paulínia,'SP',3536505,3624.0,3624,302.0,302.0,2,200.0,200.0,Médio
3660,3678,353657,1134,963,105,407,512,451,1075.92,920.33,98.42,404.0,502.42,417.92,12911,11044,1181,4848,6029,5015,2022,'PAULISTANIA',Paulistânia,'SP',3536570,335.0,335,33.5,33.5,1,27.0,27.0,Pequeno I
3661,3679,353660,3293,2622,393,1696,2089,533,3138.42,2543.17,403.33,1553.33,1956.67,586.5,37661,30518,4840,18640,23480,7038,2022,'PAULO DE FARIA',Paulo de Faria,'SP',3536604,613.0,613,51.1,51.1,1,46.0,46.0,Pequeno I
3662,3680,353670,14055,11740,2489,5017,7506,4234,13067.83,11076.17,2273.5,4965.67,7239.17,3837.0,156814,132914,27282,59588,86870,46044,2022,'PEDERNEIRAS',Pederneiras,'SP',3536703,14194.0,20835,1182.8,1736.2,1,0.0,2113.0,Pequeno II
3663,3681,353680,2177,1838,305,990,1295,543,2065.83,1762.08,262.0,1001.92,1263.92,498.17,24790,21145,3144,12023,15167,5978,2022,'PEDRA BELA',Pedra Bela,'SP',3536802,1133.0,1133,94.4,94.4,1,160.0,160.0,Pequeno I
3664,3682,353690,1402,735,81,176,257,478,1337.08,726.83,87.92,169.42,257.33,469.5,16045,8722,1055,2033,3088,5634,2022,'PEDRANOPOLIS',Pedranópolis,'SP',3536901,1149.0,1149,95.8,95.8,1,42.0,42.0,Pequeno I
3665,3683,353700,6463,5676,565,3648,4213,1463,6031.08,5341.75,475.33,3645.92,4121.25,1220.5,72373,64101,5704,43751,49455,14646,2022,'PEDREGULHO',Pedregulho,'SP',3537008,3430.0,3430,343.0,343.0,1,394.0,394.0,Pequeno I
3666,3684,353710,13204,9179,1399,4425,5824,3355,13177.83,9156.42,1160.92,4311.33,5472.25,3684.17,158134,109877,13931,51736,65667,44210,2022,'PEDREIRA',Pedreira,'SP',3537107,6904.0,6904,627.6,627.6,1,315.0,315.0,Pequeno II
3667,3685,353715,1317,859,80,328,408,451,1286.33,870.08,70.25,325.75,396.0,474.08,15436,10441,843,3909,4752,5689,2022,'PEDRINHAS PAULISTA',Pedrinhas Paulista,'SP',3537156,137.0,137,27.4,27.4,1,30.0,30.0,Pequeno I
3668,3686,353720,6072,5154,1079,2343,3422,1732,5834.92,5036.25,925.25,2545.08,3470.33,1565.92,70019,60435,11103,30541,41644,18791,2022,'PEDRO DE TOLEDO',Pedro de Toledo,'SP',3537206,1081.0,1081,90.1,90.1,1,128.0,128.0,Pequeno I
3669,3687,353730,15265,12962,2000,7174,9174,3788,13514.0,11528.08,1674.83,6444.17,8119.0,3409.08,162168,138337,20098,77330,97428,40909,2022,'PENAPOLIS',Penápolis,'SP',3537305,8324.0,8324,693.7,693.7,2,540.0,540.0,Médio
3670,3688,353740,6554,5242,1069,2102,3171,2071,6011.0,4867.08,1088.25,1808.5,2896.75,1970.33,72132,58405,13059,21702,34761,23644,2022,'PEREIRA BARRETO',Pereira Barreto,'SP',3537404,8245.0,8245,687.1,687.1,1,844.0,844.0,Pequeno II
3671,3689,353750,3237,2665,649,669,1318,1347,3080.75,2585.17,626.42,725.0,1351.42,1233.75,36969,31022,7517,8700,16217,14805,2022,'PEREIRAS',Pereiras,'SP',3537503,897.0,897,179.4,179.4,1,99.0,99.0,Pequeno I
3672,3690,353760,38836,33321,6528,18471,24999,8322,35340.17,30567.67,5796.92,17365.25,23162.17,7405.5,424082,366812,69563,208383,277946,88866,2022,'PERUIBE',Peruíbe,'SP',3537602,6391.0,6391,532.6,532.6,2,240.0,240.0,Médio
3673,3691,353770,2116,1393,227,150,377,1016,1978.25,1377.58,250.67,177.67,428.33,949.25,23739,16531,3008,2132,5140,11391,2022,'PIACATU',Piacatu,'SP',3537701,4209.0,4209,350.8,350.8,1,290.0,290.0,Pequeno I
3674,3692,353780,21055,18312,3356,9885,13241,5071,18701.33,16403.83,2920.83,9198.5,12119.33,4284.5,224416,196846,35050,110382,145432,51414,2022,'PIEDADE',Piedade,'SP',3537800,11126.0,11126,927.2,927.2,2,1693.0,1693.0,Médio
3675,3693,353790,10075,8198,2102,1516,3618,4580,9495.67,7796.75,2029.0,1589.25,3618.25,4178.5,113948,93561,24348,19071,43419,50142,2022,'PILAR DO SUL',Pilar do Sul,'SP',3537909,5756.0,5756,479.7,479.7,1,516.0,516.0,Pequeno II
3676,3694,353800,57416,50344,7578,28545,36123,14221,54478.75,47879.0,7020.92,27370.25,34391.17,13487.83,653745,574548,84251,328443,412694,161854,2022,'PINDAMONHANGABA',Pindamonhangaba,'SP',3538006,19354.0,19354,1612.8,1612.8,5,1368.0,1368.0,Grande
3677,3695,353810,3653,2768,502,1076,1578,1190,3618.25,2733.5,468.42,1144.33,1612.75,1120.75,43419,32802,5621,13732,19353,13449,2022,'PINDORAMA',Pindorama,'SP',3538105,1970.0,1970,246.2,246.2,1,191.0,191.0,Pequeno I
3678,3696,353820,5674,4354,1181,1029,2210,2144,5297.33,4082.42,1017.75,1072.17,2089.92,1992.5,63568,48989,12213,12866,25079,23910,2022,'PINHALZINHO',Pinhalzinho,'SP',3538204,1375.0,1375,229.2,229.2,1,269.0,269.0,Pequeno I
3679,3698,353850,5052,4206,801,1726,2527,1679,4807.92,4064.83,779.58,1684.75,2464.33,1600.5,57695,48778,9355,20217,29572,19206,2022,'PIQUETE',Piquete,'SP',3538501,4566.0,4566,380.5,380.5,1,391.0,391.0,Pequeno I
3680,3699,353860,8593,7237,1977,2927,4904,2333,8067.83,6902.67,1771.5,2969.5,4741.0,2161.67,96814,82832,21258,35634,56892,25940,2022,'PIRACAIA',Piracaia,'SP',3538600,696.0,696,58.0,58.0,1,40.0,40.0,Pequeno II
3681,3700,353870,92591,72937,11336,33070,44406,28531,88290.5,70992.58,10219.17,34042.5,44261.67,26730.92,1059486,851911,122630,408510,531140,320771,2022,'PIRACICABA',Piracicaba,'SP',3538709,27893.0,27893,2324.4,2324.4,6,2058.0,2058.0,Grande
3682,3701,353880,9616,8221,776,4878,5654,2567,9388.25,8079.5,732.33,4844.0,5576.33,2503.17,112659,96954,8788,58128,66916,30038,2022,'PIRAJU',Piraju,'SP',3538808,9316.0,9316,776.3,776.3,2,298.0,298.0,Pequeno II
3683,3702,353890,7905,6099,468,3876,4344,1755,7306.58,5836.17,431.83,3791.42,4223.25,1612.92,87679,70034,5182,45497,50679,19355,2022,'PIRAJUI',Pirajuí,'SP',3538907,7781.0,7781,648.4,648.4,1,355.0,355.0,Pequeno II
3684,3703,353900,2353,1910,286,695,981,929,2266.58,1874.92,287.42,718.08,1005.5,869.42,27199,22499,3449,8617,12066,10433,2022,'PIRANGI',Pirangi,'SP',3539004,4192.0,4192,349.3,349.3,1,282.0,282.0,Pequeno I
3685,3704,353910,9548,8655,726,6125,6851,1804,8503.58,7747.0,684.5,5520.58,6205.08,1541.92,102043,92964,8214,66247,74461,18503,2022,'PIRAPORA DO BOM JESUS',Pirapora do Bom Jesus,'SP',3539103,1339.0,1339,223.2,223.2,2,120.0,120.0,Pequeno I
3686,3705,353920,6378,5128,1602,931,2533,2595,6112.92,4977.0,1429.83,963.25,2393.08,2583.92,73355,59724,17158,11559,28717,31007,2022,'PIRAPOZINHO',Pirapozinho,'SP',3539202,931.0,931,77.6,77.6,1,118.0,118.0,Pequeno II
3687,3706,353930,16751,12975,2682,5052,7734,5241,14790.75,11605.75,2335.25,4641.83,6977.08,4628.67,177489,139269,28023,55702,83725,55544,2022,'PIRASSUNUNGA',Pirassununga,'SP',3539301,5654.0,5654,471.2,471.2,2,347.0,347.0,Médio
3688,3707,353940,4439,3509,612,1199,1811,1698,4046.33,3250.08,530.83,1120.17,1651.0,1599.08,48556,39001,6370,13442,19812,19189,2022,'PIRATININGA',Piratininga,'SP',3539400,3263.0,3263,271.9,271.9,1,325.0,325.0,Pequeno I
3689,3708,353950,10884,9017,2565,2637,5202,3815,10107.42,8515.83,2163.58,3259.5,5423.08,3092.75,121289,102190,25963,39114,65077,37113,2022,'PITANGUEIRAS',Pitangueiras,'SP',3539509,3313.0,3313,276.1,276.1,3,120.0,120.0,Pequeno II
3690,3709,353960,2344,1814,417,433,850,964,2280.67,1804.83,417.92,504.0,921.92,882.92,27368,21658,5015,6048,11063,10595,2022,'PLANALTO',Planalto,'SP',3539608,3151.0,3151,262.6,262.6,1,97.0,97.0,Pequeno I
3691,3710,353970,1767,1508,171,1046,1217,291,1683.67,1431.0,149.0,994.83,1143.83,287.17,20204,17172,1788,11938,13726,3446,2022,'PLATINA',Platina,'SP',3539707,340.0,340,48.6,48.6,1,,,Pequeno I
3692,3711,353980,49663,41670,2386,30057,32443,9227,45927.25,39103.75,2426.25,27871.0,30297.25,8806.5,551127,469245,29115,334452,363567,105678,2022,'POA',Poá,'SP',3539806,20788.0,20788,1732.3,1732.3,4,1697.0,1697.0,Grande
3693,3712,353990,2690,2091,443,1052,1495,596,2516.08,1894.08,358.58,908.58,1267.17,626.92,30193,22729,4303,10903,15206,7523,2022,'POLONI',Poloni,'SP',3539905,5035.0,5035,419.6,419.6,1,319.0,319.0,Pequeno I
3694,3713,354000,7388,4899,946,1501,2447,2452,6962.58,4682.92,1062.67,1132.92,2195.58,2487.33,83551,56195,12752,13595,26347,29848,2022,'POMPEIA',Pompéia,'SP',3540002,3347.0,3347,278.9,278.9,1,40.0,40.0,Pequeno I
3695,3715,354020,12276,10321,2189,4375,6564,3757,11362.17,9685.75,1931.25,4428.67,6359.92,3325.83,136346,116229,23175,53144,76319,39910,2022,'PONTAL',Pontal,'SP',3540200,4157.0,4157,346.4,346.4,1,398.0,398.0,Pequeno II
3696,3716,354025,2348,1742,306,452,758,984,2212.25,1682.67,268.42,479.33,747.75,934.92,26547,20192,3221,5752,8973,11219,2022,'PONTALINDA',Pontalinda,'SP',3540259,1964.0,1964,163.7,163.7,1,98.0,98.0,Pequeno I
3697,3717,354030,1383,894,144,400,544,350,1231.92,822.5,150.42,360.67,511.08,311.42,14783,9870,1805,4328,6133,3737,2022,'PONTES GESTAL',Pontes Gestal,'SP',3540309,945.0,945,85.9,85.9,1,119.0,119.0,Pequeno I
3698,3718,354040,2113,1634,118,1058,1176,458,2024.83,1561.17,102.5,1080.67,1183.17,378.0,24298,18734,1230,12968,14198,4536,2022,'POPULINA',Populina,'SP',3540408,3048.0,3048,277.1,277.1,1,152.0,152.0,Pequeno I
3699,3719,354050,3497,2833,608,1092,1700,1133,3150.75,2563.83,562.33,1005.83,1568.17,995.67,37809,30766,6748,12070,18818,11948,2022,'PORANGABA',Porangaba,'SP',3540507,575.0,575,191.7,191.7,1,162.0,162.0,Pequeno I
3700,3720,354060,13291,10394,1880,4685,6565,3829,11727.58,9286.58,1768.17,3983.25,5751.42,3535.17,140731,111439,21218,47799,69017,42422,2022,'PORTO FELIZ',Porto Feliz,'SP',3540606,4333.0,4333,481.4,481.4,2,233.0,233.0,Pequeno II
3701,3721,354070,12255,9231,1647,3832,5479,3752,11565.92,8776.67,1571.5,3733.83,5305.33,3471.33,138791,105320,18858,44806,63664,41656,2022,'PORTO FERREIRA',Porto Ferreira,'SP',3540705,6800.0,6800,566.7,566.7,2,504.0,504.0,Médio
3702,3722,354075,9274,8101,1432,4423,5855,2246,8858.08,7772.42,1133.83,4563.58,5697.42,2075.0,106297,93269,13606,54763,68369,24900,2022,'POTIM',Potim,'SP',3540754,4683.0,4683,390.2,390.2,1,425.0,425.0,Pequeno I
3703,3723,354080,4791,3703,579,1484,2063,1640,4433.25,3480.5,617.92,1218.83,1836.75,1643.75,53199,41766,7415,14626,22041,19725,2022,'POTIRENDABA',Potirendaba,'SP',3540804,1320.0,1320,165.0,165.0,1,,,Pequeno I
3704,3724,354085,974,828,4,567,571,257,957.25,826.67,1.25,594.83,596.08,230.58,11487,9920,15,7138,7153,2767,2022,'PRACINHA',Pracinha,'SP',3540853,106.0,106,10.6,10.6,1,12.0,12.0,Pequeno I
3705,3725,354090,5533,4864,300,3593,3893,971,5188.83,4616.33,285.5,3447.42,3732.92,883.42,62266,55396,3426,41369,44795,10601,2022,'PRADOPOLIS',Pradópolis,'SP',3540903,1799.0,1799,257.0,257.0,1,,,Pequeno I
3706,3726,354100,76714,62834,13217,28467,41684,21150,65890.42,54062.83,11563.0,24391.42,35954.42,18108.42,790685,648754,138756,292697,431453,217301,2022,'PRAIA GRANDE',Praia Grande,'SP',3541000,16788.0,16788,1399.0,1399.0,5,1259.0,1259.0,Grande
3707,3727,354105,3754,3028,515,1326,1841,1187,3802.92,3084.0,472.25,1404.58,1876.83,1207.17,45635,37008,5667,16855,22522,14486,2022,'PRATANIA',Pratânia,'SP',3541059,1418.0,1418,157.6,157.6,1,244.0,244.0,Pequeno I
3708,3728,354110,1533,1282,266,496,762,520,1396.58,1166.58,238.67,435.25,673.92,492.67,16759,13999,2864,5223,8087,5912,2022,'PRESIDENTE ALVES',Presidente Alves,'SP',3541109,700.0,700,87.5,87.5,1,59.0,59.0,Pequeno I
3709,3729,354120,4575,3303,712,980,1692,1611,4175.67,3162.17,690.17,951.42,1641.58,1520.58,50108,37946,8282,11417,19699,18247,2022,'PRESIDENTE BERNARDES',Presidente Bernardes,'SP',3541208,3619.0,3619,301.6,301.6,1,292.0,292.0,Pequeno I
3710,3730,354130,18051,13646,3983,2328,6311,7335,16803.5,12801.08,3715.25,1683.25,5398.5,7402.58,201642,153613,44583,20199,64782,88831,2022,'PRESIDENTE EPITACIO',Presidente Epitácio,'SP',3541307,1263.0,1263,180.4,180.4,1,189.0,189.0,Pequeno II
3711,3731,354140,56742,44815,7075,21251,28326,16489,54679.75,43150.92,6925.17,19684.5,26609.67,16541.25,656157,517811,83102,236214,319316,198495,2022,'PRESIDENTE PRUDENTE',Presidente Prudente,'SP',3541406,40931.0,40931,3410.9,3410.9,7,2831.0,2831.0,Grande
3712,3732,354150,8066,6900,1780,2195,3975,2925,7544.67,6479.67,1579.58,2382.92,3962.5,2517.17,90536,77756,18955,28595,47550,30206,2022,'PRESIDENTE VENCESLAU',Presidente Venceslau,'SP',3541505,1396.0,1396,116.3,116.3,1,397.0,397.0,Pequeno II
3713,3733,354160,9342,8090,2039,3144,5183,2907,8947.92,7682.75,2000.42,2811.08,4811.5,2871.25,107375,92193,24005,33733,57738,34455,2022,'PROMISSAO',Promissão,'SP',3541604,2302.0,2302,191.8,191.8,1,165.0,165.0,Pequeno II
3714,3734,354165,2439,2079,343,1099,1442,637,2262.67,1930.58,331.42,995.92,1327.33,603.25,27152,23167,3977,11951,15928,7239,2022,'QUADRA',Quadra,'SP',3541653,2481.0,2481,206.8,206.8,1,136.0,136.0,Pequeno I
3715,3735,354170,6343,5504,808,2508,3316,2188,5929.42,5207.92,536.58,2761.25,3297.83,1910.08,71153,62495,6439,33135,39574,22921,2022,'QUATA',Quatá,'SP',3541703,6395.0,8451,532.9,704.2,1,877.0,877.0,Pequeno I
3716,3736,354180,1442,1188,118,642,760,428,1314.67,1102.33,121.17,572.92,694.08,408.25,15776,13228,1454,6875,8329,4899,2022,'QUEIROZ',Queiroz,'SP',3541802,338.0,338,112.7,112.7,1,,,Pequeno I
3717,3737,354190,5036,3909,345,1933,2278,1631,4873.67,3846.67,312.33,1915.67,2228.0,1618.67,58484,46160,3748,22988,26736,19424,2022,'QUELUZ',Queluz,'SP',3541901,2620.0,2620,218.3,218.3,1,146.0,146.0,Pequeno I
3718,3738,354200,2626,2150,249,1252,1501,649,2457.33,2057.08,203.75,1262.75,1466.5,590.58,29488,24685,2445,15153,17598,7087,2022,'QUINTANA',Quintana,'SP',3542008,383.0,383,191.5,191.5,1,215.0,215.0,Pequeno I
3719,3739,354210,3180,2709,289,1568,1857,852,2888.5,2548.67,201.5,1653.92,1855.42,693.25,34662,30584,2418,19847,22265,8319,2022,'RAFARD',Rafard,'SP',3542107,4197.0,4197,349.8,349.8,1,338.0,338.0,Pequeno I
3720,3740,354220,9649,7785,1509,3421,4930,2855,9182.42,7575.17,1302.5,3714.83,5017.33,2557.83,110189,90902,15630,44578,60208,30694,2022,'RANCHARIA',Rancharia,'SP',3542206,6531.0,6531,544.2,544.2,1,142.0,142.0,Pequeno II
3721,3741,354230,2326,2089,122,1518,1640,449,2183.92,1976.67,110.08,1454.75,1564.83,411.83,26207,23720,1321,17457,18778,4942,2022,'REDENCAO DA SERRA',Redenção da Serra,'SP',3542305,1580.0,1580,225.7,225.7,1,270.0,270.0,Pequeno I
3722,3742,354240,6089,4525,855,1493,2348,2177,5526.25,4200.25,810.83,1324.75,2135.58,2064.67,66315,50403,9730,15897,25627,24776,2022,'REGENTE FEIJO',Regente Feijó,'SP',3542404,386.0,386,64.3,64.3,1,,,Pequeno I
3723,3743,354250,1856,1421,320,453,773,648,1711.25,1303.33,273.5,407.33,680.83,622.5,20535,15640,3282,4888,8170,7470,2022,'REGINOPOLIS',Reginópolis,'SP',3542503,13.0,13,2.6,2.6,1,1.0,1.0,Pequeno I
3724,3744,354260,26431,22244,3564,10834,14398,7846,24287.83,20608.25,3366.92,10489.67,13856.58,6751.67,291454,247299,40403,125876,166279,81020,2022,'REGISTRO',Registro,'SP',3542602,11555.0,11555,962.9,962.9,6,580.0,580.0,Médio
3725,3745,354270,3387,2960,481,1262,1743,1217,3283.67,2908.92,503.92,1233.0,1736.92,1172.0,39404,34907,6047,14796,20843,14064,2022,'RESTINGA',Restinga,'SP',3542701,272.0,272,27.2,27.2,1,12.0,12.0,Pequeno I
3726,3746,354280,2315,2044,120,1385,1505,539,2229.42,1998.92,146.58,1353.5,1500.08,498.83,26753,23987,1759,16242,18001,5986,2022,'RIBEIRA',Ribeira,'SP',3542800,3020.0,3020,251.7,251.7,1,52.0,52.0,Pequeno I
3727,3748,354300,11384,10131,2568,4495,7063,3068,11240.5,10106.17,2467.25,4612.5,7079.75,3026.42,134886,121274,29607,55350,84957,36317,2022,'RIBEIRAO BRANCO',Ribeirão Branco,'SP',3543006,3235.0,3235,269.6,269.6,1,206.0,206.0,Pequeno I
3728,3749,354310,2594,2345,445,1243,1688,657,2416.42,2180.58,481.0,1008.58,1489.58,691.0,28997,26167,5772,12103,17875,8292,2022,'RIBEIRAO CORRENTE',Ribeirão Corrente,'SP',3543105,1186.0,1186,98.8,98.8,1,113.0,113.0,Pequeno I
3729,3750,354320,2710,2048,328,833,1161,887,2596.92,1988.0,296.75,828.75,1125.5,862.5,31163,23856,3561,9945,13506,10350,2022,'RIBEIRAO DO SUL',Ribeirão do Sul,'SP',3543204,474.0,474,237.0,237.0,1,375.0,375.0,Pequeno I
3730,3751,354323,1289,911,113,405,518,393,1258.0,899.75,102.08,393.67,495.75,404.0,15096,10797,1225,4724,5949,4848,2022,'RIBEIRAO DOS INDIOS',Ribeirão Dos Índios,'SP',3543238,790.0,790,79.0,79.0,1,50.0,50.0,Pequeno I
3731,3752,354325,4815,3249,609,476,1085,2164,4767.92,3495.33,671.08,709.0,1380.08,2115.25,57215,41944,8053,8508,16561,25383,2022,'RIBEIRAO GRANDE',Ribeirão Grande,'SP',3543253,2419.0,2419,201.6,201.6,1,136.0,136.0,Pequeno I
3732,3753,354330,29633,22740,2950,12900,15850,6890,27550.0,21210.67,2520.17,12432.25,14952.42,6258.25,330600,254528,30242,149187,179429,75099,2022,'RIBEIRAO PIRES',Ribeirão Pires,'SP',3543303,7243.0,7243,603.6,603.6,4,522.0,522.0,Grande
3733,3754,354340,119302,96836,14648,53378,68026,28810,103172.08,83290.92,11764.58,47245.5,59010.08,24280.83,1238065,999491,141175,566946,708121,291370,2022,'RIBEIRAO PRETO',Ribeirão Preto,'SP',3543402,73202.0,73202,6100.2,6100.2,7,3657.0,3657.0,Grande
3734,3755,354350,3357,2882,429,1679,2108,774,3316.75,2879.42,439.42,1632.42,2071.83,807.58,39801,34553,5273,19589,24862,9691,2022,'RIVERSUL',Riversul,'SP',3543501,3962.0,3962,330.2,330.2,1,317.0,317.0,Pequeno I
3735,3756,354360,1780,1329,300,400,700,629,1721.0,1299.0,318.33,366.83,685.17,613.83,20652,15588,3820,4402,8222,7366,2022,'RIFAINA',Rifaina,'SP',3543600,871.0,871,72.6,72.6,1,72.0,72.0,Pequeno I
3736,3758,354380,1635,1367,243,458,701,666,1878.08,1599.08,335.08,453.08,788.17,810.92,22537,19189,4021,5437,9458,9731,2022,'RINOPOLIS',Rinópolis,'SP',3543808,462.0,462,38.5,38.5,1,31.0,31.0,Pequeno I
3737,3759,354390,43923,33726,5460,16778,22238,11488,39953.42,30879.42,5040.42,15275.92,20316.33,10563.08,479441,370553,60485,183311,243796,126757,2022,'RIO CLARO',Rio Claro,'SP',3543907,9772.0,9772,814.3,814.3,6,880.0,880.0,Grande
3738,3760,354400,6130,5118,960,1635,2595,2523,5702.92,4819.58,932.92,1703.67,2636.58,2183.0,68435,57835,11195,20444,31639,26196,2022,'RIO DAS PEDRAS',Rio Das Pedras,'SP',3544004,9010.0,9010,750.8,750.8,1,926.0,926.0,Pequeno II
3739,3761,354410,20954,17497,2957,9239,12196,5301,19383.0,16287.42,2720.92,8527.17,11248.08,5039.33,232596,195449,32651,102326,134977,60472,2022,'RIO GRANDE DA SERRA',Rio Grande da Serra,'SP',3544103,5268.0,5268,526.8,526.8,1,222.0,222.0,Pequeno II
3740,3762,354420,4378,3394,477,1619,2096,1298,4282.25,3438.67,479.67,1797.33,2277.0,1161.67,51387,41264,5756,21568,27324,13940,2022,'RIOLANDIA',Riolândia,'SP',3544202,5982.0,5982,498.5,498.5,1,376.0,376.0,Pequeno I
3741,3763,354425,8080,6453,1272,3183,4455,1998,7641.58,6171.25,1255.5,2902.83,4158.33,2012.92,91699,74055,15066,34834,49900,24155,2022,'ROSANA',Rosana,'SP',3544251,924.0,924,102.7,102.7,1,94.0,94.0,Pequeno I
3742,3764,354430,5076,4347,410,2608,3018,1329,4591.25,4024.83,350.75,2482.33,2833.08,1191.75,55095,48298,4209,29788,33997,14301,2022,'ROSEIRA',Roseira,'SP',3544301,1801.0,1801,200.1,200.1,1,,,Pequeno I
3743,3765,354440,1755,1258,169,568,737,521,1721.5,1266.25,169.25,578.17,747.42,518.83,20658,15195,2031,6938,8969,6226,2022,'RUBIACEA',Rubiácea,'SP',3544400,887.0,887,80.6,80.6,1,70.0,70.0,Pequeno I
3744,3766,354450,1543,991,169,252,421,570,1425.5,981.25,157.42,264.33,421.75,559.5,17106,11775,1889,3172,5061,6714,2022,'RUBINEIA',Rubinéia,'SP',3544509,1103.0,1103,91.9,91.9,1,51.0,51.0,Pequeno I
3745,3767,354460,2444,1874,479,563,1042,832,2356.58,1837.75,395.83,711.67,1107.5,730.25,28279,22053,4750,8540,13290,8763,2022,'SABINO',Sabino,'SP',3544608,197.0,197,65.7,65.7,1,,,Pequeno I
3746,3768,354470,1254,892,103,244,347,545,1230.75,945.75,69.83,375.17,445.0,500.75,14769,11349,838,4502,5340,6009,2022,'SAGRES',Sagres,'SP',3544707,843.0,843,70.2,70.2,1,120.0,120.0,Pequeno I
3747,3769,354480,3574,2671,254,1574,1828,843,3389.67,2562.83,241.5,1536.33,1777.83,785.0,40676,30754,2898,18436,21334,9420,2022,'SALES',Sales,'SP',3544806,2923.0,2923,292.3,292.3,1,296.0,296.0,Pequeno I
3748,3770,354490,2746,2175,430,901,1331,844,2624.83,2111.5,409.25,899.58,1308.83,802.67,31498,25338,4911,10795,15706,9632,2022,'SALES OLIVEIRA',Sales Oliveira,'SP',3544905,850.0,850,85.0,85.0,1,63.0,63.0,Pequeno I
3749,3771,354500,7302,6352,1854,1975,3829,2523,6805.92,5998.92,1793.75,1832.17,3625.92,2373.0,81671,71987,21525,21986,43511,28476,2022,'SALESOPOLIS',Salesópolis,'SP',3545001,2560.0,2560,213.3,213.3,1,201.0,201.0,Pequeno I
3750,3772,354510,2423,2048,221,1032,1253,795,2296.67,1980.92,183.75,1085.25,1269.0,711.92,27560,23771,2205,13023,15228,8543,2022,'SALMOURAO',Salmourão,'SP',3545100,179.0,179,16.3,16.3,1,12.0,12.0,Pequeno I
3751,3773,354515,1494,1134,197,348,545,589,1305.0,1015.0,169.75,347.92,517.67,497.33,15660,12180,2037,4175,6212,5968,2022,'SALTINHO',Saltinho,'SP',3545159,4329.0,4329,360.8,360.8,1,420.0,420.0,Pequeno I
3752,3774,354520,26041,20463,3011,10607,13618,6845,22967.67,18065.83,2636.25,9517.25,12153.5,5912.33,275612,216790,31635,114207,145842,70948,2022,'SALTO',Salto,'SP',3545209,12192.0,12192,1016.0,1016.0,4,1164.0,1164.0,Grande
3753,3775,354530,16385,13863,3627,4917,8544,5319,14999.33,12824.25,3101.25,4861.67,7962.92,4861.33,179992,153891,37215,58340,95555,58336,2022,'SALTO DE PIRAPORA',Salto de Pirapora,'SP',3545308,678.0,678,339.0,339.0,1,,,Pequeno II
3754,3776,354540,3909,3138,580,1319,1899,1239,3851.25,3162.0,621.92,1295.0,1916.92,1245.08,46215,37944,7463,15540,23003,14941,2022,'SALTO GRANDE',Salto Grande,'SP',3545407,3180.0,3180,265.0,265.0,1,280.0,280.0,Pequeno I
3755,3777,354550,1843,1570,240,734,974,596,1762.25,1524.83,236.58,752.58,989.17,535.67,21147,18298,2839,9031,11870,6428,2022,'SANDOVALINA',Sandovalina,'SP',3545506,675.0,675,56.2,56.2,1,32.0,32.0,Pequeno I
3756,3778,354560,6011,3789,439,2015,2454,1335,5973.0,3861.25,448.33,1975.17,2423.5,1437.75,71676,46335,5380,23702,29082,17253,2022,'SANTA ADELIA',Santa Adélia,'SP',3545605,647.0,647,58.8,58.8,1,85.0,85.0,Pequeno I
3757,3779,354570,2817,1474,290,221,511,963,3205.0,1584.83,339.0,217.58,556.58,1028.25,38460,19018,4068,2611,6679,12339,2022,'SANTA ALBERTINA',Santa Albertina,'SP',3545704,3946.0,3946,328.8,328.8,1,78.0,78.0,Pequeno I
3758,3780,354580,27780,21367,3499,10487,13986,7381,25641.08,19734.0,3220.58,9749.0,12969.58,6764.42,307693,236808,38647,116988,155635,81173,2022,'SANTA BARBARA DOESTE',Santa Bárbara D´oeste,'SP',3545803,17789.0,17789,1482.4,1482.4,5,1311.0,1311.0,Grande
3759,3781,354600,6374,5294,810,2892,3702,1592,5949.33,5054.5,748.92,2895.0,3643.92,1410.58,71392,60654,8987,34740,43727,16927,2022,'SANTA BRANCA',Santa Branca,'SP',3546009,6465.0,6465,538.8,538.8,1,432.0,432.0,Pequeno I
3760,3782,354610,1399,885,98,401,499,386,1340.42,869.75,93.75,387.42,481.17,388.58,16085,10437,1125,4649,5774,4663,2022,'SANTA CLARA DOESTE',Santa Clara D´oeste,'SP',3546108,1983.0,1983,165.2,165.2,1,142.0,142.0,Pequeno I
3761,3784,354625,1159,839,78,361,439,400,944.75,679.92,115.83,169.5,285.33,394.58,11337,8159,1390,2034,3424,4735,2022,'SANTA CRUZ DA ESPERANCA',Santa Cruz da Esperança,'SP',3546256,2122.0,2122,176.8,176.8,1,168.0,168.0,Pequeno I
3762,3785,354630,7997,7035,2105,1769,3874,3161,7531.83,6648.67,1973.67,1745.33,3719.0,2929.67,90382,79784,23684,20944,44628,35156,2022,'SANTA CRUZ DAS PALMEIRAS',Santa Cruz Das Palmeiras,'SP',3546306,4190.0,4190,380.9,380.9,1,,,Pequeno II
3763,3786,354640,12632,10551,1547,5034,6581,3970,11442.42,9603.67,1426.17,4338.25,5764.42,3839.25,137309,115244,17114,52059,69173,46071,2022,'SANTA CRUZ DO RIO PARDO',Santa Cruz do Rio Pardo,'SP',3546405,9392.0,9392,782.7,782.7,3,617.0,617.0,Pequeno II
3764,3787,354650,2630,2268,452,1096,1548,720,2530.92,2215.83,327.5,1211.17,1538.67,677.17,30371,26590,3930,14534,18464,8126,2022,'SANTA ERNESTINA',Santa Ernestina,'SP',3546504,330.0,330,33.0,33.0,1,25.0,25.0,Pequeno I
3765,3788,354660,9886,6899,1010,2738,3748,3151,9324.5,6513.58,873.58,2645.58,3519.17,2994.42,111894,78163,10483,31747,42230,35933,2022,'SANTA FE DO SUL',Santa fé do Sul,'SP',3546603,5439.0,5439,453.2,453.2,1,348.0,348.0,Pequeno II
3766,3789,354670,3703,2836,635,791,1426,1410,3418.42,2676.0,583.92,903.58,1487.5,1188.5,41021,32112,7007,10843,17850,14262,2022,'SANTA GERTRUDES',Santa Gertrudes,'SP',3546702,782.0,782,71.1,71.1,1,82.0,82.0,Pequeno II
3767,3790,354680,18501,15886,2757,9017,11774,4112,16331.25,13982.25,2587.08,7884.17,10471.25,3511.0,195975,167787,31045,94610,125655,42132,2022,'SANTA ISABEL',Santa Isabel,'SP',3546801,13968.0,13968,1269.8,1269.8,1,1208.0,1208.0,Médio
3768,3791,354690,1883,1480,234,541,775,705,1776.25,1424.92,269.08,496.08,765.17,659.75,21315,17099,3229,5953,9182,7917,2022,'SANTA LUCIA',Santa Lúcia,'SP',3546900,560.0,560,46.7,46.7,1,32.0,32.0,Pequeno I
3769,3792,354700,2711,2102,287,1038,1325,777,2648.58,2087.92,267.25,1045.0,1312.25,775.67,31783,25055,3207,12540,15747,9308,2022,'SANTA MARIA DA SERRA',Santa Maria da Serra,'SP',3547007,6459.0,6459,538.2,538.2,1,276.0,276.0,Pequeno I
3770,3793,354710,1463,1061,121,421,542,519,1444.33,1100.75,128.58,444.25,572.83,527.92,17332,13209,1543,5331,6874,6335,2022,'SANTA MERCEDES',Santa Mercedes,'SP',3547106,2955.0,2955,268.6,268.6,1,337.0,337.0,Pequeno I
3771,3794,354720,865,506,143,145,288,218,809.08,472.58,155.75,127.25,283.0,189.58,9709,5671,1869,1527,3396,2275,2022,'SANTANA DA PONTE PENSA',Santana da Ponte Pensa,'SP',3547205,316.0,316,28.7,28.7,1,50.0,50.0,Pequeno I
3772,3795,354730,37902,32184,4922,17976,22898,9286,33829.0,28850.5,4146.67,16474.5,20621.17,8229.33,405948,346206,49760,197694,247454,98752,2022,'SANTANA DE PARNAIBA',Santana de Parnaíba,'SP',3547304,73596.0,73596,6133.0,6133.0,6,5366.0,5366.0,Grande
3773,3796,354740,1043,516,106,65,171,345,971.5,504.83,96.83,66.33,163.17,341.67,11658,6058,1162,796,1958,4100,2022,'SANTA RITA DOESTE',Santa Rita D´oeste,'SP',3547403,379.0,379,37.9,37.9,1,,,Pequeno I
3774,3797,354750,7348,5484,966,2038,3004,2480,7668.67,5778.5,948.58,2190.08,3138.67,2639.83,92024,69342,11383,26281,37664,31678,2022,'SANTA RITA DO PASSA QUATRO,Santa Rita do Passa Quatro,'SP',3547502,2710.0,2710,387.1,387.1,1,232.0,232.0,Pequeno II
3775,3798,354760,6869,5528,1229,1758,2987,2541,6481.75,5264.25,1209.17,1756.75,2965.92,2298.33,77781,63171,14510,21081,35591,27580,2022,'SANTA ROSA DE VITERBO',Santa Rosa de Viterbo,'SP',3547601,2062.0,2062,171.8,171.8,1,95.0,95.0,Pequeno II
3776,3799,354765,1090,572,68,156,224,348,1062.0,556.17,70.83,154.42,225.25,330.92,12744,6674,850,1853,2703,3971,2022,'SANTA SALETE',Santa Salete,'SP',3547650,202.0,202,16.8,16.8,1,20.0,20.0,Pequeno I
3777,3800,354770,7266,5732,1192,2370,3562,2170,6919.75,5584.58,1089.25,2375.08,3464.33,2120.25,83037,67015,13071,28501,41572,25443,2022,'SANTO ANASTACIO',Santo Anastácio,'SP',3547700,2540.0,2540,211.7,211.7,1,150.0,150.0,Pequeno II
3778,3801,354780,185071,151360,12684,99940,112624,38736,167392.42,138367.83,12026.08,90501.67,102527.75,35840.08,2008709,1660414,144313,1086020,1230333,430081,2022,'SANTO ANDRE',Santo André,'SP',3547809,128135.0,141949,10677.9,11829.1,9,3492.0,3492.0,Grande
3779,3802,354790,2959,2551,246,1522,1768,783,3014.42,2616.08,242.92,1610.5,1853.42,762.67,36173,31393,2915,19326,22241,9152,2022,'SANTO ANTONIO DA ALEGRIA',Santo Antônio da Alegria,'SP',3547908,6634.0,6634,552.8,552.8,1,530.0,530.0,Pequeno I
3780,3803,354800,8313,6811,1612,2401,4013,2798,7708.0,6505.75,1438.75,2704.33,4143.08,2362.67,92496,78069,17265,32452,49717,28352,2022,'SANTO ANTONIO DE POSSE',Santo Antônio de Posse,'SP',3548005,833.0,833,119.0,119.0,1,110.0,110.0,Pequeno II
3781,3804,354805,3867,3183,285,1932,2217,966,3558.58,2932.42,276.0,1774.83,2050.83,881.58,42703,35189,3312,21298,24610,10579,2022,'SANTO ANTONIO DO ARACANGUA,Santo Antônio do Aracanguá,'SP',3548054,810.0,810,162.0,162.0,1,180.0,180.0,Pequeno I
3782,3805,354810,1965,1382,272,344,616,766,2000.75,1442.25,267.25,399.92,667.17,775.08,24009,17307,3207,4799,8006,9301,2022,'SANTO ANTONIO DO JARDIM',Santo Antônio do Jardim,'SP',3548104,2367.0,2367,236.7,236.7,1,165.0,165.0,Pequeno I
3783,3806,354820,3168,2539,528,714,1242,1297,3034.75,2463.83,531.33,666.83,1198.17,1265.67,36417,29566,6376,8002,14378,15188,2022,'SANTO ANTONIO DO PINHAL',Santo Antônio do Pinhal,'SP',3548203,3004.0,3004,273.1,273.1,1,219.0,219.0,Pequeno I
3784,3807,354830,1522,994,215,308,523,471,1409.25,972.25,226.33,300.58,526.92,445.33,16911,11667,2716,3607,6323,5344,2022,'SANTO EXPEDITO',Santo Expedito,'SP',3548302,385.0,385,38.5,38.5,1,,,Pequeno I
3785,3808,354840,2590,1679,156,836,992,687,2507.5,1722.25,166.0,874.67,1040.67,681.58,30090,20667,1992,10496,12488,8179,2022,'SANTOPOLIS DO AGUAPEI',Santópolis do Aguapeí,'SP',3548401,801.0,801,133.5,133.5,1,125.0,125.0,Pequeno I
3786,3809,354850,67210,54166,5806,33852,39658,14508,61952.83,50200.0,5596.67,30825.92,36422.58,13777.42,743434,602400,67160,369911,437071,165329,2022,'SANTOS',Santos,'SP',3548500,124967.0,181801,10413.9,15150.1,8,9169.0,12350.0,Grande
3787,3810,354860,5401,3962,632,1374,2006,1956,5160.83,3813.0,660.92,1303.58,1964.5,1848.5,61930,45756,7931,15643,23574,22182,2022,'SAO BENTO DO SAPUCAI',São Bento do Sapucaí,'SP',3548609,3337.0,3337,278.1,278.1,1,232.0,232.0,Pequeno I
3788,3811,354870,199622,166583,15340,105914,121254,45329,180614.0,151953.17,14356.42,96784.83,111141.25,40811.92,2167368,1823438,172277,1161418,1333695,489743,2022,'SAO BERNARDO DO CAMPO',São Bernardo do Campo,'SP',3548708,31014.0,35162,2584.5,2930.2,5,3433.0,3433.0,Grande
3789,3812,354880,18581,11347,1579,4279,5858,5489,16813.0,10064.25,1382.33,3518.58,4900.92,5163.33,201756,120771,16588,42223,58811,61960,2022,'SAO CAETANO DO SUL',São Caetano do Sul,'SP',3548807,18395.0,34417,1532.9,2868.1,2,1002.0,1002.0,Grande
3790,3813,354890,53946,45609,6756,24975,31731,13878,48110.58,41003.67,6103.25,22765.25,28868.5,12135.17,577327,492044,73239,273183,346422,145622,2022,'SAO CARLOS',São Carlos,'SP',3548906,25418.0,25418,2118.2,2118.2,6,1855.0,1855.0,Grande
3791,3814,354900,1106,816,217,247,464,352,1093.5,832.08,200.92,254.83,455.75,376.33,13122,9985,2411,3058,5469,4516,2022,'SAO FRANCISCO',São Francisco,'SP',3549003,1337.0,1337,111.4,111.4,1,67.0,67.0,Pequeno I
3792,3815,354910,18963,13770,3339,3389,6728,7042,17692.83,13207.08,3127.08,3149.33,6276.42,6930.67,212314,158485,37525,37792,75317,83168,2022,'SAO JOAO DA BOA VISTA',São João da Boa Vista,'SP',3549102,17271.0,17271,1439.2,1439.2,2,969.0,969.0,Médio
3793,3816,354920,1533,922,130,187,317,605,1497.5,935.92,138.42,183.0,321.42,614.5,17970,11231,1661,2196,3857,7374,2022,'SAO JOAO DAS DUAS PONTES',São João Das Duas Pontes,'SP',3549201,241.0,241,30.1,30.1,1,32.0,32.0,Pequeno I
3794,3817,354925,962,623,68,126,194,429,905.25,614.67,67.75,144.92,212.67,402.0,10863,7376,813,1739,2552,4824,2022,'SAO JOAO DE IRACEMA',São João de Iracema,'SP',3549250,297.0,297,24.8,24.8,1,19.0,19.0,Pequeno I
3795,3818,354930,1041,779,96,359,455,324,1008.0,773.67,100.83,354.33,455.17,318.5,12096,9284,1210,4252,5462,3822,2022,'SAO JOAO DO PAU DALHO',São João do Pau D´alho,'SP',3549300,150.0,150,30.0,30.0,1,,,Pequeno I
3796,3819,354940,8870,7215,2206,2267,4473,2742,8080.33,6628.42,2121.17,1935.17,4056.33,2572.08,96964,79541,25454,23222,48676,30865,2022,'SAO JOAQUIM DA BARRA',São Joaquim da Barra,'SP',3549409,4869.0,4869,442.6,442.6,1,284.0,284.0,Pequeno II
3797,3820,354950,4509,4054,343,2747,3090,964,4311.58,3881.58,304.5,2713.5,3018.0,863.58,51739,46579,3654,32562,36216,10363,2022,'SAO JOSE DA BELA VISTA',São José da Bela Vista,'SP',3549508,457.0,457,41.5,41.5,1,46.0,46.0,Pequeno I
3798,3821,354960,2586,2074,311,821,1132,942,2544.25,2116.25,298.08,905.83,1203.92,912.33,30531,25395,3577,10870,14447,10948,2022,'SAO JOSE DO BARREIRO',São José do Barreiro,'SP',3549607,861.0,861,86.1,86.1,1,18.0,18.0,Pequeno I
3799,3822,354970,14042,12190,1249,7948,9197,2993,13126.0,11445.0,1256.25,7442.92,8699.17,2745.83,157512,137340,15075,89315,104390,32950,2022,'SAO JOSE DO RIO PARDO',São José do Rio Pardo,'SP',3549706,6407.0,6407,533.9,533.9,3,650.0,650.0,Médio
3800,3823,354980,101284,79038,10037,46925,56962,22076,93395.0,73063.33,8565.67,43702.58,52268.25,20795.08,1120740,876760,102788,524431,627219,249541,2022,'SAO JOSE DO RIO PRETO',São José do Rio Preto,'SP',3549805,122638.0,122638,10219.8,10219.8,13,9711.0,9711.0,Grande
3801,3824,354990,230572,183156,14972,116798,131770,51386,209933.67,169375.75,13877.17,108440.5,122317.67,47058.08,2519204,2032509,166526,1301286,1467812,564697,2022,'SAO JOSE DOS CAMPOS',São José Dos Campos,'SP',3549904,142951.0,195593,11912.6,16299.4,9,11523.0,11523.0,Grande
3802,3825,354995,8206,7023,375,5499,5874,1149,7548.5,6506.92,377.25,5063.08,5440.33,1066.58,90582,78083,4527,60757,65284,12799,2022,'SAO LOURENCO DA SERRA',São Lourenço da Serra,'SP',3549953,2513.0,2513,279.2,279.2,1,185.0,185.0,Pequeno I
3803,3826,355000,4485,3773,710,1741,2451,1322,4319.58,3680.17,655.08,1763.92,2419.0,1261.17,51835,44162,7861,21167,29028,15134,2022,'SAO LUIS DO PARAITINGA',São Luís do Paraitinga,'SP',3550001,3156.0,3156,394.5,394.5,1,400.0,400.0,Pequeno I
3804,3827,355010,13041,9505,3001,2092,5093,4412,12354.92,9021.0,2841.92,1953.08,4795.0,4226.0,148259,108252,34103,23437,57540,50712,2022,'SAO MANUEL',São Manuel,'SP',3550100,10629.0,10629,885.8,885.8,1,677.0,677.0,Pequeno II
3805,3828,355020,10901,9464,2389,3536,5925,3539,10879.25,9198.5,2091.08,3715.25,5806.33,3392.17,130551,110382,25093,44583,69676,40706,2022,'SAO MIGUEL ARCANJO',São Miguel Arcanjo,'SP',3550209,3691.0,3691,307.6,307.6,1,273.0,273.0,Pequeno II
3806,3829,355030,4043470,3232653,483991,1667560,2151551,1081102,3832191.17,3081038.75,450571.5,1591584.33,2042155.83,1038882.92,45986294,36972465,5406858,19099012,24505870,12466595,2022,'SAO PAULO',São Paulo,'SP',3550308,901863.0,953701,75155.2,79475.1,54,75198.0,83322.0,Metrópole
3807,3830,355040,9929,8651,899,6254,7153,1498,8701.92,7638.92,658.83,5760.33,6419.17,1219.75,104423,91667,7906,69124,77030,14637,2022,'SAO PEDRO',São Pedro,'SP',3550407,8360.0,8360,760.0,760.0,1,751.0,751.0,Pequeno II
3808,3831,355050,2993,2469,604,944,1548,921,2735.5,2288.42,568.75,956.0,1524.75,763.67,32826,27461,6825,11472,18297,9164,2022,'SAO PEDRO DO TURVO',São Pedro do Turvo,'SP',3550506,4098.0,4098,341.5,341.5,1,159.0,159.0,Pequeno I
3809,3832,355060,21466,17670,3186,8851,12037,5633,19384.83,16000.75,2863.83,7999.17,10863.0,5137.75,232618,192009,34366,95990,130356,61653,2022,'SAO ROQUE',São Roque,'SP',3550605,15836.0,15836,1319.7,1319.7,4,927.0,927.0,Médio
3810,3833,355070,31872,28202,3662,17419,21081,7121,28998.83,25804.42,3292.0,16089.25,19381.25,6423.17,347986,309653,39504,193071,232575,77078,2022,'SAO SEBASTIAO',São Sebastião,'SP',3550704,22530.0,22530,1877.5,1877.5,3,1435.0,1435.0,Médio
3811,3834,355080,3269,2460,600,358,958,1502,3055.33,2331.83,565.42,341.75,907.17,1424.67,36664,27982,6785,4101,10886,17096,2022,'SAO SEBASTIAO DA GRAMA',São Sebastião da Grama,'SP',3550803,5602.0,5602,466.8,466.8,1,363.0,363.0,Pequeno I
3812,3835,355090,4356,3769,728,1791,2519,1250,3987.83,3499.08,667.83,1688.25,2356.08,1143.0,47854,41989,8014,20259,28273,13716,2022,'SAO SIMAO',São Simão,'SP',3550902,2013.0,2013,167.8,167.8,1,162.0,162.0,Pequeno I
3813,3836,355100,88705,79088,9486,53653,63139,15949,71465.08,63134.0,8563.75,40805.17,49368.92,13765.08,857581,757608,102765,489662,592427,165181,2022,'SAO VICENTE',São Vicente,'SP',3551009,42493.0,125433,3541.1,10452.8,5,2571.0,6007.0,Grande
3814,3837,355110,3107,2568,521,155,676,1892,2859.92,2430.92,670.67,249.92,920.58,1510.33,34319,29171,8048,2999,11047,18124,2022,'SARAPUI',Sarapuí,'SP',3551108,260.0,260,52.0,52.0,1,60.0,60.0,Pequeno I
3815,3838,355120,2254,1845,257,863,1120,725,2134.58,1780.0,233.83,808.5,1042.33,737.67,25615,21360,2806,9702,12508,8852,2022,'SARUTAIA',Sarutaiá,'SP',3551207,2845.0,2845,237.1,237.1,1,300.0,300.0,Pequeno I
3816,3839,355130,2136,1355,66,884,950,405,2067.92,1319.5,74.08,821.75,895.83,423.67,24815,15834,889,9861,10750,5084,2022,'SEBASTIANOPOLIS DO SUL',Sebastianópolis do Sul,'SP',3551306,1593.0,1593,132.8,132.8,1,99.0,99.0,Pequeno I
3817,3840,355140,5411,4842,197,4161,4358,484,5041.0,4523.25,223.17,3842.42,4065.58,457.67,60492,54279,2678,46109,48787,5492,2022,'SERRA AZUL',Serra Azul,'SP',3551405,3742.0,3742,340.2,340.2,1,254.0,254.0,Pequeno I
3818,3841,355150,14782,12782,1582,7917,9499,3283,13428.17,11700.83,1402.0,7310.67,8712.67,2988.17,161138,140410,16824,87728,104552,35858,2022,'SERRANA',Serrana,'SP',3551504,1906.0,1906,158.8,158.8,2,96.0,96.0,Pequeno II
3819,3842,355160,7527,6064,1513,1524,3037,3027,7003.0,5724.92,1349.92,1517.33,2867.25,2857.67,84036,68699,16199,18208,34407,34292,2022,'SERRA NEGRA',Serra Negra,'SP',3551603,3207.0,3207,267.2,267.2,1,211.0,211.0,Pequeno II
3820,3843,355170,36157,30809,5571,16563,22134,8675,33022.83,28436.67,4977.67,15449.42,20427.08,8009.58,396274,341240,59732,185393,245125,96115,2022,'SERTAOZINHO',Sertãozinho,'SP',3551702,48383.0,48383,4031.9,4031.9,5,4333.0,4333.0,Grande
3821,3844,355180,8466,7076,1551,3242,4793,2283,8154.08,6812.75,1421.58,3104.08,4525.67,2287.08,97849,81753,17059,37249,54308,27445,2022,'SETE BARRAS',Sete Barras,'SP',3551801,2650.0,2650,220.8,220.8,1,198.0,198.0,Pequeno I
3822,3845,355190,5812,5017,1977,1597,3574,1443,5540.08,4812.92,1595.67,2046.08,3641.75,1171.17,66481,57755,19148,24553,43701,14054,2022,'SEVERINIA',Severínia,'SP',3551900,6333.0,12806,527.8,1067.2,1,968.0,968.0,Pequeno I
3823,3846,355200,3068,2792,911,886,1797,995,2839.25,2613.75,771.92,1018.58,1790.5,823.25,34071,31365,9263,12223,21486,9879,2022,'SILVEIRAS',Silveiras,'SP',3552007,618.0,618,68.7,68.7,1,27.0,27.0,Pequeno I
3824,3847,355210,10200,8219,1988,3206,5194,3025,9373.75,7628.25,1590.83,3369.17,4960.0,2668.25,112485,91539,19090,40430,59520,32019,2022,'SOCORRO',Socorro,'SP',3552106,11975.0,11975,997.9,997.9,1,963.0,963.0,Pequeno II
3825,3848,355220,164601,140813,21647,74804,96451,44362,148685.92,128060.5,21398.92,65232.0,86630.92,41429.58,1784231,1536726,256787,782784,1039571,497155,2022,'SOROCABA',Sorocaba,'SP',3552205,68329.0,68329,5694.1,5694.1,12,3750.0,3750.0,Grande
3826,3849,355230,3636,2240,441,709,1150,1090,3423.25,2207.17,396.33,688.75,1085.08,1122.08,41079,26486,4756,8265,13021,13465,2022,'SUD MENNUCCI',Sud Mennucci,'SP',3552304,5102.0,5102,425.2,425.2,1,304.0,304.0,Pequeno I
3827,3850,355240,78611,61867,7398,35190,42588,19279,74175.67,58859.67,6917.42,33064.08,39981.5,18878.17,890108,706316,83009,396769,479778,226538,2022,'SUMARE',Sumaré,'SP',3552403,46830.0,105032,3902.5,8752.7,8,2722.0,8922.0,Grande
3828,3851,355250,127570,105133,23552,48017,71569,33564,116682.0,96651.42,21463.75,43417.75,64881.5,31769.92,1400184,1159817,257565,521013,778578,381239,2022,'SUZANO',Suzano,'SP',3552502,23313.0,23313,1942.8,1942.8,5,1088.0,1088.0,Grande
3829,3852,355255,1863,1183,141,344,485,698,1794.33,1180.92,127.5,381.42,508.92,672.0,21532,14171,1530,4577,6107,8064,2022,'SUZANAPOLIS',Suzanápolis,'SP',3552551,772.0,772,77.2,77.2,1,90.0,90.0,Pequeno I
3830,3853,355260,4281,3487,349,2252,2601,886,4118.17,3373.08,348.67,2136.33,2485.0,888.08,49418,40477,4184,25636,29820,10657,2022,'TABAPUA',Tabapuã,'SP',3552601,1467.0,1467,122.2,122.2,1,87.0,87.0,Pequeno I
3831,3854,355270,4133,3499,814,1347,2161,1338,3799.58,3246.0,732.17,1328.25,2060.42,1185.58,45595,38952,8786,15939,24725,14227,2022,'TABATINGA',Tabatinga,'SP',3552700,1652.0,1652,236.0,236.0,1,200.0,200.0,Pequeno I
3832,3855,355280,98777,79314,10538,42837,53375,25939,90951.08,73484.67,9593.67,39399.75,48993.42,24491.25,1091413,881816,115124,472797,587921,293895,2022,'TABOAO DA SERRA',Taboão da Serra,'SP',3552809,53158.0,53158,4429.8,4429.8,8,2975.0,2975.0,Grande
3833,3856,355290,2910,2498,485,1137,1622,876,2781.17,2387.58,424.5,1081.42,1505.92,881.67,33374,28651,5094,12977,18071,10580,2022,'TACIBA',Taciba,'SP',3552908,1347.0,1347,134.7,134.7,1,,,Pequeno I
3834,3857,355300,4688,4123,727,1663,2390,1733,4432.25,3928.5,745.17,1568.0,2313.17,1615.33,53187,47142,8942,18816,27758,19384,2022,'TAGUAI',Taguaí,'SP',3553005,3567.0,3567,324.3,324.3,1,204.0,204.0,Pequeno I
3835,3858,355310,2905,2375,344,1287,1631,744,2787.58,2321.33,326.67,1290.25,1616.92,704.42,33451,27856,3920,15483,19403,8453,2022,'TAIACU',Taiaçu,'SP',3553104,579.0,579,52.6,52.6,1,50.0,50.0,Pequeno I
3836,3860,355330,9005,7547,440,5396,5836,1711,8436.75,7151.75,392.08,5170.67,5562.75,1589.0,101241,85821,4705,62048,66753,19068,2022,'TAMBAU',Tambaú,'SP',3553302,370.0,370,185.0,185.0,1,,,Pequeno II
3837,3861,355340,10944,9366,1810,4664,6474,2892,10322.33,8878.25,1485.67,5048.67,6534.33,2343.92,123868,106539,17828,60584,78412,28127,2022,'TANABI',Tanabi,'SP',3553401,5616.0,5616,468.0,468.0,1,225.0,225.0,Pequeno II
3838,3862,355350,4587,3785,787,1527,2314,1471,4337.5,3619.75,746.75,1476.83,2223.58,1396.17,52050,43437,8961,17722,26683,16754,2022,'TAPIRAI',Tapiraí,'SP',3553500,4078.0,4078,339.8,339.8,1,421.0,421.0,Pequeno I
3839,3863,355360,3780,3220,411,1667,2078,1142,3475.5,2990.67,341.67,1706.58,2048.25,942.42,41706,35888,4100,20479,24579,11309,2022,'TAPIRATIBA',Tapiratiba,'SP',3553609,1979.0,1979,395.8,395.8,1,386.0,386.0,Pequeno I
3840,3864,355365,1054,698,121,192,313,385,1021.58,693.08,138.33,158.0,296.33,396.75,12259,8317,1660,1896,3556,4761,2022,'TAQUARAL',Taquaral,'SP',3553658,787.0,787,71.5,71.5,1,63.0,63.0,Pequeno I
3841,3865,355370,16843,14434,2829,7051,9880,4554,15459.75,13298.25,2565.67,6682.42,9248.08,4050.17,185517,159579,30788,80189,110977,48602,2022,'TAQUARITINGA',Taquaritinga,'SP',3553708,4743.0,4743,395.2,395.2,2,79.0,79.0,Médio
3842,3866,355380,9180,7628,1663,2492,4155,3473,8595.67,7226.92,1506.92,2446.58,3953.5,3273.42,103148,86723,18083,29359,47442,39281,2022,'TAQUARITUBA',Taquarituba,'SP',3553807,26112.0,28113,2176.0,2342.8,2,2091.0,2091.0,Pequeno II
3843,3867,355385,4212,3715,348,2193,2541,1174,4105.25,3692.17,353.58,2218.75,2572.33,1119.83,49263,44306,4243,26625,30868,13438,2022,'TAQUARIVAI',Taquarivaí,'SP',3553856,1641.0,1641,149.2,149.2,1,86.0,86.0,Pequeno I
3844,3868,355390,2584,2016,335,853,1188,828,2497.42,1965.92,350.42,808.92,1159.33,806.58,29969,23591,4205,9707,13912,9679,2022,'TARABAI',Tarabai,'SP',3553906,1546.0,1546,154.6,154.6,1,,,Pequeno I
3845,3869,355395,6009,4728,872,1678,2550,2178,5881.42,4717.75,844.75,1691.25,2536.0,2181.75,70577,56613,10137,20295,30432,26181,2022,'TARUMA',Tarumã,'SP',3553955,2562.0,2562,213.5,213.5,1,268.0,268.0,Pequeno I
3846,3870,355400,32150,27661,6771,10391,17162,10499,29912.92,25897.58,6263.33,9977.5,16240.83,9656.75,358955,310771,75160,119730,194890,115881,2022,'TATUI',Tatuí,'SP',3554003,46543.0,49562,3878.6,4130.2,4,3808.0,3808.0,Grande
3847,3871,355410,81234,60435,12885,21138,34023,26412,74396.83,55121.08,11774.58,18243.83,30018.42,25102.67,892762,661453,141295,218926,360221,301232,2022,'TAUBATE',Taubaté,'SP',3554102,12061.0,12061,1005.1,1005.1,5,652.0,652.0,Grande
3848,3872,355420,2256,1996,473,598,1071,925,2183.08,1956.42,513.25,603.83,1117.08,839.33,26197,23477,6159,7246,13405,10072,2022,'TEJUPA',Tejupá,'SP',3554201,1642.0,1642,136.8,136.8,1,28.0,28.0,Pequeno I
3849,3873,355430,11091,9234,1680,4705,6385,2849,10482.42,8766.92,1629.25,4315.25,5944.5,2822.42,125789,105203,19551,51783,71334,33869,2022,'TEODORO SAMPAIO',Teodoro Sampaio,'SP',3554300,1399.0,1399,116.6,116.6,1,82.0,82.0,Pequeno II
3850,3874,355440,2303,1664,279,304,583,1081,2254.58,1638.42,275.58,334.25,609.83,1028.58,27055,19661,3307,4011,7318,12343,2022,'TERRA ROXA',Terra Roxa,'SP',3554409,4491.0,4491,374.2,374.2,1,162.0,162.0,Pequeno I
3851,3875,355450,11015,8333,1341,3580,4921,3412,10039.42,7680.75,1236.17,3286.08,4522.25,3158.5,120473,92169,14834,39433,54267,37902,2022,'TIETE',Tietê,'SP',3554508,18172.0,18172,1514.3,1514.3,2,949.0,949.0,Pequeno II
3852,3876,355460,1411,1068,118,441,559,509,1371.5,1029.83,120.58,435.42,556.0,473.83,16458,12358,1447,5225,6672,5686,2022,'TIMBURI',Timburi,'SP',3554607,393.0,393,32.8,32.8,1,20.0,20.0,Pequeno I
3853,3877,355465,1291,1115,152,695,847,268,1288.08,1126.17,158.42,690.83,849.25,276.92,15457,13514,1901,8290,10191,3323,2022,'TORRE DE PEDRA',Torre de Pedra,'SP',3554656,694.0,694,77.1,77.1,1,102.0,102.0,Pequeno I
3854,3878,355470,3517,2339,680,722,1402,937,3290.58,2208.92,604.75,677.42,1282.17,926.75,39487,26507,7257,8129,15386,11121,2022,'TORRINHA',Torrinha,'SP',3554706,2256.0,2256,188.0,188.0,1,89.0,89.0,Pequeno I
3855,3879,355475,925,821,45,569,614,207,887.33,800.58,30.92,598.25,629.17,171.42,10648,9607,371,7179,7550,2057,2022,'TRABIJU',Trabiju,'SP',3554755,924.0,924,77.0,77.0,1,38.0,38.0,Pequeno I
3856,3880,355480,13790,12035,1957,7221,9178,2857,12707.0,11237.42,1661.08,7114.67,8775.75,2461.67,152484,134849,19933,85376,105309,29540,2022,'TREMEMBE',Tremembé,'SP',3554805,4178.0,4178,348.2,348.2,1,223.0,223.0,Pequeno II
3857,3881,355490,2868,1899,235,792,1027,872,2734.5,1841.83,209.0,799.75,1008.75,833.08,32814,22102,2508,9597,12105,9997,2022,'TRES FRONTEIRAS',Três Fronteiras,'SP',3554904,1614.0,1614,134.5,134.5,1,55.0,55.0,Pequeno I
3858,3882,355495,2915,2394,400,952,1352,1042,2685.5,2251.17,376.08,844.33,1220.42,1030.75,32226,27014,4513,10132,14645,12369,2022,'TUIUTI',Tuiuti,'SP',3554953,3375.0,3375,281.2,281.2,1,218.0,218.0,Pequeno I
3859,3883,355500,21202,15634,2403,6459,8862,6772,19905.08,14647.5,2267.75,5684.83,7952.58,6694.92,238861,175770,27213,68218,95431,80339,2022,'TUPA',Tupã,'SP',3555000,3922.0,3922,326.8,326.8,3,381.0,381.0,Médio
3860,3884,355510,3977,3049,535,1169,1704,1345,3800.92,2929.67,537.67,1113.67,1651.33,1278.33,45611,35156,6452,13364,19816,15340,2022,'TUPI PAULISTA',Tupi Paulista,'SP',3555109,180.0,180,15.0,15.0,1,15.0,15.0,Pequeno I
3861,3885,355520,875,535,118,114,232,303,923.58,597.17,118.83,164.25,283.08,314.08,11083,7166,1426,1971,3397,3769,2022,'TURIUBA',Turiúba,'SP',3555208,516.0,516,64.5,64.5,1,25.0,25.0,Pequeno I
3862,3886,355530,825,435,32,216,248,187,823.33,420.92,23.75,195.5,219.25,201.67,9880,5051,285,2346,2631,2420,2022,'TURMALINA',Turmalina,'SP',3555307,326.0,326,27.2,27.2,1,18.0,18.0,Pequeno I
3863,3887,355535,1668,1452,348,616,964,488,1645.58,1439.5,330.0,642.08,972.08,467.42,19747,17274,3960,7705,11665,5609,2022,'UBARANA',Ubarana,'SP',3555356,3801.0,3801,316.8,316.8,1,204.0,204.0,Pequeno I
3864,3888,355540,37764,33947,3972,23487,27459,6488,33010.83,29810.83,3424.08,20879.75,24303.83,5507.0,396130,357730,41089,250557,291646,66084,2022,'UBATUBA',Ubatuba,'SP',3555406,18637.0,18637,1553.1,1553.1,3,1188.0,1188.0,Médio
3865,3889,355550,2206,1973,268,1016,1284,689,2056.33,1850.5,237.92,936.67,1174.58,675.92,24676,22206,2855,11240,14095,8111,2022,'UBIRAJARA',Ubirajara,'SP',3555505,2532.0,2532,211.0,211.0,1,75.0,75.0,Pequeno I
3866,3890,355560,3405,2241,530,104,634,1607,3273.83,2228.25,555.42,116.58,672.0,1556.25,39286,26739,6665,1399,8064,18675,2022,'UCHOA',Uchoa,'SP',3555604,4894.0,4894,407.8,407.8,1,266.0,266.0,Pequeno I
3867,3891,355570,883,548,142,133,275,273,875.17,564.33,117.08,136.5,253.58,310.75,10502,6772,1405,1638,3043,3729,2022,'UNIAO PAULISTA',União Paulista,'SP',3555703,429.0,429,39.0,39.0,1,61.0,61.0,Pequeno I
3868,3892,355580,3479,2315,482,528,1010,1305,3248.0,2326.67,469.0,685.17,1154.17,1172.5,38976,27920,5628,8222,13850,14070,2022,'URANIA',Urânia,'SP',3555802,1123.0,1123,93.6,93.6,1,86.0,86.0,Pequeno I
3869,3893,355590,516,427,45,218,263,164,478.17,404.67,38.83,220.42,259.25,145.42,5738,4856,466,2645,3111,1745,2022,'URU',Uru,'SP',3555901,180.0,180,60.0,60.0,1,,,Pequeno I
3870,3894,355600,4142,2989,505,717,1222,1767,4174.5,3119.33,551.58,939.67,1491.25,1628.08,50094,37432,6619,11276,17895,19537,2022,'URUPES',Urupês,'SP',3556008,2428.0,2428,202.3,202.3,1,99.0,99.0,Pequeno I
3871,3895,355610,5840,4435,758,2175,2933,1502,5276.42,4061.17,534.83,2051.17,2586.0,1475.17,63317,48734,6418,24614,31032,17702,2022,'VALENTIM GENTIL',Valentim Gentil,'SP',3556107,705.0,705,100.7,100.7,1,45.0,45.0,Pequeno I
3872,3896,355620,16085,13270,1745,7052,8797,4473,15117.67,12458.17,1640.17,6563.5,8203.67,4254.5,181412,149498,19682,78762,98444,51054,2022,'VALINHOS',Valinhos,'SP',3556206,30424.0,30424,2535.3,2535.3,4,1590.0,1590.0,Grande
3873,3897,355630,8134,6429,796,3494,4290,2139,7644.75,6177.33,833.0,3363.42,4196.42,1980.92,91737,74128,9996,40361,50357,23771,2022,'VALPARAISO',Valparaíso,'SP',3556305,5350.0,5350,445.8,445.8,1,375.0,375.0,Pequeno II
3874,3898,355635,3332,2626,420,858,1278,1348,3035.08,2456.75,411.25,803.92,1215.17,1241.58,36421,29481,4935,9647,14582,14899,2022,'VARGEM',Vargem,'SP',3556354,3268.0,3268,272.3,272.3,1,147.0,147.0,Pequeno I
3875,3899,355640,11318,8433,2044,1502,3546,4887,10565.0,8106.67,1864.25,1986.42,3850.67,4256.0,126780,97280,22371,23837,46208,51072,2022,'VARGEM GRANDE DO SUL',Vargem Grande do Sul,'SP',3556404,3704.0,3704,336.7,336.7,1,193.0,193.0,Pequeno II
3876,3900,355645,12540,10180,1636,5208,6844,3336,12325.83,10170.25,1607.42,5382.0,6989.42,3180.83,147910,122043,19289,64584,83873,38170,2022,'VARGEM GRANDE PAULISTA',Vargem Grande Paulista,'SP',3556453,2750.0,2750,229.2,229.2,2,165.0,165.0,Pequeno II
3877,3901,355650,24390,21006,4375,9725,14100,6906,21141.92,18178.17,4058.92,7808.08,11867.0,6311.17,253703,218138,48707,93697,142404,75734,2022,'VARZEA PAULISTA',Várzea Paulista,'SP',3556503,25255.0,25255,2104.6,2104.6,3,1376.0,1376.0,Grande
3878,3902,355660,4191,3130,516,540,1056,2074,4061.92,3160.42,533.42,820.42,1353.83,1806.58,48743,37925,6401,9845,16246,21679,2022,'VERA CRUZ',Vera Cruz,'SP',3556602,663.0,663,55.2,55.2,1,21.0,21.0,Pequeno I
3879,3903,355670,13726,10496,1634,4670,6304,4192,12285.75,9375.75,1452.33,4197.58,5649.92,3725.83,147429,112509,17428,50371,67799,44710,2022,'VINHEDO',Vinhedo,'SP',3556701,16967.0,16967,1542.5,1542.5,3,1243.0,1243.0,Médio
3880,3904,355680,8924,5173,1512,340,1852,3321,8723.67,5036.0,1434.08,393.25,1827.33,3208.67,104684,60432,17209,4719,21928,38504,2022,'VIRADOURO',Viradouro,'SP',3556800,2549.0,2549,231.7,231.7,1,182.0,182.0,Pequeno I
3881,3905,355690,2462,1909,604,20,624,1285,2443.42,1925.25,594.42,32.42,626.83,1298.42,29321,23103,7133,389,7522,15581,2022,'VISTA ALEGRE DO ALTO',Vista Alegre do Alto,'SP',3556909,1645.0,1645,137.1,137.1,1,86.0,86.0,Pequeno I
3882,3906,355695,839,562,57,86,143,419,793.08,536.67,53.75,79.92,133.67,403.0,9517,6440,645,959,1604,4836,2022,'VITORIA BRASIL',Vitória Brasil,'SP',3556958,2115.0,2115,192.3,192.3,1,110.0,110.0,Pequeno I
3883,3907,355700,27558,24077,3341,13849,17190,6887,24754.58,21727.75,3081.92,12416.58,15498.5,6229.25,297055,260733,36983,148999,185982,74751,2022,'VOTORANTIM',Votorantim,'SP',3557006,16864.0,16864,1405.3,1405.3,3,1178.0,1178.0,Grande
3884,3908,355710,28729,21475,3490,9854,13344,8131,26000.42,19684.58,3118.92,9153.75,12272.67,7411.92,312005,236215,37427,109845,147272,88943,2022,'VOTUPORANGA',Votuporanga,'SP',3557105,18302.0,18302,1830.2,1830.2,4,1545.0,1545.0,Médio
3885,3909,355715,1481,918,249,162,411,507,1421.92,890.75,211.25,159.92,371.17,519.58,17063,10689,2535,1919,4454,6235,2022,'ZACARIAS',Zacarias,'SP',3557154,922.0,922,76.8,76.8,1,42.0,42.0,Pequeno I
3886,3910,355720,4688,4006,724,1985,2709,1297,4465.17,3879.42,609.75,2015.0,2624.75,1254.67,53582,46553,7317,24180,31497,15056,2022,'CHAVANTES',Chavantes,'SP',3557204,4499.0,4499,374.9,374.9,1,300.0,300.0,Pequeno I
3887,3911,355730,3279,2807,343,1483,1826,981,3022.5,2634.33,356.42,1381.83,1738.25,896.08,36270,31612,4277,16582,20859,10753,2022,'ESTIVA GERBI',Estiva Gerbi,'SP',3557303,8029.0,8029,669.1,669.1,1,300.0,300.0,Pequeno I
3888,3912,410010,3968,3185,731,692,1423,1762,3778.25,3111.75,712.42,693.67,1406.08,1705.67,45339,37341,8549,8324,16873,20468,2022,'ABATIA',Abatiá,'PR',4100103,6841.0,6841,684.1,684.1,1,386.0,386.0,Pequeno I
3889,3913,410020,3608,2847,828,667,1495,1352,3445.5,2804.83,757.58,727.83,1485.42,1319.42,41346,33658,9091,8734,17825,15833,2022,'ADRIANOPOLIS',Adrianópolis,'PR',4100202,2584.0,2584,234.9,234.9,1,345.0,345.0,Pequeno I
3890,3914,410030,5154,4579,688,2339,3027,1552,4797.5,4341.75,611.08,2396.58,3007.67,1334.08,57570,52101,7333,28759,36092,16009,2022,'AGUDOS DO SUL',Agudos do Sul,'PR',4100301,4042.0,4042,336.8,336.8,1,294.0,294.0,Pequeno I
3891,3915,410040,46682,37774,8506,11254,19760,18014,42354.83,34814.25,7806.58,11013.83,18820.42,15993.83,508258,417771,93679,132166,225845,191926,2022,'ALMIRANTE TAMANDARE',Almirante Tamandaré,'PR',4100400,44355.0,44355,3696.2,3696.2,4,1750.0,1750.0,Grande
3892,3916,410045,2310,1822,415,435,850,972,2307.58,1825.83,376.33,557.17,933.5,892.33,27691,21910,4516,6686,11202,10708,2022,'ALTAMIRA DO PARANA',Altamira do Paraná,'PR',4100459,1971.0,1971,164.2,164.2,1,187.0,187.0,Pequeno I
3893,3917,410050,6501,5126,938,1658,2596,2530,6259.58,4969.42,844.58,1797.0,2641.58,2327.83,75115,59633,10135,21564,31699,27934,2022,'ALTONIA',Altônia,'PR',4100509,4594.0,4594,382.8,382.8,1,199.0,199.0,Pequeno II
3894,3918,410060,6629,5707,1557,1451,3008,2699,6398.08,5529.33,1413.75,1541.08,2954.83,2574.5,76777,66352,16965,18493,35458,30894,2022,'ALTO PARANA',Alto Paraná,'PR',4100608,4236.0,4236,353.0,353.0,1,230.0,230.0,Pequeno I
3895,3919,410070,5709,4509,978,1539,2517,1992,5486.17,4470.33,928.75,1487.0,2415.75,2054.58,65834,53644,11145,17844,28989,24655,2022,'ALTO PIQUIRI',Alto Piquiri,'PR',4100707,687.0,687,57.2,57.2,1,47.0,47.0,Pequeno I
3896,3920,410080,4153,3364,771,643,1414,1950,3949.42,3212.33,765.75,640.5,1406.25,1806.08,47393,38548,9189,7686,16875,21673,2022,'ALVORADA DO SUL',Alvorada do Sul,'PR',4100806,1994.0,1994,166.2,166.2,1,67.0,67.0,Pequeno I
3897,3921,410090,3111,2729,327,1422,1749,980,3001.08,2684.42,269.5,1534.5,1804.0,880.42,36013,32213,3234,18414,21648,10565,2022,'AMAPORA',Amaporã,'PR',4100905,3048.0,3048,254.0,254.0,1,160.0,160.0,Pequeno I
3898,3922,410100,6862,5028,986,416,1402,3626,6438.92,4824.83,955.92,458.67,1414.58,3410.25,77267,57898,11471,5504,16975,40923,2022,'AMPERE',Ampére,'PR',4101002,6955.0,6955,579.6,579.6,1,324.0,324.0,Pequeno I
3899,3923,410105,1545,1092,84,540,624,468,1425.0,996.25,89.58,420.0,509.58,486.67,17100,11955,1075,5040,6115,5840,2022,'ANAHY',Anahy,'PR',4101051,1812.0,1812,151.0,151.0,1,189.0,189.0,Pequeno I
3900,3924,410110,9269,7295,1029,3492,4521,2774,8963.58,7124.58,1022.25,3323.58,4345.83,2778.75,107563,85495,12267,39883,52150,33345,2022,'ANDIRA',Andirá,'PR',4101101,12695.0,14981,1057.9,1248.4,1,1041.0,1041.0,Pequeno II
3901,3925,410115,1643,1307,190,435,625,682,1603.25,1296.25,186.75,461.25,648.0,648.25,19239,15555,2241,5535,7776,7779,2022,'ANGULO',Ângulo,'PR',4101150,1225.0,1225,102.1,102.1,1,50.0,50.0,Pequeno I
3902,3926,410120,9461,8720,1391,5517,6908,1812,8694.08,8046.75,1246.17,5071.0,6317.17,1729.58,104329,96561,14954,60852,75806,20755,2022,'ANTONINA',Antonina,'PR',4101200,7953.0,7953,662.8,662.8,1,502.0,502.0,Pequeno I
3903,3927,410130,3904,3554,536,2041,2577,977,3766.67,3437.08,529.42,1929.0,2458.42,978.67,45200,41245,6353,23148,29501,11744,2022,'ANTONIO OLINTO',Antônio Olinto,'PR',4101309,2328.0,2328,211.6,211.6,1,170.0,170.0,Pequeno I
3904,3928,410140,49688,37082,7500,10907,18407,18675,46600.67,35316.67,7024.58,10049.33,17073.92,18242.75,559208,423800,84295,120592,204887,218913,2022,'APUCARANA',Apucarana,'PR',4101408,44161.0,44161,3680.1,3680.1,4,3460.0,3460.0,Grande
3905,3929,410150,45888,28492,5272,8077,13349,15143,43579.0,27211.58,5027.75,7114.92,12142.67,15068.92,522948,326539,60333,85379,145712,180827,2022,'ARAPONGAS',Arapongas,'PR',4101507,70005.0,70005,5833.8,5833.8,4,4094.0,4094.0,Grande
3906,3930,410160,9601,8377,2057,2819,4876,3501,9191.83,8093.92,1944.42,2887.67,4832.08,3261.83,110302,97127,23333,34652,57985,39142,2022,'ARAPOTI',Arapoti,'PR',4101606,8415.0,8415,701.2,701.2,2,450.0,450.0,Pequeno II
3907,3931,410165,1925,1583,246,728,974,609,1869.75,1561.67,232.92,780.17,1013.08,548.58,22437,18740,2795,9362,12157,6583,2022,'ARAPUA',Arapuã,'PR',4101655,5267.0,5267,438.9,438.9,1,366.0,366.0,Pequeno I
3908,3932,410170,8689,5815,1166,769,1935,3880,8344.0,5860.92,1265.92,666.33,1932.25,3928.67,100128,70331,15191,7996,23187,47144,2022,'ARARUNA',Araruna,'PR',4101705,6076.0,6076,506.3,506.3,1,685.0,685.0,Pequeno I
3909,3933,410180,55651,46055,8348,20311,28659,17396,50820.17,42641.17,7329.33,19480.17,26809.5,15831.67,609842,511694,87952,233762,321714,189980,2022,'ARAUCARIA',Araucária,'PR',4101804,50616.0,50616,4218.0,4218.0,8,2982.0,2982.0,Grande
3910,3934,410185,1495,1158,236,344,580,578,1426.92,1121.0,201.58,339.25,540.83,580.17,17123,13452,2419,4071,6490,6962,2022,'ARIRANHA DO IVAI',Ariranha do Ivaí,'PR',4101853,1124.0,1124,93.7,93.7,1,40.0,40.0,Pequeno I
3911,3935,410190,6413,5038,1044,1119,2163,2875,6130.0,4899.25,1051.33,1202.58,2253.92,2645.33,73560,58791,12616,14431,27047,31744,2022,'ASSAI',Assaí,'PR',4101903,4773.0,4773,530.3,530.3,1,536.0,536.0,Pequeno I
3912,3936,410200,15245,10021,2142,1691,3833,6188,14640.58,9760.0,2014.67,1507.33,3522.0,6238.0,175687,117120,24176,18088,42264,74856,2022,'ASSIS CHATEAUBRIAND',Assis Chateaubriand,'PR',4102000,13370.0,13370,1114.2,1114.2,1,1125.0,1125.0,Pequeno II
3913,3937,410210,9163,6581,1146,1858,3004,3577,8834.25,6530.83,1177.5,1899.42,3076.92,3453.92,106011,78370,14130,22793,36923,41447,2022,'ASTORGA',Astorga,'PR',4102109,7224.0,7224,602.0,602.0,2,571.0,571.0,Pequeno II
3914,3938,410220,1603,1218,276,356,632,586,1539.33,1176.83,228.5,335.5,564.0,612.83,18472,14122,2742,4026,6768,7354,2022,'ATALAIA',Atalaia,'PR',4102208,921.0,921,131.6,131.6,1,62.0,62.0,Pequeno I
3915,3939,410230,6059,4885,860,1728,2588,2297,5560.75,4570.42,781.58,1724.75,2506.33,2064.08,66729,54845,9379,20697,30076,24769,2022,'BALSA NOVA',Balsa Nova,'PR',4102307,6599.0,6599,549.9,549.9,1,387.0,387.0,Pequeno I
3916,3940,410240,15424,11876,2766,1642,4408,7468,14993.83,11631.17,2683.25,1674.75,4358.0,7273.17,179926,139574,32199,20097,52296,87278,2022,'BANDEIRANTES',Bandeirantes,'PR',4102406,10200.0,10200,927.3,927.3,1,1005.0,1005.0,Pequeno II
3917,3941,410250,6380,5179,646,2252,2898,2281,6294.17,5173.42,542.83,2383.33,2926.17,2247.25,75530,62081,6514,28600,35114,26967,2022,'BARBOSA FERRAZ',Barbosa Ferraz,'PR',4102505,4205.0,4205,350.4,350.4,1,295.0,295.0,Pequeno I
3918,3942,410260,5581,3980,778,1779,2557,1423,5240.42,3748.58,593.92,1772.83,2366.75,1381.83,62885,44983,7127,21274,28401,16582,2022,'BARRACAO',Barracão,'PR',4102604,5465.0,5465,455.4,455.4,1,380.0,380.0,Pequeno I
3919,3943,410270,1482,1174,187,394,581,593,1438.08,1161.08,184.17,412.42,596.58,564.5,17257,13933,2210,4949,7159,6774,2022,'BARRA DO JACARE',Barra do Jacaré,'PR',4102703,1320.0,1320,110.0,110.0,1,130.0,130.0,Pequeno I
3920,3944,410275,1888,1399,252,510,762,637,1850.33,1405.33,260.67,516.67,777.33,628.0,22204,16864,3128,6200,9328,7536,2022,'BELA VISTA DA CAROBA',Bela Vista da Caroba,'PR',4102752,2009.0,2009,167.4,167.4,1,83.0,83.0,Pequeno I
3921,3945,410280,7111,5401,792,2119,2911,2490,6849.25,5259.83,764.75,2069.0,2833.75,2426.08,82191,63118,9177,24828,34005,29113,2022,'BELA VISTA DO PARAISO',Bela Vista do Paraíso,'PR',4102802,6809.0,6809,567.4,567.4,1,282.0,282.0,Pequeno I
3922,3946,410290,10186,7721,2478,1881,4359,3362,10070.75,7773.08,2155.58,2118.67,4274.25,3498.83,120849,93277,25867,25424,51291,41986,2022,'BITURUNA',Bituruna,'PR',4102901,6475.0,9878,588.6,898.0,1,910.0,910.0,Pequeno I
3923,3947,410300,1952,1685,207,775,982,703,1894.0,1634.75,200.08,744.42,944.5,690.25,22728,19617,2401,8933,11334,8283,2022,'BOA ESPERANCA',Boa Esperança,'PR',4103008,1717.0,1717,143.1,143.1,1,40.0,40.0,Pequeno I
3924,3948,410302,973,692,95,279,374,318,935.5,666.25,79.0,298.08,377.08,289.17,11226,7995,948,3577,4525,3470,2022,'BOA ESPERANCA DO IGUACU',Boa Esperança do Iguaçu,'PR',4103024,1870.0,1870,155.8,155.8,1,113.0,113.0,Pequeno I
3925,3949,410304,3980,3510,398,2226,2624,886,3717.0,3326.58,344.25,2260.0,2604.25,722.33,44604,39919,4131,27120,31251,8668,2022,'BOA VENTURA DE SAO ROQUE',Boa Ventura de São Roque,'PR',4103040,899.0,899,74.9,74.9,1,98.0,98.0,Pequeno I
3926,3950,410305,4678,3773,450,2300,2750,1023,4441.58,3618.0,343.67,2294.83,2638.5,979.5,53299,43416,4124,27538,31662,11754,2022,'BOA VISTA DA APARECIDA',Boa Vista da Aparecida,'PR',4103057,2357.0,2357,196.4,196.4,1,116.0,116.0,Pequeno I
3927,3951,410310,8961,7813,824,4871,5695,2118,8351.0,7340.92,855.92,4429.25,5285.17,2055.75,100212,88091,10271,53151,63422,24669,2022,'BOCAIUVA DO SUL',Bocaiúva do Sul,'PR',4103107,6677.0,6677,556.4,556.4,1,193.0,193.0,Pequeno I
3928,3952,410315,1914,1386,407,410,817,569,1790.25,1322.67,429.5,385.58,815.08,507.58,21483,15872,5154,4627,9781,6091,2022,'BOM JESUS DO SUL',Bom Jesus do Sul,'PR',4103156,3062.0,3062,255.2,255.2,1,266.0,266.0,Pequeno I
3929,3953,410320,3111,2253,307,305,612,1641,3045.0,2312.83,328.08,341.58,669.67,1643.17,36540,27754,3937,4099,8036,19718,2022,'BOM SUCESSO',Bom Sucesso,'PR',4103206,2925.0,2925,243.8,243.8,1,178.0,178.0,Pequeno I
3930,3954,410322,1993,1127,152,309,461,666,1916.58,1118.0,159.83,368.75,528.58,589.42,22999,13416,1918,4425,6343,7073,2022,'BOM SUCESSO DO SUL',Bom Sucesso do Sul,'PR',4103222,1541.0,1541,128.4,128.4,1,72.0,72.0,Pequeno I
3931,3955,410330,4162,3155,521,973,1494,1661,4046.17,3102.42,507.33,983.17,1490.5,1611.92,48554,37229,6088,11798,17886,19343,2022,'BORRAZOPOLIS',Borrazópolis,'PR',4103305,3262.0,3262,271.8,271.8,1,296.0,296.0,Pequeno I
3932,3956,410335,2550,2080,388,661,1049,1031,2459.83,2026.42,363.33,734.25,1097.58,928.83,29518,24317,4360,8811,13171,11146,2022,'BRAGANEY',Braganey,'PR',4103354,3602.0,3602,300.2,300.2,1,538.0,538.0,Pequeno I
3933,3957,410337,2289,1714,254,529,783,931,2216.08,1692.92,263.17,527.83,791.0,901.92,26593,20315,3158,6334,9492,10823,2022,'BRASILANDIA DO SUL',Brasilândia do Sul,'PR',4103370,2001.0,2001,166.8,166.8,1,152.0,152.0,Pequeno I
3934,3958,410340,1483,1044,101,358,459,585,1483.67,1072.92,97.75,367.0,464.75,608.17,17804,12875,1173,4404,5577,7298,2022,'CAFEARA',Cafeara,'PR',4103404,2303.0,2303,191.9,191.9,1,137.0,137.0,Pequeno I
3935,3959,410345,8214,5587,1265,1865,3130,2457,7603.92,5102.5,1126.58,1572.75,2699.33,2403.17,91247,61230,13519,18873,32392,28838,2022,'CAFELANDIA',Cafelândia,'PR',4103453,3564.0,14818,297.0,1234.8,1,0.0,1265.0,Pequeno I
3936,3960,410347,2261,1837,255,491,746,1091,2179.58,1781.33,210.92,548.5,759.42,1021.92,26155,21376,2531,6582,9113,12263,2022,'CAFEZAL DO SUL',Cafezal do Sul,'PR',4103479,1793.0,1793,149.4,149.4,1,99.0,99.0,Pequeno I
3937,3961,410350,4620,3716,424,1877,2301,1415,4411.58,3603.33,446.83,1739.5,2186.33,1417.0,52939,43240,5362,20874,26236,17004,2022,'CALIFORNIA',Califórnia,'PR',4103503,5949.0,5949,594.9,594.9,1,500.0,500.0,Pequeno I
3938,3962,410360,11553,9284,1707,2754,4461,4823,11202.25,9257.5,1692.25,3331.42,5023.67,4233.83,134427,111090,20307,39977,60284,50806,2022,'CAMBARA',Cambará,'PR',4103602,5649.0,5649,470.8,470.8,1,404.0,404.0,Pequeno II
3939,3963,410370,44321,30684,4106,10979,15085,15599,41944.0,29388.75,3854.08,10663.5,14517.58,14871.17,503328,352665,46249,127962,174211,178454,2022,'CAMBE',Cambé,'PR',4103701,76000.0,78504,6333.3,6542.0,6,4553.0,4553.0,Médio
3940,3964,410380,4897,3775,613,1208,1821,1954,4706.42,3765.17,676.5,1187.83,1864.33,1900.83,56477,45182,8118,14254,22372,22810,2022,'CAMBIRA',Cambira,'PR',4103800,7027.0,8240,638.8,749.1,1,687.0,687.0,Pequeno I
3941,3965,410390,7941,6053,1513,2039,3552,2501,7567.08,5839.58,1405.33,2009.25,3414.58,2425.0,90805,70075,16864,24111,40975,29100,2022,'CAMPINA DA LAGOA',Campina da Lagoa,'PR',4103909,4347.0,13913,362.2,1159.4,1,0.0,1230.0,Pequeno I
3942,3966,410395,2916,2441,512,907,1419,1022,2842.25,2424.5,454.67,975.58,1430.25,994.25,34107,29094,5456,11707,17163,11931,2022,'CAMPINA DO SIMAO',Campina do Simão,'PR',4103958,1932.0,1932,161.0,161.0,1,111.0,111.0,Pequeno I
3943,3967,410400,22641,18531,2422,10495,12917,5614,20953.33,17225.58,2320.08,9347.42,11667.5,5558.08,251440,206707,27841,112169,140010,66697,2022,'CAMPINA GRANDE DO SUL',Campina Grande do Sul,'PR',4104006,2702.0,32335,225.2,2694.6,1,0.0,2605.0,Pequeno II
3944,3968,410405,2397,1898,322,848,1170,728,2254.33,1812.67,275.83,845.25,1121.08,691.58,27052,21752,3310,10143,13453,8299,2022,'CAMPO BONITO',Campo Bonito,'PR',4104055,4066.0,4066,338.8,338.8,1,189.0,189.0,Pequeno I
3945,3969,410410,4582,4204,366,2818,3184,1020,4187.33,3943.58,394.25,2724.42,3118.67,824.92,50248,47323,4731,32693,37424,9899,2022,'CAMPO DO TENENTE',Campo do Tenente,'PR',4104105,965.0,965,80.4,80.4,1,70.0,70.0,Pequeno I
3946,3970,410420,37856,30725,5516,12415,17931,12794,35073.08,28898.75,4903.08,11774.17,16677.25,12221.5,420877,346785,58837,141290,200127,146658,2022,'CAMPO LARGO',Campo Largo,'PR',4104204,49754.0,49754,4146.2,4146.2,4,3054.0,3054.0,Grande
3947,3971,410425,11678,8852,1690,2905,4595,4257,10842.67,8328.0,1548.42,2854.25,4402.67,3925.33,130112,99936,18581,34251,52832,47104,2022,'CAMPO MAGRO',Campo Magro,'PR',4104253,11798.0,11798,983.2,983.2,1,730.0,730.0,Pequeno II
3948,3972,410430,38567,30018,5100,10820,15920,14098,36660.42,28989.33,4866.33,10402.17,15268.5,13720.83,439925,347872,58396,124826,183222,164650,2022,'CAMPO MOURAO',Campo Mourão,'PR',4104303,15939.0,15939,1328.2,1328.2,3,990.0,990.0,Médio
3949,3973,410440,7741,6985,1241,3656,4897,2088,7395.33,6704.25,1151.75,3510.5,4662.25,2042.0,88744,80451,13821,42126,55947,24504,2022,'CANDIDO DE ABREU',Cândido de Abreu,'PR',4104402,1852.0,4117,264.6,588.1,1,234.0,234.0,Pequeno I
3950,3974,410442,8326,7008,2059,1642,3701,3307,7945.75,6793.5,1898.0,1813.83,3711.83,3081.67,95349,81522,22776,21766,44542,36980,2022,'CANDOI',Candói,'PR',4104428,2593.0,18577,216.1,1548.1,1,967.0,967.0,Pequeno I
3951,3975,410445,7272,5545,1297,790,2087,3458,6996.08,5576.67,1352.67,916.08,2268.75,3307.92,83953,66920,16232,10993,27225,39695,2022,'CANTAGALO',Cantagalo,'PR',4104451,5771.0,6876,577.1,687.6,1,207.0,207.0,Pequeno I
3952,3976,410450,4361,3613,644,1146,1790,1823,4094.33,3443.5,630.08,1211.08,1841.17,1602.33,49132,41322,7561,14533,22094,19228,2022,'CAPANEMA',Capanema,'PR',4104501,9986.0,9986,832.2,832.2,1,814.0,814.0,Pequeno I
3953,3977,410460,6853,5407,910,2335,3245,2162,6397.25,5144.17,812.5,2250.42,3062.92,2081.25,76767,61730,9750,27005,36755,24975,2022,'CAPITAO LEONIDAS MARQUES',Capitão Leônidas Marques,'PR',4104600,6119.0,9638,509.9,803.2,1,434.0,434.0,Pequeno I
3954,3978,410465,9744,8086,1659,2242,3901,4185,9146.58,7765.5,1495.92,2456.58,3952.5,3813.0,109759,93186,17951,29479,47430,45756,2022,'CARAMBEI',Carambeí,'PR',4104659,5132.0,6329,427.7,527.4,1,313.0,313.0,Pequeno I
3955,3979,410470,7556,6061,2126,529,2655,3406,6967.08,5609.92,1762.58,709.58,2472.17,3137.75,83605,67319,21151,8515,29666,37653,2022,'CARLOPOLIS',Carlópolis,'PR',4104709,5544.0,5544,462.0,462.0,1,172.0,172.0,Pequeno I
3956,3980,410480,113803,77429,12763,19601,32364,45065,106319.33,73144.08,12270.17,17643.75,29913.92,43230.17,1275832,877729,147242,211725,358967,518762,2022,'CASCAVEL',Cascavel,'PR',4104808,129811.0,129811,10817.6,10817.6,9,9283.0,9283.0,Grande
3957,3981,410490,37166,29227,5246,11871,17117,12110,35252.92,28070.08,4881.58,11420.67,16302.25,11767.83,423035,336841,58579,137048,195627,141214,2022,'CASTRO',Castro,'PR',4104907,37728.0,37728,3144.0,3144.0,6,2879.0,2879.0,Médio
3958,3982,410500,5410,3944,787,666,1453,2491,5261.67,3949.92,788.92,765.42,1554.33,2395.58,63140,47399,9467,9185,18652,28747,2022,'CATANDUVAS',Catanduvas,'PR',4105003,7087.0,7087,590.6,590.6,1,500.0,500.0,Pequeno I
3959,3983,410510,5241,4069,862,1227,2089,1980,4969.83,3885.58,802.67,1212.42,2015.08,1870.5,59638,46627,9632,14549,24181,22446,2022,'CENTENARIO DO SUL',Centenário do Sul,'PR',4105102,3697.0,3697,308.1,308.1,1,316.0,316.0,Pequeno I
3960,3984,410520,10574,9716,3286,3502,6788,2928,10163.08,9379.17,3019.67,3406.25,6425.92,2953.25,121957,112550,36236,40875,77111,35439,2022,'CERRO AZUL',Cerro Azul,'PR',4105201,3749.0,3749,312.4,312.4,1,137.0,137.0,Pequeno I
3961,3985,410530,4416,2415,375,516,891,1524,4264.75,2396.08,337.75,510.08,847.83,1548.25,51177,28753,4053,6121,10174,18579,2022,'CEU AZUL',Céu Azul,'PR',4105300,5590.0,9119,465.8,759.9,1,536.0,536.0,Pequeno I
3962,3986,410540,8668,6611,1279,2540,3819,2792,8300.92,6368.17,1142.42,2555.67,3698.08,2670.08,99611,76418,13709,30668,44377,32041,2022,'CHOPINZINHO',Chopinzinho,'PR',4105409,12084.0,15410,1007.0,1284.2,2,184.0,1218.0,Pequeno I
3963,3987,410550,23972,17698,3319,4457,7776,9922,22793.58,17029.67,3185.0,4257.75,7442.75,9586.92,273523,204356,38220,51093,89313,115043,2022,'CIANORTE',Cianorte,'PR',4105508,24759.0,57780,2063.2,4815.0,2,2793.0,2793.0,Médio
3964,3988,410560,4620,3611,873,822,1695,1916,4470.0,3536.83,812.0,944.67,1756.67,1780.17,53640,42442,9744,11336,21080,21362,2022,'CIDADE GAUCHA',Cidade Gaúcha,'PR',4105607,6096.0,6096,508.0,508.0,1,508.0,508.0,Pequeno I
3965,3989,410570,8184,6468,2585,564,3149,3319,7813.75,6359.67,2394.58,706.0,3100.58,3259.08,93765,76316,28735,8472,37207,39109,2022,'CLEVELANDIA',Clevelândia,'PR',4105706,7164.0,9570,597.0,797.5,1,655.0,655.0,Pequeno I
3966,3990,410580,86143,70314,11823,33522,45345,24969,79521.42,65602.67,11018.58,31001.08,42019.67,23583.0,954257,787232,132223,372013,504236,282996,2022,'COLOMBO',Colombo,'PR',4105805,84604.0,88345,7050.3,7362.1,6,4391.0,4391.0,Grande
3967,3991,410590,5397,3899,554,967,1521,2378,5086.33,3823.42,584.17,998.83,1583.0,2240.42,61036,45881,7010,11986,18996,26885,2022,'COLORADO',Colorado,'PR',4105904,2717.0,2717,226.4,226.4,1,138.0,138.0,Pequeno II
3968,3992,410600,5389,4455,928,1595,2523,1932,5166.0,4326.08,896.92,1503.5,2400.42,1925.67,61992,51913,10763,18042,28805,23108,2022,'CONGONHINHAS',Congonhinhas,'PR',4106001,3497.0,3497,291.4,291.4,1,258.0,258.0,Pequeno I
3969,3993,410610,2020,1633,171,735,906,727,1980.08,1631.67,188.25,719.33,907.58,724.08,23761,19580,2259,8632,10891,8689,2022,'CONSELHEIRO MAIRINCK',Conselheiro Mairinck,'PR',4106100,2381.0,2381,198.4,198.4,1,208.0,208.0,Pequeno I
3970,3994,410620,8723,6604,1786,1569,3355,3249,8175.67,6248.25,1620.0,1358.33,2978.33,3269.92,98108,74979,19440,16300,35740,39239,2022,'CONTENDA',Contenda,'PR',4106209,2579.0,2579,214.9,214.9,1,164.0,164.0,Pequeno I
3971,3995,410630,7536,5502,1275,988,2263,3239,7250.42,5384.17,1190.0,1055.33,2245.33,3138.83,87005,64610,14280,12664,26944,37666,2022,'CORBELIA',Corbélia,'PR',4106308,925.0,15985,77.1,1332.1,1,0.0,1024.0,Pequeno I
3972,3996,410640,13814,10393,2504,1670,4174,6219,12918.5,9944.42,2446.75,1604.08,4050.83,5893.58,155022,119333,29361,19249,48610,70723,2022,'CORNELIO PROCOPIO',Cornélio Procópio,'PR',4106407,1969.0,28874,164.1,2406.2,1,0.0,2029.0,Pequeno II
3973,3997,410645,3925,3586,383,2764,3147,439,3541.25,3247.0,536.92,2201.08,2738.0,509.0,42495,38964,6443,26413,32856,6108,2022,'CORONEL DOMINGOS SOARES',Coronel Domingos Soares,'PR',4106456,4985.0,4985,415.4,415.4,1,426.0,426.0,Pequeno I
3974,3998,410650,7769,5827,1260,2116,3376,2451,7378.33,5658.33,1111.75,2082.58,3194.33,2464.0,88540,67900,13341,24991,38332,29568,2022,'CORONEL VIVIDA',Coronel Vivida,'PR',4106506,1593.0,27738,132.8,2311.5,1,1593.0,1593.0,Pequeno II
3975,3999,410655,2375,1822,266,625,891,931,2318.33,1823.42,169.5,785.08,954.58,868.83,27820,21881,2034,9421,11455,10426,2022,'CORUMBATAI DO SUL',Corumbataí do Sul,'PR',4106555,2311.0,2311,192.6,192.6,1,151.0,151.0,Pequeno I
3976,4000,410657,1867,1284,194,449,643,641,1827.5,1274.25,211.25,382.67,593.92,680.33,21930,15291,2535,4592,7127,8164,2022,'CRUZEIRO DO IGUACU',Cruzeiro do Iguaçu,'PR',4106571,1833.0,1833,152.8,152.8,1,48.0,48.0,Pequeno I
3977,4001,410660,10668,7048,1180,2231,3411,3637,10078.92,6775.83,1152.83,2155.92,3308.75,3467.08,120947,81310,13834,25871,39705,41605,2022,'CRUZEIRO DO OESTE',Cruzeiro do Oeste,'PR',4106605,9520.0,9520,793.3,793.3,1,581.0,581.0,Pequeno II
3978,4002,410670,2866,1965,319,628,947,1018,2802.33,1950.92,331.08,614.75,945.83,1005.08,33628,23411,3973,7377,11350,12061,2022,'CRUZEIRO DO SUL',Cruzeiro do Sul,'PR',4106704,1981.0,1981,220.1,220.1,1,60.0,60.0,Pequeno I
3979,4003,410680,8079,5739,1367,1032,2399,3340,7905.5,5737.67,1482.17,1071.67,2553.83,3183.83,94866,68852,17786,12860,30646,38206,2022,'CRUZ MACHADO',Cruz Machado,'PR',4106803,6232.0,6232,566.5,566.5,1,556.0,556.0,Pequeno I
3980,4004,410685,1534,1219,308,460,768,451,1467.17,1196.5,279.0,460.5,739.5,457.0,17606,14358,3348,5526,8874,5484,2022,'CRUZMALTINA',Cruzmaltina,'PR',4106852,3132.0,3132,261.0,261.0,1,275.0,275.0,Pequeno I
3981,4005,410690,408865,311480,54662,119408,174070,137410,378454.75,291353.83,49833.75,113044.58,162878.33,128475.5,4541457,3496246,598005,1356535,1954540,1541706,2022,'CURITIBA',Curitiba,'PR',4106902,508362.0,508362,42363.5,42363.5,39,30141.0,30141.0,Metrópole
3982,4006,410700,7147,6287,1518,2178,3696,2591,6862.75,6113.92,1327.0,2473.83,3800.83,2313.08,82353,73367,15924,29686,45610,27757,2022,'CURIUVA',Curiúva,'PR',4107009,2668.0,2668,242.5,242.5,1,192.0,192.0,Pequeno I
3983,4007,410710,2595,1863,517,613,1130,733,2508.67,1828.0,398.83,698.33,1097.17,730.83,30104,21936,4786,8380,13166,8770,2022,'DIAMANTE DO NORTE',Diamante do Norte,'PR',4107108,1205.0,1205,120.5,120.5,1,,,Pequeno I
3984,4008,410712,2103,1842,287,954,1241,601,1999.17,1767.92,285.33,928.92,1214.25,553.67,23990,21215,3424,11147,14571,6644,2022,'DIAMANTE DO SUL',Diamante do Sul,'PR',4107124,225.0,225,45.0,45.0,1,,,Pequeno I
3985,4009,410715,2827,1965,248,761,1009,956,2736.75,1929.92,237.0,747.75,984.75,945.17,32841,23159,2844,8973,11817,11342,2022,'DIAMANTE DOESTE',Diamante D´oeste,'PR',4107157,2859.0,2859,238.2,238.2,1,384.0,384.0,Pequeno I
3986,4010,410720,10889,9504,1605,3313,4918,4586,10029.58,8794.33,1602.17,2971.33,4573.5,4220.83,120355,105532,19226,35656,54882,50650,2022,'DOIS VIZINHOS',Dois Vizinhos,'PR',4107207,31892.0,31892,2657.7,2657.7,3,1590.0,1590.0,Pequeno II
3987,4011,410725,3323,2328,590,388,978,1350,3124.5,2199.75,556.0,368.25,924.25,1275.5,37494,26397,6672,4419,11091,15306,2022,'DOURADINA',Douradina,'PR',4107256,3972.0,3972,331.0,331.0,1,123.0,123.0,Pequeno I
3988,4012,410730,2426,1865,319,407,726,1139,2250.75,1816.08,353.0,418.08,771.08,1045.0,27009,21793,4236,5017,9253,12540,2022,'DOUTOR CAMARGO',Doutor Camargo,'PR',4107306,1738.0,1738,144.8,144.8,1,172.0,172.0,Pequeno I
3989,4013,410740,2704,2243,209,1134,1343,900,2622.25,2178.58,236.0,1036.0,1272.0,906.58,31467,26143,2832,12432,15264,10879,2022,'ENEAS MARQUES',Enéas Marques,'PR',4107405,3920.0,3920,326.7,326.7,1,300.0,300.0,Pequeno I
3990,4014,410750,5448,4501,808,1973,2781,1720,5110.58,4334.92,753.33,2044.0,2797.33,1537.58,61327,52019,9040,24528,33568,18451,2022,'ENGENHEIRO BELTRAO',Engenheiro Beltrão,'PR',4107504,1410.0,1410,117.5,117.5,1,86.0,86.0,Pequeno I
3991,4015,410752,1095,682,213,161,374,308,1038.58,663.17,128.92,252.92,381.83,281.33,12463,7958,1547,3035,4582,3376,2022,'ESPERANCA NOVA',Esperança Nova,'PR',4107520,738.0,738,61.5,61.5,1,69.0,69.0,Pequeno I
3992,4016,410753,1124,867,109,231,340,527,1083.25,845.08,133.08,213.5,346.58,498.5,12999,10141,1597,2562,4159,5982,2022,'ENTRE RIOS DO OESTE',Entre Rios do Oeste,'PR',4107538,3337.0,3337,278.1,278.1,1,238.0,238.0,Pequeno I
3993,4017,410754,3250,2882,213,2095,2308,574,3051.0,2742.0,181.83,2000.42,2182.25,559.75,36612,32904,2182,24005,26187,6717,2022,'ESPIGAO ALTO DO IGUACU',Espigão Alto do Iguaçu,'PR',4107546,4471.0,5558,372.6,463.2,1,0.0,1087.0,Pequeno I
3994,4018,410755,1642,1312,160,555,715,597,1590.25,1283.17,162.33,530.67,693.0,590.17,19083,15398,1948,6368,8316,7082,2022,'FAROL',Farol,'PR',4107553,6124.0,6124,556.7,556.7,1,438.0,438.0,Pequeno I
3995,4019,410760,10859,8562,2488,2075,4563,3999,10437.42,8278.08,2251.75,2135.83,4387.58,3890.5,125249,99337,27021,25630,52651,46686,2022,'FAXINAL',Faxinal,'PR',4107603,5381.0,5381,448.4,448.4,1,179.0,179.0,Pequeno I
3996,4020,410765,56345,47649,10679,13472,24151,23498,50425.17,43028.0,9611.17,11681.42,21292.58,21735.42,605102,516336,115334,140177,255511,260825,2022,'FAZENDA RIO GRANDE',Fazenda Rio Grande,'PR',4107652,38833.0,44057,3236.1,3671.4,3,2516.0,2516.0,Médio
3997,4021,410770,2794,2154,182,1052,1234,920,2720.5,2130.42,188.83,1090.92,1279.75,850.67,32646,25565,2266,13091,15357,10208,2022,'FENIX',Fênix,'PR',4107702,2124.0,2124,177.0,177.0,1,181.0,181.0,Pequeno I
3998,4022,410773,3837,3430,534,1991,2525,905,3692.75,3370.25,405.75,2135.75,2541.5,828.75,44313,40443,4869,25629,30498,9945,2022,'FERNANDES PINHEIRO',Fernandes Pinheiro,'PR',4107736,3804.0,3804,345.8,345.8,1,371.0,371.0,Pequeno I
3999,4023,410775,4242,3889,112,2849,2961,928,4095.25,3762.83,125.92,2674.5,2800.42,962.42,49143,45154,1511,32094,33605,11549,2022,'FIGUEIRA',Figueira,'PR',4107751,2386.0,2386,198.8,198.8,1,130.0,130.0,Pequeno I
4000,4024,410780,1772,1311,261,372,633,678,1721.83,1288.83,251.25,371.92,623.17,665.67,20662,15466,3015,4463,7478,7988,2022,'FLORAI',Floraí,'PR',4107801,6662.0,6662,555.2,555.2,1,420.0,420.0,Pequeno I
4001,4025,410785,2219,1796,308,743,1051,745,2077.58,1714.25,283.58,651.92,935.5,778.75,24931,20571,3403,7823,11226,9345,2022,'FLOR DA SERRA DO SUL',Flor da Serra do Sul,'PR',4107850,3887.0,3887,323.9,323.9,1,142.0,142.0,Pequeno I
4002,4026,410790,3551,3099,735,362,1097,2002,3209.5,2827.42,670.17,331.0,1001.17,1826.25,38514,33929,8042,3972,12014,21915,2022,'FLORESTA',Floresta,'PR',4107900,820.0,820,74.5,74.5,1,80.0,80.0,Pequeno I
4003,4027,410800,8411,7215,192,4715,4907,2308,8235.25,7144.5,227.33,4593.83,4821.17,2323.33,98823,85734,2728,55126,57854,27880,2022,'FLORESTOPOLIS',Florestópolis,'PR',4108007,5505.0,11538,458.8,961.5,1,695.0,695.0,Pequeno I
4004,4028,410810,1377,1111,163,490,653,458,1311.17,1066.17,147.25,419.17,566.42,499.75,15734,12794,1767,5030,6797,5997,2022,'FLORIDA',Flórida,'PR',4108106,2391.0,2391,199.2,199.2,1,302.0,302.0,Pequeno I
4005,4029,410820,3280,1879,443,308,751,1128,3082.58,1794.08,394.42,293.08,687.5,1106.58,36991,21529,4733,3517,8250,13279,2022,'FORMOSA DO OESTE',Formosa do Oeste,'PR',4108205,383.0,383,54.7,54.7,1,56.0,56.0,Pequeno I
4006,4030,410830,123225,97336,17595,43419,61014,36322,114059.0,90807.0,17498.92,38261.83,55760.75,35046.25,1368708,1089684,209987,459142,669129,420555,2022,'FOZ DO IGUACU',Foz do Iguaçu,'PR',4108304,73550.0,261987,6129.2,21832.2,5,7460.0,17237.0,Grande
4007,4031,410832,3337,2891,313,1619,1932,959,3106.58,2712.92,311.0,1551.25,1862.25,850.67,37279,32555,3732,18615,22347,10208,2022,'FRANCISCO ALVES',Francisco Alves,'PR',4108320,1796.0,1796,149.7,149.7,1,179.0,179.0,Pequeno I
4008,4032,410840,26596,17794,3991,3998,7989,9805,25010.58,17259.08,3843.08,4258.58,8101.67,9157.42,300127,207109,46117,51103,97220,109889,2022,'FRANCISCO BELTRAO',Francisco Beltrão,'PR',4108403,37819.0,93973,3151.6,7831.1,3,6254.0,6254.0,Médio
4009,4033,410845,3178,2740,362,1535,1897,843,3079.17,2647.58,407.25,1291.92,1699.17,948.42,36950,31771,4887,15503,20390,11381,2022,'FOZ DO JORDAO',Foz do Jordão,'PR',4108452,1896.0,1896,172.4,172.4,1,174.0,174.0,Pequeno I
4010,4034,410850,6766,6123,1313,2649,3962,2161,6606.75,6058.42,1171.75,2762.75,3934.5,2123.92,79281,72701,14061,33153,47214,25487,2022,'GENERAL CARNEIRO',General Carneiro,'PR',4108502,6051.0,6051,504.2,504.2,1,211.0,211.0,Pequeno I
4011,4035,410855,2033,1420,202,590,792,628,2010.0,1429.0,180.83,614.92,795.75,633.25,24120,17148,2170,7379,9549,7599,2022,'GODOY MOREIRA',Godoy Moreira,'PR',4108551,2877.0,2877,239.8,239.8,1,214.0,214.0,Pequeno I
4012,4036,410860,13052,11042,679,7145,7824,3218,12303.83,10525.58,716.08,6671.17,7387.25,3138.33,147646,126307,8593,80054,88647,37660,2022,'GOIOERE',Goioerê,'PR',4108601,10537.0,10537,878.1,878.1,1,1431.0,1431.0,Pequeno II
4013,4037,410865,4605,4115,649,2230,2879,1236,4480.75,4036.0,492.33,2359.0,2851.33,1184.67,53769,48432,5908,28308,34216,14216,2022,'GOIOXIM',Goioxim,'PR',4108650,979.0,979,81.6,81.6,1,66.0,66.0,Pequeno I
4014,4038,410870,3591,3064,435,1616,2051,1013,3529.5,3059.42,383.5,1745.67,2129.17,930.25,42354,36713,4602,20948,25550,11163,2022,'GRANDES RIOS',Grandes Rios,'PR',4108700,1684.0,1684,140.3,140.3,1,137.0,137.0,Pequeno I
4015,4039,410880,14515,11103,1981,1968,3949,7154,13784.75,10887.67,2115.08,2054.0,4169.08,6718.58,165417,130652,25381,24648,50029,80623,2022,'GUAIRA',Guaíra,'PR',4108809,13518.0,13518,1126.5,1126.5,1,1132.0,1132.0,Pequeno II
4016,4040,410890,3561,3024,576,1287,1863,1161,3280.58,2803.42,539.25,1093.0,1632.25,1171.17,39367,33641,6471,13116,19587,14054,2022,'GUAIRACA',Guairaçá,'PR',4108908,2295.0,2295,191.2,191.2,1,71.0,71.0,Pequeno I
4017,4041,410895,3549,3068,1127,659,1786,1282,3433.42,3027.83,1047.83,747.67,1795.5,1232.33,41201,36334,12574,8972,21546,14788,2022,'GUAMIRANGA',Guamiranga,'PR',4108957,4028.0,4028,335.7,335.7,1,201.0,201.0,Pequeno I
4018,4042,410900,2597,1979,330,319,649,1330,2478.42,1941.17,328.25,371.5,699.75,1241.42,29741,23294,3939,4458,8397,14897,2022,'GUAPIRAMA',Guapirama,'PR',4109005,1190.0,1190,99.2,99.2,1,175.0,175.0,Pequeno I
4019,4043,410910,1154,785,45,403,448,337,1102.92,765.0,39.5,384.92,424.42,340.58,13235,9180,474,4619,5093,4087,2022,'GUAPOREMA',Guaporema,'PR',4109104,8047.0,8047,670.6,670.6,1,502.0,502.0,Pequeno I
4020,4044,410920,2470,2022,288,1037,1325,697,2331.75,1943.08,288.75,963.92,1252.67,690.42,27981,23317,3465,11567,15032,8285,2022,'GUARACI',Guaraci,'PR',4109203,1474.0,1474,184.2,184.2,1,160.0,160.0,Pequeno I
4021,4045,410930,5099,3974,1135,577,1712,2262,4881.92,3854.58,1104.83,647.75,1752.58,2102.0,58583,46255,13258,7773,21031,25224,2022,'GUARANIACU',Guaraniaçu,'PR',4109302,2411.0,2411,200.9,200.9,1,140.0,140.0,Pequeno I
4022,4046,410940,77215,62754,13556,22995,36551,26203,72066.58,59196.0,12278.5,21566.75,33845.25,25350.75,864799,710352,147342,258801,406143,304209,2022,'GUARAPUAVA',Guarapuava,'PR',4109401,65891.0,84042,5990.1,7640.2,4,6223.0,6223.0,Grande
4023,4047,410950,6233,5798,507,4287,4794,1004,6059.92,5696.42,381.75,4443.83,4825.58,870.83,72719,68357,4581,53326,57907,10450,2022,'GUARAQUECABA',Guaraqueçaba,'PR',4109500,4201.0,4201,350.1,350.1,1,173.0,173.0,Pequeno I
4024,4048,410960,24090,19010,6011,6612,12623,6387,22161.75,17662.08,4880.08,6965.0,11845.08,5817.0,265941,211945,58561,83580,142141,69804,2022,'GUARATUBA',Guaratuba,'PR',4109609,15990.0,26432,1332.5,2202.7,2,2441.0,2441.0,Pequeno II
4025,4049,410965,3309,2363,355,928,1283,1080,3211.42,2423.17,286.33,1282.58,1568.92,854.25,38537,29078,3436,15391,18827,10251,2022,'HONORIO SERPA',Honório Serpa,'PR',4109658,5032.0,5032,419.3,419.3,1,245.0,245.0,Pequeno I
4026,4050,410970,13265,10183,2989,1399,4388,5795,12389.25,9703.17,2805.83,1320.25,4126.08,5577.08,148671,116438,33670,15843,49513,66925,2022,'IBAITI',Ibaiti,'PR',4109708,5430.0,25988,543.0,2598.8,1,1692.0,1692.0,Pequeno II
4027,4051,410975,4023,3219,533,1310,1843,1376,3797.08,3150.83,511.0,1397.25,1908.25,1242.58,45565,37810,6132,16767,22899,14911,2022,'IBEMA',Ibema,'PR',4109757,2032.0,2032,169.3,169.3,1,136.0,136.0,Pequeno I
4028,4052,410980,21564,15907,1913,6932,8845,7062,20693.42,15609.0,1900.5,6670.0,8570.5,7038.5,248321,187308,22806,80040,102846,84462,2022,'IBIPORA',Ibiporã,'PR',4109807,12262.0,12262,1021.8,1021.8,2,965.0,965.0,Pequeno II
4029,4053,410990,4017,3173,628,1419,2047,1126,3802.0,3014.42,570.33,1348.0,1918.33,1096.08,45624,36173,6844,16176,23020,13153,2022,'ICARAIMA',Icaraíma,'PR',4109906,3779.0,3779,343.5,343.5,1,301.0,301.0,Pequeno I
4030,4054,411000,2114,1635,334,414,748,887,2038.58,1628.58,324.17,451.25,775.42,853.17,24463,19543,3890,5415,9305,10238,2022,'IGUARACU',Iguaraçu,'PR',4110003,2146.0,2146,178.8,178.8,1,102.0,102.0,Pequeno I
4031,4055,411005,1339,917,124,308,432,485,1269.5,862.58,122.42,274.0,396.42,466.17,15234,10351,1469,3288,4757,5594,2022,'IGUATU',Iguatu,'PR',4110052,909.0,909,82.6,82.6,1,72.0,72.0,Pequeno I
4032,4057,411010,15124,12393,3579,1858,5437,6956,14182.08,12042.83,3377.17,1593.42,4970.58,7072.25,170185,144514,40526,19121,59647,84867,2022,'IMBITUVA',Imbituva,'PR',4110102,13955.0,13955,1162.9,1162.9,1,823.0,823.0,Pequeno II
4033,4058,411020,7431,6545,1781,1910,3691,2854,7185.92,6394.25,1715.33,1991.67,3707.0,2687.25,86231,76731,20584,23900,44484,32247,2022,'INACIO MARTINS',Inácio Martins,'PR',4110201,4310.0,4310,391.8,391.8,1,400.0,400.0,Pequeno I
4034,4059,411030,2044,1504,220,569,789,715,2011.5,1502.67,199.83,583.42,783.25,719.42,24138,18032,2398,7001,9399,8633,2022,'INAJA',Inajá,'PR',4110300,2260.0,2260,188.3,188.3,1,70.0,70.0,Pequeno I
4035,4060,411040,2964,1751,340,401,741,1010,2830.58,1701.75,287.92,392.08,680.0,1021.75,33967,20421,3455,4705,8160,12261,2022,'INDIANOPOLIS',Indianópolis,'PR',4110409,5030.0,5030,419.2,419.2,1,299.0,299.0,Pequeno I
4036,4061,411050,7056,5930,1404,833,2237,3693,6762.33,5857.5,1435.33,923.5,2358.83,3498.67,81148,70290,17224,11082,28306,41984,2022,'IPIRANGA',Ipiranga,'PR',4110508,0.0,25534,0.0,2127.8,1,0.0,2380.0,Pequeno I
4037,4062,411060,6848,4820,933,1197,2130,2690,6416.83,4663.58,992.92,1146.08,2139.0,2524.58,77002,55963,11915,13753,25668,30295,2022,'IPORA',Iporã,'PR',4110607,5472.0,5472,456.0,456.0,1,297.0,297.0,Pequeno I
4038,4063,411065,1116,746,92,263,355,391,1115.17,776.92,84.0,299.75,383.75,393.17,13382,9323,1008,3597,4605,4718,2022,'IRACEMA DO OESTE',Iracema do Oeste,'PR',4110656,1843.0,1843,153.6,153.6,1,106.0,106.0,Pequeno I
4039,4064,411070,22234,18956,3042,9468,12510,6446,21080.75,18210.0,2515.92,9476.33,11992.25,6217.75,252969,218520,30191,113716,143907,74613,2022,'IRATI',Irati,'PR',4110706,33626.0,33626,2802.2,2802.2,4,1594.0,1594.0,Médio
4040,4065,411080,5986,5137,1418,1374,2792,2345,5661.75,4935.0,1342.08,1325.25,2667.33,2267.67,67941,59220,16105,15903,32008,27212,2022,'IRETAMA',Iretama,'PR',4110805,3005.0,3005,250.4,250.4,1,200.0,200.0,Pequeno I
4041,4066,411090,2447,1704,267,335,602,1102,2369.25,1730.17,261.5,359.67,621.17,1109.0,28431,20762,3138,4316,7454,13308,2022,'ITAGUAJE',Itaguajé,'PR',4110904,1068.0,1068,89.0,89.0,1,114.0,114.0,Pequeno I
4042,4067,411095,6686,4483,632,647,1279,3204,6658.92,4498.42,683.33,770.92,1454.25,3044.17,79907,53981,8200,9251,17451,36530,2022,'ITAIPULANDIA',Itaipulândia,'PR',4110953,3830.0,3830,638.3,638.3,1,680.0,680.0,Pequeno I
4043,4068,411100,3593,2674,400,879,1279,1395,3480.08,2700.17,371.5,924.42,1295.92,1404.25,41761,32402,4458,11093,15551,16851,2022,'ITAMBARACA',Itambaracá,'PR',4111001,4557.0,4557,414.3,414.3,1,614.0,614.0,Pequeno I
4044,4069,411110,1982,1070,104,56,160,910,1865.83,1045.5,111.25,54.0,165.25,880.25,22390,12546,1335,648,1983,10563,2022,'ITAMBE',Itambé,'PR',4111100,2847.0,2847,237.2,237.2,1,205.0,205.0,Pequeno I
4045,4070,411120,4872,4306,915,1865,2780,1526,4352.83,3864.08,952.75,1420.5,2373.25,1490.83,52234,46369,11433,17046,28479,17890,2022,'ITAPEJARA DOESTE',Itapejara D´oeste,'PR',4111209,2813.0,2813,234.4,234.4,1,145.0,145.0,Pequeno I
4046,4071,411125,17687,16187,4502,6182,10684,5503,16984.42,15734.25,3660.25,7282.0,10942.25,4792.0,203813,188811,43923,87384,131307,57504,2022,'ITAPERUCU',Itaperuçu,'PR',4111258,6197.0,6197,516.4,516.4,1,389.0,389.0,Pequeno II
4047,4072,411130,2226,1695,456,456,912,783,2109.33,1652.25,391.5,509.42,900.92,751.33,25312,19827,4698,6113,10811,9016,2022,'ITAUNA DO SUL',Itaúna do Sul,'PR',4111308,1455.0,1455,121.2,121.2,1,66.0,66.0,Pequeno I
4048,4073,411140,7586,6490,1662,1822,3484,3006,7394.83,6466.5,1708.33,2012.0,3720.33,2746.17,88738,77598,20500,24144,44644,32954,2022,'IVAI',Ivaí,'PR',4111407,7534.0,7534,627.8,627.8,1,639.0,639.0,Pequeno I
4049,4074,411150,11793,8446,1888,652,2540,5906,11296.08,8336.0,1883.67,695.92,2579.58,5756.42,135553,100032,22604,8351,30955,69077,2022,'IVAIPORA',Ivaiporã,'PR',4111506,10091.0,10091,840.9,840.9,1,627.0,627.0,Pequeno II
4050,4075,411155,3052,2283,347,974,1321,962,2895.17,2166.08,338.83,902.92,1241.75,924.33,34742,25993,4066,10835,14901,11092,2022,'IVATE',Ivaté,'PR',4111555,1294.0,1294,107.8,107.8,1,60.0,60.0,Pequeno I
4051,4076,411160,989,723,91,217,308,415,955.92,728.75,100.42,207.42,307.83,420.92,11471,8745,1205,2489,3694,5051,2022,'IVATUBA',Ivatuba,'PR',4111605,584.0,584,48.7,48.7,1,109.0,109.0,Pequeno I
4052,4077,411170,2653,2156,539,841,1380,776,2499.42,2058.58,485.67,816.75,1302.42,756.17,29993,24703,5828,9801,15629,9074,2022,'JABOTI',Jaboti,'PR',4111704,868.0,868,108.5,108.5,1,68.0,68.0,Pequeno I
4053,4078,411180,15612,13441,2157,6712,8869,4572,16460.83,14204.83,2224.75,6894.58,9119.33,5085.5,197530,170458,26697,82735,109432,61026,2022,'JACAREZINHO',Jacarezinho,'PR',4111803,27354.0,29434,2279.5,2452.8,2,1464.0,1464.0,Pequeno II
4054,4079,411190,6290,5205,784,2058,2842,2363,5706.83,4738.92,711.58,1831.83,2543.42,2195.5,68482,56867,8539,21982,30521,26346,2022,'JAGUAPITA',Jaguapitã,'PR',4111902,6908.0,6908,575.7,575.7,1,527.0,527.0,Pequeno I
4055,4080,411200,15427,12696,3022,3435,6457,6239,14592.25,12080.17,2983.83,3231.83,6215.67,5864.5,175107,144962,35806,38782,74588,70374,2022,'JAGUARIAIVA',Jaguariaíva,'PR',4112009,9995.0,9995,832.9,832.9,2,428.0,428.0,Pequeno II
4056,4081,411210,9219,7129,1064,2990,4054,3075,8604.0,6770.42,1092.92,2863.08,3956.0,2814.42,103248,81245,13115,34357,47472,33773,2022,'JANDAIA DO SUL',Jandaia do Sul,'PR',4112108,13807.0,13807,1150.6,1150.6,1,604.0,604.0,Pequeno II
4057,4082,411220,2811,2133,456,654,1110,1023,2599.25,2003.75,431.58,609.5,1041.08,962.67,31191,24045,5179,7314,12493,11552,2022,'JANIOPOLIS',Janiópolis,'PR',4112207,3674.0,3674,334.0,334.0,1,123.0,123.0,Pequeno I
4058,4083,411230,2585,2066,491,592,1083,983,2520.5,2044.08,482.83,618.17,1101.0,943.08,30246,24529,5794,7418,13212,11317,2022,'JAPIRA',Japira,'PR',4112306,4015.0,4015,365.0,365.0,1,398.0,398.0,Pequeno I
4059,4084,411240,4259,3296,623,1163,1786,1510,4153.25,3236.0,555.17,1280.42,1835.58,1400.42,49839,38832,6662,15365,22027,16805,2022,'JAPURA',Japurá,'PR',4112405,3368.0,3368,336.8,336.8,1,167.0,167.0,Pequeno I
4060,4085,411250,6816,5402,1267,1353,2620,2782,6573.25,5317.08,1209.75,1528.25,2738.0,2579.08,78879,63805,14517,18339,32856,30949,2022,'JARDIM ALEGRE',Jardim Alegre,'PR',4112504,6760.0,6760,563.3,563.3,1,193.0,193.0,Pequeno I
4061,4086,411260,929,667,125,239,364,303,901.67,664.42,102.92,231.17,334.08,330.33,10820,7973,1235,2774,4009,3964,2022,'JARDIM OLINDA',Jardim Olinda,'PR',4112603,1681.0,1681,152.8,152.8,1,147.0,147.0,Pequeno I
4062,4087,411270,6107,4801,835,1988,2823,1978,5822.0,4659.25,769.83,2004.08,2773.92,1885.33,69864,55911,9238,24049,33287,22624,2022,'JATAIZINHO',Jataizinho,'PR',4112702,1887.0,1887,171.5,171.5,1,46.0,46.0,Pequeno I
4063,4088,411275,4103,3206,414,1781,2195,1011,3878.58,3053.92,406.08,1589.67,1995.75,1058.17,46543,36647,4873,19076,23949,12698,2022,'JESUITAS',Jesuítas,'PR',4112751,2231.0,2231,185.9,185.9,1,244.0,244.0,Pequeno I
4064,4089,411280,4546,3581,886,978,1864,1717,4184.58,3325.0,875.08,732.25,1607.33,1717.67,50215,39900,10501,8787,19288,20612,2022,'JOAQUIM TAVORA',Joaquim Távora,'PR',4112801,4185.0,4185,348.8,348.8,1,187.0,187.0,Pequeno I
4065,4090,411290,2484,1790,243,860,1103,687,2374.33,1727.25,212.75,872.83,1085.58,641.67,28492,20727,2553,10474,13027,7700,2022,'JUNDIAI DO SUL',Jundiaí do Sul,'PR',4112900,2327.0,2327,193.9,193.9,1,190.0,190.0,Pequeno I
4066,4091,411295,3721,2961,518,1167,1685,1276,3478.42,2775.25,413.75,1156.67,1570.42,1204.83,41741,33303,4965,13880,18845,14458,2022,'JURANDA',Juranda,'PR',4112959,6537.0,6537,544.8,544.8,1,279.0,279.0,Pequeno I
4067,4092,411300,2897,2026,256,595,851,1175,2815.67,2052.75,248.83,709.0,957.83,1094.92,33788,24633,2986,8508,11494,13139,2022,'JUSSARA',Jussara,'PR',4113007,3891.0,3891,353.7,353.7,1,229.0,229.0,Pequeno I
4068,4093,411310,2386,2050,393,989,1382,668,2275.83,1970.58,324.67,924.67,1249.33,721.25,27310,23647,3896,11096,14992,8655,2022,'KALORE',Kaloré,'PR',4113106,965.0,965,80.4,80.4,1,37.0,37.0,Pequeno I
4069,4094,411320,16742,13622,2231,5840,8071,5551,15669.42,12879.92,2057.83,5418.08,7475.92,5404.0,188033,154559,24694,65017,89711,64848,2022,'LAPA',Lapa,'PR',4113205,7016.0,7016,584.7,584.7,1,545.0,545.0,Pequeno II
4070,4095,411325,4602,3926,783,1948,2731,1195,4391.92,3835.33,753.83,1929.0,2682.83,1152.5,52703,46024,9046,23148,32194,13830,2022,'LARANJAL',Laranjal,'PR',4113254,257.0,257,23.4,23.4,1,28.0,28.0,Pequeno I
4071,4096,411330,9950,8096,2184,2206,4390,3706,9594.67,7858.5,1920.58,2374.33,4294.92,3563.58,115136,94302,23047,28492,51539,42763,2022,'LARANJEIRAS DO SUL',Laranjeiras do Sul,'PR',4113304,9342.0,9342,849.3,849.3,1,1012.0,1012.0,Pequeno II
4072,4097,411340,2573,1714,271,428,699,1015,2505.25,1687.25,271.25,445.67,716.92,970.33,30063,20247,3255,5348,8603,11644,2022,'LEOPOLIS',Leópolis,'PR',4113403,2680.0,2680,223.3,223.3,1,150.0,150.0,Pequeno I
4073,4098,411342,2949,1790,379,537,916,874,2847.5,1759.67,334.75,544.75,879.5,880.17,34170,21116,4017,6537,10554,10562,2022,'LIDIANOPOLIS',Lidianópolis,'PR',4113429,2991.0,2991,249.2,249.2,1,134.0,134.0,Pequeno I
4074,4099,411345,3478,2762,212,1744,1956,806,3260.33,2669.25,211.67,1786.0,1997.67,671.58,39124,32031,2540,21432,23972,8059,2022,'LINDOESTE',Lindoeste,'PR',4113452,954.0,954,95.4,95.4,1,34.0,34.0,Pequeno I
4075,4100,411350,9124,6600,1830,864,2694,3906,8648.33,6449.0,1770.08,1057.25,2827.33,3621.67,103780,77388,21241,12687,33928,43460,2022,'LOANDA',Loanda,'PR',4113502,18479.0,18479,1539.9,1539.9,1,1582.0,1582.0,Pequeno II
4076,4101,411360,2080,1708,228,790,1018,690,1986.42,1649.67,211.75,789.58,1001.33,648.33,23837,19796,2541,9475,12016,7780,2022,'LOBATO',Lobato,'PR',4113601,6510.0,6510,542.5,542.5,1,640.0,640.0,Pequeno I
4077,4102,411370,169601,136752,12900,73580,86480,50272,163722.83,133772.33,12423.42,73344.33,85767.75,48004.58,1964674,1605268,149081,880132,1029213,576055,2022,'LONDRINA',Londrina,'PR',4113700,108497.0,108497,9041.4,9041.4,10,3568.0,3568.0,Grande
4078,4103,411373,4074,3501,431,1680,2111,1390,3939.08,3437.08,407.75,1753.08,2160.83,1276.25,47269,41245,4893,21037,25930,15315,2022,'LUIZIANA',Luiziana,'PR',4113734,2689.0,2689,224.1,224.1,1,59.0,59.0,Pequeno I
4079,4104,411375,3200,2364,310,807,1117,1247,3086.33,2371.92,307.75,899.33,1207.08,1164.83,37036,28463,3693,10792,14485,13978,2022,'LUNARDELLI',Lunardelli,'PR',4113759,2647.0,2647,220.6,220.6,1,116.0,116.0,Pequeno I
4080,4105,411380,3034,2193,104,1343,1447,746,2924.83,2169.58,121.42,1300.25,1421.67,747.92,35098,26035,1457,15603,17060,8975,2022,'LUPIONOPOLIS',Lupionópolis,'PR',4113809,5449.0,5449,454.1,454.1,1,331.0,331.0,Pequeno I
4081,4106,411390,4740,3817,688,1333,2021,1796,4574.08,3797.5,644.08,1316.5,1960.58,1836.92,54889,45570,7729,15798,23527,22043,2022,'MALLET',Mallet,'PR',4113908,6060.0,6060,505.0,505.0,1,319.0,319.0,Pequeno I
4082,4107,411400,6544,5299,658,2693,3351,1948,6331.75,5188.5,558.58,2708.5,3267.08,1921.42,75981,62262,6703,32502,39205,23057,2022,'MAMBORE',Mamborê,'PR',4114005,2929.0,2929,244.1,244.1,1,60.0,60.0,Pequeno I
4083,4108,411410,9494,7486,1940,1627,3567,3919,8731.25,7044.08,1680.58,1591.5,3272.08,3772.0,104775,84529,20167,19098,39265,45264,2022,'MANDAGUACU',Mandaguaçu,'PR',4114104,1741.0,17017,145.1,1418.1,1,0.0,1149.0,Pequeno I
4084,4109,411420,11967,7497,1170,1027,2197,5300,11576.75,7506.17,1178.08,1108.42,2286.5,5219.67,138921,90074,14137,13301,27438,62636,2022,'MANDAGUARI',Mandaguari,'PR',4114203,10056.0,10056,838.0,838.0,1,961.0,961.0,Pequeno II
4085,4110,411430,11990,9782,2106,2909,5015,4767,11245.92,9313.17,2077.0,2893.58,4970.58,4342.58,134951,111758,24924,34723,59647,52111,2022,'MANDIRITUBA',Mandirituba,'PR',4114302,4081.0,4081,340.1,340.1,1,212.0,212.0,Pequeno II
4086,4111,411435,1361,871,131,155,286,585,1309.58,909.33,162.08,217.5,379.58,529.75,15715,10912,1945,2610,4555,6357,2022,'MANFRINOPOLIS',Manfrinópolis,'PR',4114351,2098.0,2098,174.8,174.8,1,126.0,126.0,Pequeno I
4087,4112,411440,8217,6690,1482,1657,3139,3551,7766.75,6609.08,1470.75,1933.17,3403.92,3205.17,93201,79309,17649,23198,40847,38462,2022,'MANGUEIRINHA',Mangueirinha,'PR',4114401,7319.0,7319,609.9,609.9,1,520.0,520.0,Pequeno I
4088,4113,411450,7726,6416,923,3544,4467,1949,7294.5,6159.17,794.58,3529.5,4324.08,1835.08,87534,73910,9535,42354,51889,22021,2022,'MANOEL RIBAS',Manoel Ribas,'PR',4114500,1932.0,1932,161.0,161.0,1,130.0,130.0,Pequeno I
4089,4114,411460,13577,9684,1639,1965,3604,6080,12790.0,9301.67,1630.33,1810.83,3441.17,5860.5,153480,111620,19564,21730,41294,70326,2022,'MARECHAL CANDIDO RONDON',Marechal Cândido Rondon,'PR',4114609,8126.0,8126,677.2,677.2,1,501.0,501.0,Pequeno II
4090,4115,411470,2513,2096,331,999,1330,766,2334.42,1925.92,345.58,791.83,1137.42,788.5,28013,23111,4147,9502,13649,9462,2022,'MARIA HELENA',Maria Helena,'PR',4114708,3992.0,3992,332.7,332.7,1,396.0,396.0,Pequeno I
4091,4116,411480,16214,12869,2976,3391,6367,6502,15595.33,12525.17,2580.33,3867.25,6447.58,6077.58,187144,150302,30964,46407,77371,72931,2022,'MARIALVA',Marialva,'PR',4114807,9898.0,13097,824.8,1091.4,1,574.0,574.0,Pequeno II
4092,4117,411490,4830,4047,585,1661,2246,1801,4631.0,3915.58,546.5,1568.0,2114.5,1801.08,55572,46987,6558,18816,25374,21613,2022,'MARILANDIA DO SUL',Marilândia do Sul,'PR',4114906,4747.0,4747,395.6,395.6,1,320.0,320.0,Pequeno I
4093,4118,411500,4183,3135,584,539,1123,2012,3973.33,2994.42,556.17,518.58,1074.75,1919.67,47680,35933,6674,6223,12897,23036,2022,'MARILENA',Marilena,'PR',4115002,2003.0,2003,166.9,166.9,1,81.0,81.0,Pequeno I
4094,4119,411510,6397,5406,1004,1588,2592,2814,6250.42,5382.5,973.42,1705.92,2679.33,2703.17,75005,64590,11681,20471,32152,32438,2022,'MARILUZ',Mariluz,'PR',4115101,3096.0,3096,281.5,281.5,1,,,Pequeno I
4095,4120,411520,103054,68563,9633,26262,35895,32668,96028.75,65749.83,9135.5,24586.25,33721.75,32028.08,1152345,788998,109626,295035,404661,384337,2022,'MARINGA',Maringá,'PR',4115200,119130.0,119130,9927.5,9927.5,10,7193.0,7193.0,Grande
4096,4121,411530,2745,1745,291,311,602,1143,2666.5,1805.25,326.08,319.33,645.42,1159.83,31998,21663,3913,3832,7745,13918,2022,'MARIOPOLIS',Mariópolis,'PR',4115309,6204.0,6204,517.0,517.0,1,330.0,330.0,Pequeno I
4097,4122,411535,1731,1264,149,336,485,779,1625.42,1207.17,166.83,329.33,496.17,711.0,19505,14486,2002,3952,5954,8532,2022,'MARIPA',Maripá,'PR',4115358,1364.0,1364,113.7,113.7,1,62.0,62.0,Pequeno I
4098,4123,411540,7424,5691,356,3293,3649,2042,7105.75,5519.75,314.92,3197.33,3512.25,2007.5,85269,66237,3779,38368,42147,24090,2022,'MARMELEIRO',Marmeleiro,'PR',4115408,5980.0,11062,543.6,1005.6,1,543.0,543.0,Pequeno I
4099,4124,411545,2896,2571,234,1614,1848,723,2823.0,2522.08,221.25,1629.0,1850.25,671.83,33876,30265,2655,19548,22203,8062,2022,'MARQUINHO',Marquinho,'PR',4115457,3310.0,3310,275.8,275.8,1,350.0,350.0,Pequeno I
4100,4125,411550,1985,1612,251,471,722,890,1919.75,1582.83,245.83,445.25,691.08,891.75,23037,18994,2950,5343,8293,10701,2022,'MARUMBI',Marumbi,'PR',4115507,4285.0,4285,357.1,357.1,1,250.0,250.0,Pequeno I
4101,4126,411560,6249,3799,601,207,808,2991,6014.0,3861.42,637.67,231.0,868.67,2992.75,72168,46337,7652,2772,10424,35913,2022,'MATELANDIA',Matelândia,'PR',4115606,5344.0,5344,534.4,534.4,1,432.0,432.0,Pequeno I
4102,4127,411570,20637,16351,4095,4918,9013,7338,18999.17,15205.58,3801.25,4094.42,7895.67,7309.92,227990,182467,45615,49133,94748,87719,2022,'MATINHOS',Matinhos,'PR',4115705,16453.0,46044,1371.1,3837.0,2,1247.0,1247.0,Pequeno II
4103,4128,411573,2384,2059,389,982,1371,688,2287.17,1996.92,419.92,857.33,1277.25,719.67,27446,23963,5039,10288,15327,8636,2022,'MATO RICO',Mato Rico,'PR',4115739,532.0,532,48.4,48.4,1,20.0,20.0,Pequeno I
4104,4129,411575,6133,4834,944,1425,2369,2465,5909.08,4780.25,934.92,1384.92,2319.83,2460.42,70909,57363,11219,16619,27838,29525,2022,'MAUA DA SERRA',Mauá da Serra,'PR',4115754,5648.0,5648,470.7,470.7,1,677.0,677.0,Pequeno I
4105,4130,411580,12463,8741,1421,1148,2569,6172,12456.67,9115.75,1607.33,1442.08,3049.42,6066.33,149480,109389,19288,17305,36593,72796,2022,'MEDIANEIRA',Medianeira,'PR',4115804,11121.0,22905,926.8,1908.8,1,1249.0,1249.0,Pequeno II
4106,4131,411585,2043,1135,194,145,339,796,1952.25,1082.58,196.0,175.67,371.67,710.92,23427,12991,2352,2108,4460,8531,2022,'MERCEDES',Mercedes,'PR',4115853,3109.0,3109,282.6,282.6,1,,,Pequeno I
4107,4132,411590,1433,1139,142,550,692,447,1322.42,1074.0,134.33,518.83,653.17,420.83,15869,12888,1612,6226,7838,5050,2022,'MIRADOR',Mirador,'PR',4115903,4239.0,4239,353.2,353.2,1,209.0,209.0,Pequeno I
4108,4133,411600,985,725,111,262,373,352,928.58,697.0,118.25,249.17,367.42,329.58,11143,8364,1419,2990,4409,3955,2022,'MIRASELVA',Miraselva,'PR',4116000,77.0,77,19.2,19.2,1,,,Pequeno I
4109,4134,411605,4170,3107,443,1511,1954,1153,4006.58,3030.58,466.42,1495.58,1962.0,1068.58,48079,36367,5597,17947,23544,12823,2022,'MISSAL',Missal,'PR',4116059,0.0,16950,0.0,1540.9,1,0.0,1538.0,Pequeno I
4110,4135,411610,7327,5663,210,3874,4084,1579,6956.42,5429.08,204.25,3687.17,3891.42,1537.67,83477,65149,2451,44246,46697,18452,2022,'MOREIRA SALES',Moreira Sales,'PR',4116109,5450.0,5450,454.2,454.2,1,246.0,246.0,Pequeno I
4111,4136,411620,8739,7729,1438,3651,5089,2640,8277.33,7456.25,1261.58,3863.42,5125.0,2331.25,99328,89475,15139,46361,61500,27975,2022,'MORRETES',Morretes,'PR',4116208,900.0,900,75.0,75.0,1,55.0,55.0,Pequeno I
4112,4137,411630,2479,1854,360,607,967,887,2335.42,1741.17,299.58,577.17,876.75,864.42,28025,20894,3595,6926,10521,10373,2022,'MUNHOZ DE MELO',Munhoz de Melo,'PR',4116307,6254.0,6254,521.2,521.2,1,370.0,370.0,Pequeno I
4113,4138,411640,1393,987,129,291,420,567,1346.58,999.75,132.67,309.42,442.08,557.67,16159,11997,1592,3713,5305,6692,2022,'NOSSA SENHORA DAS GRACAS',Nossa Senhora Das Graças,'PR',4116406,1331.0,1331,147.9,147.9,1,139.0,139.0,Pequeno I
4114,4139,411650,638,450,87,99,186,264,621.0,443.75,94.5,82.17,176.67,267.08,7452,5325,1134,986,2120,3205,2022,'NOVA ALIANCA DO IVAI',Nova Aliança do Ivaí,'PR',4116505,1304.0,1304,108.7,108.7,1,90.0,90.0,Pequeno I
4115,4140,411660,2492,1872,269,662,931,941,2498.67,1928.33,236.67,693.83,930.5,997.83,29984,23140,2840,8326,11166,11974,2022,'NOVA AMERICA DA COLINA',Nova América da Colina,'PR',4116604,2503.0,2503,208.6,208.6,1,169.0,169.0,Pequeno I
4116,4141,411670,4160,3045,321,1583,1904,1141,3921.17,2914.58,292.58,1506.08,1798.67,1115.92,47054,34975,3511,18073,21584,13391,2022,'NOVA AURORA',Nova Aurora,'PR',4116703,7167.0,7167,597.2,597.2,1,458.0,458.0,Pequeno I
4117,4142,411680,4322,3433,736,1095,1831,1602,4174.67,3388.08,734.17,1181.83,1916.0,1472.08,50096,40657,8810,14182,22992,17665,2022,'NOVA CANTU',Nova Cantu,'PR',4116802,2729.0,2729,227.4,227.4,1,226.0,226.0,Pequeno I
4118,4143,411690,11552,9287,2013,2855,4868,4419,11047.92,9022.0,1839.0,2885.5,4724.5,4297.5,132575,108264,22068,34626,56694,51570,2022,'NOVA ESPERANCA',Nova Esperança,'PR',4116901,6775.0,6775,564.6,564.6,2,845.0,845.0,Pequeno II
4119,4144,411695,2144,1540,151,610,761,779,2065.58,1515.42,151.25,612.42,763.67,751.75,24787,18185,1815,7349,9164,9021,2022,'NOVA ESPERANCA DO SUDOESTE,Nova Esperança do Sudoeste,'PR',4116950,4379.0,4379,364.9,364.9,1,361.0,361.0,Pequeno I
4120,4145,411700,4869,3681,911,744,1655,2026,4750.75,3594.83,873.0,670.67,1543.67,2051.17,57009,43138,10476,8048,18524,24614,2022,'NOVA FATIMA',Nova Fátima,'PR',4117008,5372.0,5372,488.4,488.4,1,367.0,367.0,Pequeno I
4121,4146,411705,7512,6713,1110,4178,5288,1425,7287.83,6595.83,1060.0,4200.17,5260.17,1335.67,87454,79150,12720,50402,63122,16028,2022,'NOVA LARANJEIRAS',Nova Laranjeiras,'PR',4117057,3197.0,3197,319.7,319.7,1,229.0,229.0,Pequeno I
4122,4147,411710,6177,4669,1039,1203,2242,2427,5753.5,4412.75,990.83,1178.17,2169.0,2243.75,69042,52953,11890,14138,26028,26925,2022,'NOVA LONDRINA',Nova Londrina,'PR',4117107,5088.0,5088,424.0,424.0,1,393.0,393.0,Pequeno I
4123,4148,411720,2942,2260,345,708,1053,1207,2807.0,2193.42,335.42,784.75,1120.17,1073.25,33684,26321,4025,9417,13442,12879,2022,'NOVA OLIMPIA',Nova Olímpia,'PR',4117206,1500.0,1500,125.0,125.0,1,76.0,76.0,Pequeno I
4124,4149,411721,2831,2241,393,619,1012,1229,2727.0,2200.75,365.0,692.25,1057.25,1143.5,32724,26409,4380,8307,12687,13722,2022,'NOVA SANTA BARBARA',Nova Santa Bárbara,'PR',4117214,1165.0,1165,97.1,97.1,1,105.0,105.0,Pequeno I
4125,4150,411722,3007,1941,360,564,924,1017,2835.42,1802.67,326.67,473.92,800.58,1002.08,34025,21632,3920,5687,9607,12025,2022,'NOVA SANTA ROSA',Nova Santa Rosa,'PR',4117222,1458.0,1458,208.3,208.3,1,122.0,122.0,Pequeno I
4126,4151,411725,4156,3015,769,621,1390,1625,3892.08,2899.92,721.25,638.83,1360.08,1539.83,46705,34799,8655,7666,16321,18478,2022,'NOVA PRATA DO IGUACU',Nova Prata do Iguaçu,'PR',4117255,6960.0,6960,580.0,580.0,1,280.0,280.0,Pequeno I
4127,4152,411727,4474,3242,655,274,929,2313,4434.0,3248.25,735.58,335.0,1070.58,2177.67,53208,38979,8827,4020,12847,26132,2022,'NOVA TEBAS',Nova Tebas,'PR',4117271,7214.0,9333,601.2,777.8,1,376.0,376.0,Pequeno I
4128,4153,411729,1709,1129,193,224,417,712,1668.08,1094.42,199.0,271.58,470.58,623.83,20017,13133,2388,3259,5647,7486,2022,'NOVO ITACOLOMI',Novo Itacolomi,'PR',4117297,980.0,980,81.7,81.7,1,88.0,88.0,Pequeno I
4129,4154,411730,16415,13341,3115,5174,8289,5052,15588.5,12972.83,2450.25,5990.33,8440.58,4532.25,187062,155674,29403,71884,101287,54387,2022,'ORTIGUEIRA',Ortigueira,'PR',4117305,21937.0,21937,1828.1,1828.1,2,1378.0,1378.0,Pequeno II
4130,4155,411740,1472,905,196,154,350,555,1448.0,905.42,207.0,149.5,356.5,548.92,17376,10865,2484,1794,4278,6587,2022,'OURIZONA',Ourizona,'PR',4117404,2014.0,2014,167.8,167.8,1,173.0,173.0,Pequeno I
4131,4156,411745,2558,1897,310,342,652,1245,2481.42,1903.83,281.92,366.83,648.75,1255.08,29777,22846,3383,4402,7785,15061,2022,'OURO VERDE DO OESTE',Ouro Verde do Oeste,'PR',4117453,3125.0,3125,260.4,260.4,1,220.0,220.0,Pequeno I
4132,4157,411750,19041,15249,2179,7167,9346,5903,17459.75,14135.42,1959.75,6670.83,8630.58,5504.83,209517,169625,23517,80050,103567,66058,2022,'PAICANDU',Paiçandu,'PR',4117503,17115.0,17115,1426.2,1426.2,2,728.0,728.0,Pequeno II
4133,4158,411760,22127,18415,5793,3902,9695,8720,20829.25,17696.0,5477.25,4348.33,9825.58,7870.42,249951,212352,65727,52180,117907,94445,2022,'PALMAS',Palmas,'PR',4117602,13496.0,13496,1124.7,1124.7,2,1039.0,1039.0,Pequeno II
4134,4159,411770,10700,8457,1978,1671,3649,4808,10181.75,8147.75,1911.08,1657.5,3568.58,4579.17,122181,97773,22933,19890,42823,54950,2022,'PALMEIRA',Palmeira,'PR',4117701,9871.0,21371,822.6,1780.9,1,755.0,755.0,Pequeno II
4135,4160,411780,8274,7398,1982,2611,4593,2805,8052.83,7326.83,1941.42,2830.42,4771.83,2555.0,96634,87922,23297,33965,57262,30660,2022,'PALMITAL',Palmital,'PR',4117800,2993.0,2993,272.1,272.1,1,110.0,110.0,Pequeno I
4136,4161,411790,8683,6120,995,2015,3010,3110,7982.33,5658.75,1045.67,1617.33,2663.0,2995.75,95788,67905,12548,19408,31956,35949,2022,'PALOTINA',Palotina,'PR',4117909,5522.0,5522,460.2,460.2,1,511.0,511.0,Pequeno II
4137,4162,411800,3807,2859,601,551,1152,1707,3637.42,2743.17,591.58,529.42,1121.0,1622.17,43649,32918,7099,6353,13452,19466,2022,'PARAISO DO NORTE',Paraíso do Norte,'PR',4118006,4725.0,4725,393.8,393.8,1,336.0,336.0,Pequeno I
4138,4163,411810,4536,3555,609,1148,1757,1798,4409.58,3560.92,623.75,1278.17,1901.92,1659.0,52915,42731,7485,15338,22823,19908,2022,'PARANACITY',Paranacity,'PR',4118105,3979.0,3979,361.7,361.7,1,229.0,229.0,Pequeno I
4139,4164,411820,49825,44335,10315,22358,32673,11662,42776.33,38227.83,8782.0,18938.67,27720.67,10507.17,513316,458734,105384,227264,332648,126086,2022,'PARANAGUA',Paranaguá,'PR',4118204,63258.0,70350,5271.5,5862.5,4,4078.0,4078.0,Grande
4140,4165,411830,1437,1136,234,163,397,739,1402.83,1142.92,284.42,181.0,465.42,677.5,16834,13715,3413,2172,5585,8130,2022,'PARANAPOEMA',Paranapoema,'PR',4118303,1030.0,1030,85.8,85.8,1,58.0,58.0,Pequeno I
4141,4166,411840,38407,29071,4873,9442,14315,14756,36618.0,28119.25,4855.42,8451.58,13307.0,14812.25,439416,337431,58265,101419,159684,177747,2022,'PARANAVAI',Paranavaí,'PR',4118402,23152.0,23152,1929.3,1929.3,4,2223.0,2223.0,Médio
4142,4167,411845,2073,1402,252,350,602,800,1970.5,1351.92,253.33,313.0,566.33,785.58,23646,16223,3040,3756,6796,9427,2022,'PATO BRAGADO',Pato Bragado,'PR',4118451,5426.0,6772,452.2,564.3,1,0.0,1346.0,Pequeno I
4143,4168,411850,23522,18206,5206,3035,8241,9965,21930.42,17211.92,4489.92,3332.83,7822.75,9389.17,263165,206543,53879,39994,93873,112670,2022,'PATO BRANCO',Pato Branco,'PR',4118501,17178.0,17178,1431.5,1431.5,2,1250.0,1250.0,Médio
4144,4169,411860,2398,1905,343,384,727,1178,2215.17,1801.92,304.92,383.33,688.25,1113.67,26582,21623,3659,4600,8259,13364,2022,'PAULA FREITAS',Paula Freitas,'PR',4118600,2023.0,2023,183.9,183.9,1,95.0,95.0,Pequeno I
4145,4170,411870,1971,1539,455,214,669,870,1863.17,1456.5,419.08,261.42,680.5,776.0,22358,17478,5029,3137,8166,9312,2022,'PAULO FRONTIN',Paulo Frontin,'PR',4118709,3039.0,3039,253.2,253.2,1,123.0,123.0,Pequeno I
4146,4171,411880,6597,5266,866,2148,3014,2252,6340.58,5139.42,747.83,2147.25,2895.08,2244.33,76087,61673,8974,25767,34741,26932,2022,'PEABIRU',Peabiru,'PR',4118808,5886.0,5886,490.5,490.5,1,316.0,316.0,Pequeno I
4147,4172,411885,3216,2487,384,535,919,1568,3154.0,2486.67,397.33,567.83,965.17,1521.5,37848,29840,4768,6814,11582,18258,2022,'PEROBAL',Perobal,'PR',4118857,602.0,602,50.2,50.2,1,48.0,48.0,Pequeno I
4148,4173,411890,4560,3671,714,365,1079,2592,4272.92,3487.42,706.42,389.5,1095.92,2391.5,51275,41849,8477,4674,13151,28698,2022,'PEROLA',Pérola,'PR',4118907,2477.0,2477,206.4,206.4,1,100.0,100.0,Pequeno I
4149,4174,411900,2619,1780,511,198,709,1071,2496.5,1757.92,417.0,337.08,754.08,1003.83,29958,21095,5004,4045,9049,12046,2022,'PEROLA DOESTE',Pérola D´oeste,'PR',4119004,2636.0,2636,219.7,219.7,1,92.0,92.0,Pequeno I
4150,4175,411910,3701,2907,682,816,1498,1409,3508.67,2833.25,639.75,855.0,1494.75,1338.5,42104,33999,7677,10260,17937,16062,2022,'PIEN',Piên,'PR',4119103,5135.0,5135,427.9,427.9,1,474.0,474.0,Pequeno I
4151,4176,411915,46709,35394,5914,13667,19581,15813,43181.0,33541.0,5374.08,13313.92,18688.0,14853.0,518172,402492,64489,159767,224256,178236,2022,'PINHAIS',Pinhais,'PR',4119152,54517.0,132317,4543.1,11026.4,4,5668.0,10039.0,Grande
4152,4177,411920,3808,3316,876,1096,1972,1344,3692.17,3254.17,760.0,1177.67,1937.67,1316.5,44306,39050,9120,14132,23252,15798,2022,'PINHALAO',Pinhalão,'PR',4119202,530.0,530,44.2,44.2,1,45.0,45.0,Pequeno I
4153,4178,411925,1416,1066,201,447,648,418,1389.42,1089.33,201.33,458.33,659.67,429.67,16673,13072,2416,5500,7916,5156,2022,'PINHAL DE SAO BENTO',Pinhal de São Bento,'PR',4119251,2132.0,2132,177.7,177.7,1,112.0,112.0,Pequeno I
4154,4179,411930,17076,15313,7914,1785,9699,5614,16369.58,14774.0,6984.25,2011.0,8995.25,5778.75,196435,177288,83811,24132,107943,69345,2022,'PINHAO',Pinhão,'PR',4119301,4943.0,4943,449.4,449.4,1,233.0,233.0,Pequeno II
4155,4180,411940,10915,9115,2158,2901,5059,4056,10484.83,8866.83,2135.75,2921.67,5057.42,3809.42,125818,106402,25629,35060,60689,45713,2022,'PIRAI DO SUL',Piraí do Sul,'PR',4119400,7010.0,7010,637.3,637.3,1,310.0,310.0,Pequeno II
4156,4181,411950,48223,42710,5769,25245,31014,11696,44494.17,39839.83,5111.42,23963.67,29075.08,10764.75,533930,478078,61337,287564,348901,129177,2022,'PIRAQUARA',Piraquara,'PR',4119509,46540.0,82149,4230.9,7468.1,4,,,Médio
4157,4182,411960,17873,14879,3066,5253,8319,6560,17451.0,14745.0,2838.58,5658.08,8496.67,6248.33,209412,176940,34063,67897,101960,74980,2022,'PITANGA',Pitanga,'PR',4119608,1743.0,24890,145.2,2074.2,1,0.0,2193.0,Pequeno II
4158,4183,411965,1553,1211,184,508,692,519,1478.58,1164.75,171.33,494.42,665.75,499.0,17743,13977,2056,5933,7989,5988,2022,'PITANGUEIRAS',Pitangueiras,'PR',4119657,1319.0,1319,131.9,131.9,1,170.0,170.0,Pequeno I
4159,4184,411970,2903,2482,422,1301,1723,759,2842.92,2455.5,407.33,1313.92,1721.25,734.25,34115,29466,4888,15767,20655,8811,2022,'PLANALTINA DO PARANA',Planaltina do Paraná,'PR',4119707,975.0,975,81.2,81.2,1,65.0,65.0,Pequeno I
4160,4185,411980,4476,3637,719,1612,2331,1306,4105.75,3361.25,672.08,1464.17,2136.25,1225.0,49269,40335,8065,17570,25635,14700,2022,'PLANALTO',Planalto,'PR',4119806,3200.0,3200,266.7,266.7,1,400.0,400.0,Pequeno I
4161,4186,411990,122030,92909,18204,35390,53594,39315,113844.75,87420.92,16757.17,33444.42,50201.58,37219.33,1366137,1049051,201086,401333,602419,446632,2022,'PONTA GROSSA',Ponta Grossa,'PR',4119905,160336.0,160336,13361.3,13361.3,10,16242.0,16242.0,Grande
4162,4187,411995,13972,11729,3608,3333,6941,4788,12285.33,10475.83,3136.92,3121.58,6258.5,4217.33,147424,125710,37643,37459,75102,50608,2022,'PONTAL DO PARANA',Pontal do Paraná,'PR',4119954,14167.0,14167,1180.6,1180.6,2,593.0,593.0,Pequeno II
4163,4188,412000,5015,3900,121,2730,2851,1049,4736.0,3707.75,136.33,2502.5,2638.83,1068.92,56832,44493,1636,30030,31666,12827,2022,'PORECATU',Porecatu,'PR',4120002,3008.0,3008,250.7,250.7,1,84.0,84.0,Pequeno I
4164,4189,412010,2046,1460,206,261,467,993,2030.92,1596.75,237.33,325.5,562.83,1033.92,24371,19161,2848,3906,6754,12407,2022,'PORTO AMAZONAS',Porto Amazonas,'PR',4120101,4925.0,4925,410.4,410.4,1,312.0,312.0,Pequeno I
4165,4190,412015,1655,1413,239,713,952,461,1604.08,1385.33,195.08,751.75,946.83,438.5,19249,16624,2341,9021,11362,5262,2022,'PORTO BARREIRO',Porto Barreiro,'PR',4120150,1255.0,1255,104.6,104.6,1,102.0,102.0,Pequeno I
4166,4191,412020,1522,1044,182,291,473,571,1422.83,1020.42,189.0,337.67,526.67,493.75,17074,12245,2268,4052,6320,5925,2022,'PORTO RICO',Porto Rico,'PR',4120200,1323.0,1323,110.2,110.2,1,50.0,50.0,Pequeno I
4167,4192,412030,2009,1674,241,699,940,734,1897.25,1577.83,230.83,623.25,854.08,723.75,22767,18934,2770,7479,10249,8685,2022,'PORTO VITORIA',Porto Vitória,'PR',4120309,2446.0,2446,203.8,203.8,1,125.0,125.0,Pequeno I
4168,4193,412033,2771,2111,254,760,1014,1097,2693.17,2100.75,226.58,700.0,926.58,1174.17,32318,25209,2719,8400,11119,14090,2022,'PRADO FERREIRA',Prado Ferreira,'PR',4120333,2142.0,2142,214.2,214.2,1,200.0,200.0,Pequeno I
4169,4194,412035,2153,1585,298,688,986,599,2101.33,1577.75,244.08,753.25,997.33,580.42,25216,18933,2929,9039,11968,6965,2022,'PRANCHITA',Pranchita,'PR',4120358,6156.0,6156,513.0,513.0,1,321.0,321.0,Pequeno I
4170,4195,412040,2154,1497,252,298,550,947,2064.42,1417.92,187.42,234.75,422.17,995.75,24773,17015,2249,2817,5066,11949,2022,'PRESIDENTE CASTELO BRANCO',Presidente Castelo Branco,'PR',4120408,2514.0,2514,209.5,209.5,1,180.0,180.0,Pequeno I
4171,4196,412050,4116,3158,871,603,1474,1684,4148.25,3184.75,819.58,700.0,1519.58,1665.17,49779,38217,9835,8400,18235,19982,2022,'PRIMEIRO DE MAIO',Primeiro de Maio,'PR',4120507,4659.0,4659,388.2,388.2,1,215.0,215.0,Pequeno I
4172,4197,412060,23777,20328,6127,5072,11199,9129,22938.5,19946.0,5790.33,5481.58,11271.92,8674.08,275262,239352,69484,65779,135263,104089,2022,'PRUDENTOPOLIS',Prudentópolis,'PR',4120606,3849.0,3849,320.8,320.8,1,230.0,230.0,Pequeno II
4173,4198,412065,1917,1499,288,359,647,852,1891.42,1521.42,322.83,399.58,722.42,799.0,22697,18257,3874,4795,8669,9588,2022,'QUARTO CENTENARIO',Quarto Centenário,'PR',4120655,652.0,652,163.0,163.0,1,174.0,174.0,Pequeno I
4174,4199,412070,3789,3108,412,1241,1653,1455,3613.92,2997.83,407.5,1155.75,1563.25,1434.58,43367,35974,4890,13869,18759,17215,2022,'QUATIGUA',Quatiguá,'PR',4120705,3545.0,3545,354.5,354.5,1,420.0,420.0,Pequeno I
4175,4200,412080,7927,6287,905,2736,3641,2646,7269.17,5798.5,886.33,2206.0,3092.33,2706.17,87230,69582,10636,26472,37108,32474,2022,'QUATRO BARRAS',Quatro Barras,'PR',4120804,8102.0,8102,675.2,675.2,2,306.0,306.0,Pequeno I
4176,4201,412085,938,437,38,86,124,313,880.33,412.25,46.0,82.42,128.42,283.83,10564,4947,552,989,1541,3406,2022,'QUATRO PONTES',Quatro Pontes,'PR',4120853,1659.0,1659,138.2,138.2,1,66.0,66.0,Pequeno I
4177,4202,412090,18531,14984,3525,6210,9735,5249,17724.5,14401.67,3211.0,6061.0,9272.0,5129.67,212694,172820,38532,72732,111264,61556,2022,'QUEDAS DO IGUACU',Quedas do Iguaçu,'PR',4120903,2081.0,2081,260.1,260.1,1,325.0,325.0,Pequeno II
4178,4203,412100,5582,4519,1482,1098,2580,1939,5257.67,4311.42,1424.0,1164.0,2588.0,1723.42,63092,51737,17088,13968,31056,20681,2022,'QUERENCIA DO NORTE',Querência do Norte,'PR',4121000,4221.0,4221,383.7,383.7,1,160.0,160.0,Pequeno I
4179,4204,412110,2868,1955,233,499,732,1223,2715.67,1948.33,256.92,562.33,819.25,1129.08,32588,23380,3083,6748,9831,13549,2022,'QUINTA DO SOL',Quinta do Sol,'PR',4121109,1226.0,1226,245.2,245.2,1,493.0,493.0,Pequeno I
4180,4205,412120,7272,6141,1467,1601,3068,3073,6888.25,5851.83,1429.92,1546.58,2976.5,2875.33,82659,70222,17159,18559,35718,34504,2022,'QUITANDINHA',Quitandinha,'PR',4121208,2067.0,2067,258.4,258.4,1,135.0,135.0,Pequeno I
4181,4206,412125,2462,1641,260,348,608,1033,2181.08,1568.75,285.5,333.0,618.5,950.25,26173,18825,3426,3996,7422,11403,2022,'RAMILANDIA',Ramilândia,'PR',4121257,542.0,542,49.3,49.3,1,86.0,86.0,Pequeno I
4182,4207,412130,2254,1641,309,349,658,983,2189.67,1645.42,319.42,395.67,715.08,930.33,26276,19745,3833,4748,8581,11164,2022,'RANCHO ALEGRE',Rancho Alegre,'PR',4121307,1896.0,1896,158.0,158.0,1,171.0,171.0,Pequeno I
4183,4208,412135,1762,994,152,321,473,521,1738.58,985.67,162.67,299.08,461.75,523.92,20863,11828,1952,3589,5541,6287,2022,'RANCHO ALEGRE DOESTE',Rancho Alegre D´oeste,'PR',4121356,1549.0,1549,129.1,129.1,1,122.0,122.0,Pequeno I
4184,4209,412140,5530,4303,791,1045,1836,2467,5107.33,4031.58,737.0,1004.83,1741.83,2289.75,61288,48379,8844,12058,20902,27477,2022,'REALEZA',Realeza,'PR',4121406,6577.0,6577,548.1,548.1,1,641.0,641.0,Pequeno I
4185,4210,412150,8094,7036,1495,3133,4628,2408,7826.5,6875.0,1383.92,3174.75,4558.67,2316.33,93918,82500,16607,38097,54704,27796,2022,'REBOUCAS',Rebouças,'PR',4121505,4329.0,4329,360.8,360.8,1,189.0,189.0,Pequeno I
4186,4211,412160,3162,1792,127,104,231,1561,3074.58,1848.33,196.92,109.67,306.58,1541.75,36895,22180,2363,1316,3679,18501,2022,'RENASCENCA',Renascença,'PR',4121604,3680.0,3680,306.7,306.7,1,238.0,238.0,Pequeno I
4187,4212,412170,13929,12408,2509,5313,7822,4586,13314.25,12005.83,2354.67,5219.67,7574.33,4431.5,159771,144070,28256,62636,90892,53178,2022,'RESERVA',Reserva,'PR',4121703,5210.0,5210,473.6,473.6,1,464.0,464.0,Pequeno II
4188,4213,412175,4282,3726,917,1202,2119,1607,4091.08,3638.58,821.83,1405.17,2227.0,1411.58,49093,43663,9862,16862,26724,16939,2022,'RESERVA DO IGUACU',Reserva do Iguaçu,'PR',4121752,4018.0,11516,334.8,959.7,1,452.0,452.0,Pequeno I
4189,4214,412180,5368,4363,708,1543,2251,2112,5126.75,4230.33,646.58,1657.0,2303.58,1926.75,61521,50764,7759,19884,27643,23121,2022,'RIBEIRAO CLARO',Ribeirão Claro,'PR',4121802,2554.0,2554,212.8,212.8,1,272.0,272.0,Pequeno I
4190,4215,412190,9329,7282,1054,2755,3809,3473,9121.67,7268.25,997.92,2872.42,3870.33,3397.92,109460,87219,11975,34469,46444,40775,2022,'RIBEIRAO DO PINHAL',Ribeirão do Pinhal,'PR',4121901,7557.0,8810,629.8,734.2,1,536.0,536.0,Pequeno I
4191,4216,412200,6222,4380,1242,746,1988,2392,5988.25,4343.67,1181.0,775.42,1956.42,2387.25,71859,52124,14172,9305,23477,28647,2022,'RIO AZUL',Rio Azul,'PR',4122008,5678.0,5678,473.2,473.2,1,390.0,390.0,Pequeno I
4192,4217,412210,1796,1290,199,534,733,557,1734.0,1267.75,203.83,490.42,694.25,573.5,20808,15213,2446,5885,8331,6882,2022,'RIO BOM',Rio Bom,'PR',4122107,1004.0,1004,100.4,100.4,1,80.0,80.0,Pequeno I
4193,4218,412215,10171,7816,1810,3418,5228,2588,9695.42,7686.92,1769.83,3361.67,5131.5,2555.42,116345,92243,21238,40340,61578,30665,2022,'RIO BONITO DO IGUACU',Rio Bonito do Iguaçu,'PR',4122156,7937.0,10098,661.4,841.5,1,719.0,719.0,Pequeno I
4194,4219,412217,2860,2463,55,1734,1789,674,2784.42,2446.0,78.67,1697.33,1776.0,670.0,33413,29352,944,20368,21312,8040,2022,'RIO BRANCO DO IVAI',Rio Branco do Ivaí,'PR',4122172,879.0,879,146.5,146.5,1,96.0,96.0,Pequeno I
4195,4220,412220,19881,16984,3950,4352,8302,8682,18688.83,16271.25,3820.42,5068.33,8888.75,7382.5,224266,195255,45845,60820,106665,88590,2022,'RIO BRANCO DO SUL',Rio Branco do Sul,'PR',4122206,13054.0,13054,1087.8,1087.8,1,895.0,895.0,Pequeno II
4196,4221,412230,9142,7652,1305,1167,2472,5180,8634.0,7409.0,1377.5,1358.08,2735.58,4673.42,103608,88908,16530,16297,32827,56081,2022,'RIO NEGRO',Rio Negro,'PR',4122305,4599.0,4599,383.2,383.2,1,403.0,403.0,Pequeno II
4197,4222,412240,24190,17725,3434,4806,8240,9485,22522.67,16669.67,3114.08,4578.25,7692.33,8977.33,270272,200036,37369,54939,92308,107728,2022,'ROLANDIA',Rolândia,'PR',4122404,15634.0,15634,1302.8,1302.8,3,1236.0,1236.0,Médio
4198,4223,412250,5772,4541,1207,732,1939,2602,5593.17,4470.08,1139.92,852.08,1992.0,2478.08,67118,53641,13679,10225,23904,29737,2022,'RONCADOR',Roncador,'PR',4122503,3933.0,3933,327.8,327.8,1,183.0,183.0,Pequeno I
4199,4224,412260,3970,3175,572,961,1533,1642,3822.92,3116.33,576.5,981.92,1558.42,1557.92,45875,37396,6918,11783,18701,18695,2022,'RONDON',Rondon,'PR',4122602,2081.0,2081,189.2,189.2,1,74.0,74.0,Pequeno I
4200,4225,412265,2978,2586,360,1498,1858,728,2823.83,2461.33,377.5,1329.75,1707.25,754.08,33886,29536,4530,15957,20487,9049,2022,'ROSARIO DO IVAI',Rosário do Ivaí,'PR',4122651,1991.0,1991,181.0,181.0,1,65.0,65.0,Pequeno I
4201,4226,412270,3380,2467,363,872,1235,1232,3115.67,2298.58,344.67,821.92,1166.58,1132.0,37388,27583,4136,9863,13999,13584,2022,'SABAUDIA',Sabáudia,'PR',4122701,2689.0,2689,224.1,224.1,1,152.0,152.0,Pequeno I
4202,4227,412280,1303,1069,230,214,444,625,1212.17,1021.25,229.08,244.5,473.58,547.67,14546,12255,2749,2934,5683,6572,2022,'SALGADO FILHO',Salgado Filho,'PR',4122800,2765.0,2765,230.4,230.4,1,98.0,98.0,Pequeno I
4203,4228,412290,3031,2440,464,855,1319,1121,2892.33,2318.42,449.08,812.08,1261.17,1057.25,34708,27821,5389,9745,15134,12687,2022,'SALTO DO ITARARE',Salto do Itararé,'PR',4122909,812.0,812,73.8,73.8,1,83.0,83.0,Pequeno I
4204,4229,412300,5240,4246,778,1213,1991,2255,4912.58,3998.33,749.5,1066.92,1816.42,2181.92,58951,47980,8994,12803,21797,26183,2022,'SALTO DO LONTRA',Salto do Lontra,'PR',4123006,4069.0,4069,339.1,339.1,1,185.0,185.0,Pequeno I
4205,4230,412310,2176,1709,353,375,728,981,2188.5,1799.33,363.0,459.33,822.33,977.0,26262,21592,4356,5512,9868,11724,2022,'SANTA AMELIA',Santa Amélia,'PR',4123105,745.0,745,62.1,62.1,1,38.0,38.0,Pequeno I
4206,4231,412320,2183,1503,192,454,646,857,2127.67,1501.58,193.42,427.75,621.17,880.42,25532,18019,2321,5133,7454,10565,2022,'SANTA CECILIA DO PAVAO',Santa Cecília do Pavão,'PR',4123204,411.0,411,34.2,34.2,1,14.0,14.0,Pequeno I
4207,4232,412330,4777,3537,784,852,1636,1901,4556.92,3517.08,741.0,1166.17,1907.17,1609.92,54683,42205,8892,13994,22886,19319,2022,'SANTA CRUZ DE MONTE CASTEL,Santa Cruz de Monte Castelo,'PR',4123303,4276.0,4276,356.3,356.3,1,433.0,433.0,Pequeno I
4208,4233,412340,3704,2846,485,354,839,2007,3546.83,2783.83,484.5,359.5,844.0,1939.83,42562,33406,5814,4314,10128,23278,2022,'SANTA FE',Santa fé,'PR',4123402,3785.0,3785,315.4,315.4,1,359.0,359.0,Pequeno I
4209,4234,412350,9620,6982,1360,1597,2957,4025,9018.17,6705.58,1358.92,1467.92,2826.83,3878.75,108218,80467,16307,17615,33922,46545,2022,'SANTA HELENA',Santa Helena,'PR',4123501,6618.0,6618,551.5,551.5,1,428.0,428.0,Pequeno II
4210,4235,412360,836,679,21,456,477,202,807.67,658.17,22.0,426.67,448.67,209.5,9692,7898,264,5120,5384,2514,2022,'SANTA INES',Santa Inês,'PR',4123600,993.0,993,82.8,82.8,1,78.0,78.0,Pequeno I
4211,4236,412370,3475,2670,564,598,1162,1508,2923.92,2284.17,491.17,495.17,986.33,1297.83,35087,27410,5894,5942,11836,15574,2022,'SANTA ISABEL DO IVAI',Santa Isabel do Ivaí,'PR',4123709,2075.0,2075,188.6,188.6,1,80.0,80.0,Pequeno I
4212,4237,412380,4798,3787,976,236,1212,2575,4620.58,3666.58,1033.08,323.67,1356.75,2309.83,55447,43999,12397,3884,16281,27718,2022,'SANTA IZABEL DO OESTE',Santa Izabel do Oeste,'PR',4123808,3070.0,3070,341.1,341.1,1,268.0,268.0,Pequeno I
4213,4238,412382,1413,1044,158,451,609,435,1321.25,998.67,153.67,417.75,571.42,427.25,15855,11984,1844,5013,6857,5127,2022,'SANTA LUCIA',Santa Lúcia,'PR',4123824,1789.0,1789,149.1,149.1,1,108.0,108.0,Pequeno I
4214,4239,412385,6927,5811,1588,2142,3730,2081,6655.58,5727.58,1547.33,2306.92,3854.25,1873.33,79867,68731,18568,27683,46251,22480,2022,'SANTA MARIA DO OESTE',Santa Maria do Oeste,'PR',4123857,3751.0,3751,312.6,312.6,1,230.0,230.0,Pequeno I
4215,4240,412390,6876,5784,1155,1749,2904,2880,6591.42,5636.75,1055.33,1926.58,2981.92,2654.83,79097,67641,12664,23119,35783,31858,2022,'SANTA MARIANA',Santa Mariana,'PR',4123907,5175.0,5175,431.2,431.2,1,250.0,250.0,Pequeno I
4216,4241,412395,2310,1740,237,791,1028,712,2242.67,1724.0,227.67,783.83,1011.5,712.5,26912,20688,2732,9406,12138,8550,2022,'SANTA MONICA',Santa Mônica,'PR',4123956,1619.0,1619,147.2,147.2,1,,,Pequeno I
4217,4242,412400,2782,2105,400,573,973,1132,2657.33,2074.92,401.42,586.08,987.5,1087.42,31888,24899,4817,7033,11850,13049,2022,'SANTANA DO ITARARE',Santana do Itararé,'PR',4124004,2547.0,2547,212.2,212.2,1,78.0,78.0,Pequeno I
4218,4243,412402,6824,5316,1166,1509,2675,2641,6418.25,5090.75,1122.5,1323.58,2446.08,2644.67,77019,61089,13470,15883,29353,31736,2022,'SANTA TEREZA DO OESTE',Santa Tereza do Oeste,'PR',4124020,7053.0,7053,587.8,587.8,1,412.0,412.0,Pequeno I
4219,4244,412405,9321,6986,1933,956,2889,4097,8951.67,6811.58,1922.58,821.92,2744.5,4067.08,107420,81739,23071,9863,32934,48805,2022,'SANTA TEREZINHA DE ITAIPU',Santa Terezinha de Itaipu,'PR',4124053,5109.0,5109,425.8,425.8,1,363.0,363.0,Pequeno II
4220,4245,412410,19444,15999,3327,4696,8023,7976,18220.17,15194.75,3016.92,4649.08,7666.0,7528.75,218642,182337,36203,55789,91992,90345,2022,'SANTO ANTONIO DA PLATINA',Santo Antônio da Platina,'PR',4124103,10064.0,10064,914.9,914.9,1,721.0,721.0,Pequeno II
4221,4246,412420,1490,1033,121,356,477,556,1475.17,1061.5,110.5,423.25,533.75,527.75,17702,12738,1326,5079,6405,6333,2022,'SANTO ANTONIO DO CAIUA',Santo Antônio do Caiuá,'PR',4124202,1579.0,1579,131.6,131.6,1,286.0,286.0,Pequeno I
4222,4247,412430,1589,969,133,355,488,481,1554.08,967.58,117.5,364.75,482.25,485.33,18649,11611,1410,4377,5787,5824,2022,'SANTO ANTONIO DO PARAISO',Santo Antônio do Paraíso,'PR',4124301,1638.0,1638,136.5,136.5,1,152.0,152.0,Pequeno I
4223,4248,412440,8805,6911,1619,1969,3588,3323,8379.0,6614.17,1564.25,1915.17,3479.42,3134.75,100548,79370,18771,22982,41753,37617,2022,'SANTO ANTONIO DO SUDOESTE',Santo Antônio do Sudoeste,'PR',4124400,0.0,18509,0.0,1542.4,1,0.0,1179.0,Pequeno I
4224,4249,412450,1769,1199,162,77,239,960,1640.0,1161.0,187.42,81.08,268.5,892.5,19680,13932,2249,973,3222,10710,2022,'SANTO INACIO',Santo Inácio,'PR',4124509,1796.0,1796,179.6,179.6,1,97.0,97.0,Pequeno I
4225,4250,412460,3226,2685,548,1145,1693,992,3099.5,2630.5,480.67,1190.5,1671.17,959.33,37194,31566,5768,14286,20054,11512,2022,'SAO CARLOS DO IVAI',São Carlos do Ivaí,'PR',4124608,4143.0,4143,414.3,414.3,1,236.0,236.0,Pequeno I
4226,4251,412470,5563,4794,1316,1198,2514,2280,5312.83,4627.58,1234.25,1165.33,2399.58,2228.0,63754,55531,14811,13984,28795,26736,2022,'SAO JERONIMO DA SERRA',São Jerônimo da Serra,'PR',4124707,5670.0,5670,472.5,472.5,1,962.0,962.0,Pequeno I
4227,4252,412480,3806,2785,521,970,1491,1294,3447.92,2581.0,468.58,896.33,1364.92,1216.08,41375,30972,5623,10756,16379,14593,2022,'SAO JOAO',São João,'PR',4124806,4765.0,4765,397.1,397.1,1,347.0,347.0,Pequeno I
4228,4253,412490,3674,3034,235,1623,1858,1176,3565.0,2964.83,255.83,1581.92,1837.75,1127.08,42780,35578,3070,18983,22053,13525,2022,'SAO JOAO DO CAIUA',São João do Caiuá,'PR',4124905,1626.0,1626,135.5,135.5,1,118.0,118.0,Pequeno I
4229,4254,412500,5833,4647,860,1334,2194,2453,5591.08,4572.08,850.67,1401.25,2251.92,2320.17,67093,54865,10208,16815,27023,27842,2022,'SAO JOAO DO IVAI',São João do Ivaí,'PR',4125001,3384.0,3384,282.0,282.0,1,281.0,281.0,Pequeno I
4230,4255,412510,6612,4998,1434,662,2096,2902,6422.67,4940.08,1425.42,722.5,2147.92,2792.17,77072,59281,17105,8670,25775,33506,2022,'SAO JOAO DO TRIUNFO',São João do Triunfo,'PR',4125100,4068.0,4068,339.0,339.0,1,66.0,66.0,Pequeno I
4231,4256,412520,4055,2766,535,362,897,1869,3775.33,2554.42,533.58,400.5,934.08,1620.33,45304,30653,6403,4806,11209,19444,2022,'SAO JORGE DOESTE',São Jorge D´oeste,'PR',4125209,3070.0,3070,341.1,341.1,1,353.0,353.0,Pequeno I
4232,4257,412530,2090,1647,300,341,641,1006,1992.33,1581.08,245.5,307.0,552.5,1028.58,23908,18973,2946,3684,6630,12343,2022,'SAO JORGE DO IVAI',São Jorge do Ivaí,'PR',4125308,7846.0,8888,653.8,740.7,1,869.0,869.0,Pequeno I
4233,4258,412535,2455,1611,254,136,390,1221,2309.83,1696.58,353.42,190.08,543.5,1153.08,27718,20359,4241,2281,6522,13837,2022,'SAO JORGE DO PATROCINIO',São Jorge do Patrocínio,'PR',4125357,3378.0,3378,281.5,281.5,1,63.0,63.0,Pequeno I
4234,4259,412540,3148,2494,585,553,1138,1356,3112.67,2501.25,516.17,682.42,1198.58,1302.67,37352,30015,6194,8189,14383,15632,2022,'SAO JOSE DA BOA VISTA',São José da Boa Vista,'PR',4125407,3332.0,3332,277.7,277.7,1,146.0,146.0,Pequeno I
4235,4260,412545,2143,1549,293,483,776,773,1979.42,1516.25,286.0,464.92,750.92,765.33,23753,18195,3432,5579,9011,9184,2022,'SAO JOSE DAS PALMEIRAS',São José Das Palmeiras,'PR',4125456,2450.0,2450,306.2,306.2,1,,,Pequeno I
4236,4261,412550,113494,89675,14396,38132,52528,37147,105575.17,84393.5,13569.5,35161.0,48730.5,35663.0,1266902,1012722,162834,421932,584766,427956,2022,'SAO JOSE DOS PINHAIS',São José Dos Pinhais,'PR',4125506,168897.0,172072,14074.8,14339.3,10,10509.0,10509.0,Grande
4237,4262,412555,854,594,86,149,235,359,831.58,608.0,89.58,153.67,243.25,364.75,9979,7296,1075,1844,2919,4377,2022,'SAO MANOEL DO PARANA',São Manoel do Paraná,'PR',4125555,803.0,803,73.0,73.0,1,55.0,55.0,Pequeno I
4238,4263,412560,17099,13410,3615,2594,6209,7201,16025.42,12884.42,3046.75,3164.83,6211.58,6672.83,192305,154613,36561,37978,74539,80074,2022,'SAO MATEUS DO SUL',São Mateus do Sul,'PR',4125605,5006.0,32936,417.2,2744.7,1,0.0,2500.0,Pequeno II
4239,4264,412570,12169,8343,1630,1292,2922,5421,12289.92,8579.33,1772.75,1357.33,3130.08,5449.25,147479,102952,21273,16288,37561,65391,2022,'SAO MIGUEL DO IGUACU',São Miguel do Iguaçu,'PR',4125704,13659.0,13659,1138.2,1138.2,1,891.0,891.0,Pequeno II
4240,4265,412575,3142,2657,579,1152,1731,926,2927.58,2542.08,451.5,1230.33,1681.83,860.25,35131,30505,5418,14764,20182,10323,2022,'SAO PEDRO DO IGUACU',São Pedro do Iguaçu,'PR',4125753,2667.0,2667,222.2,222.2,1,201.0,201.0,Pequeno I
4241,4266,412580,4528,3545,342,1811,2153,1392,4306.75,3421.67,319.0,1782.5,2101.5,1320.17,51681,41060,3828,21390,25218,15842,2022,'SAO PEDRO DO IVAI',São Pedro do Ivaí,'PR',4125803,4790.0,4790,399.2,399.2,1,341.0,341.0,Pequeno I
4242,4267,412590,1362,820,179,72,251,569,1248.0,793.33,170.75,77.67,248.42,544.92,14976,9520,2049,932,2981,6539,2022,'SAO PEDRO DO PARANA',São Pedro do Paraná,'PR',4125902,930.0,930,77.5,77.5,1,40.0,40.0,Pequeno I
4243,4268,412600,4936,4116,320,2459,2779,1337,4761.92,3963.58,400.08,2140.33,2540.42,1423.17,57143,47563,4801,25684,30485,17078,2022,'SAO SEBASTIAO DA AMOREIRA',São Sebastião da Amoreira,'PR',4126009,4097.0,4097,341.4,341.4,1,186.0,186.0,Pequeno I
4244,4269,412610,2546,1963,274,774,1048,915,2482.17,1930.58,289.75,773.33,1063.08,867.5,29786,23167,3477,9280,12757,10410,2022,'SAO TOME',São Tomé,'PR',4126108,3110.0,3110,259.2,259.2,1,101.0,101.0,Pequeno I
4245,4270,412620,3696,3144,665,1203,1868,1276,3591.42,3079.08,666.67,1115.92,1782.58,1296.5,43097,36949,8000,13391,21391,15558,2022,'SAPOPEMA',Sapopema,'PR',4126207,4070.0,4070,339.2,339.2,1,250.0,250.0,Pequeno I
4246,4271,412625,29149,21547,4612,2590,7202,14345,26488.42,19560.33,3965.58,1800.58,5766.17,13794.17,317861,234724,47587,21607,69194,165530,2022,'SARANDI',Sarandi,'PR',4126256,29758.0,52525,2479.8,4377.1,2,3085.0,3085.0,Médio
4247,4272,412627,3644,2787,772,520,1292,1495,3449.5,2670.92,618.75,681.17,1299.92,1371.0,41394,32051,7425,8174,15599,16452,2022,'SAUDADE DO IGUACU',Saudade do Iguaçu,'PR',4126272,4011.0,5118,334.2,426.5,1,160.0,160.0,Pequeno I
4248,4273,412630,9259,7010,1294,1439,2733,4277,8949.42,6989.92,1326.5,1637.83,2964.33,4025.58,107393,83879,15918,19654,35572,48307,2022,'SENGES',Sengés,'PR',4126306,4900.0,4900,408.3,408.3,1,270.0,270.0,Pequeno I
4249,4274,412635,1393,971,165,229,394,577,1294.0,935.58,133.33,247.08,380.42,555.17,15528,11227,1600,2965,4565,6662,2022,'SERRANOPOLIS DO IGUACU',Serranópolis do Iguaçu,'PR',4126355,1375.0,1375,114.6,114.6,1,200.0,200.0,Pequeno I
4250,4275,412640,2998,1921,295,270,565,1356,2929.67,1945.75,266.33,371.17,637.5,1308.25,35156,23349,3196,4454,7650,15699,2022,'SERTANEJA',Sertaneja,'PR',4126405,2872.0,2872,239.3,239.3,1,327.0,327.0,Pequeno I
4251,4276,412650,5289,4354,819,1480,2299,2055,5018.08,4202.25,777.42,1470.0,2247.42,1954.83,60217,50427,9329,17640,26969,23458,2022,'SERTANOPOLIS',Sertanópolis,'PR',4126504,2632.0,2632,219.3,219.3,1,209.0,209.0,Pequeno I
4252,4277,412660,8214,6300,820,2133,2953,3347,7539.42,5966.08,790.92,2034.08,2825.0,3141.08,90473,71593,9491,24409,33900,37693,2022,'SIQUEIRA CAMPOS',Siqueira Campos,'PR',4126603,5732.0,5732,477.7,477.7,1,418.0,418.0,Pequeno I
4253,4278,412665,1199,983,212,362,574,409,1101.83,917.08,183.17,369.83,553.0,364.08,13222,11005,2198,4438,6636,4369,2022,'SULINA',Sulina,'PR',4126652,32.0,32,32.0,32.0,1,32.0,32.0,Pequeno I
4254,4279,412667,5140,4015,684,1595,2279,1736,5015.25,3979.67,637.75,1668.83,2306.58,1673.08,60183,47756,7653,20026,27679,20077,2022,'TAMARANA',Tamarana,'PR',4126678,5397.0,5397,449.8,449.8,1,510.0,510.0,Pequeno I
4255,4280,412670,2461,1878,393,639,1032,846,2269.17,1760.0,373.58,517.08,890.67,869.33,27230,21120,4483,6205,10688,10432,2022,'TAMBOARA',Tamboara,'PR',4126702,1540.0,1540,140.0,140.0,1,158.0,158.0,Pequeno I
4256,4281,412680,6376,4862,631,1180,1811,3051,6079.33,4725.42,658.33,1312.25,1970.58,2754.83,72952,56705,7900,15747,23647,33058,2022,'TAPEJARA',Tapejara,'PR',4126801,5575.0,5575,464.6,464.6,1,311.0,311.0,Pequeno I
4257,4282,412690,3374,2552,527,794,1321,1231,3294.83,2536.5,526.75,789.67,1316.42,1220.08,39538,30438,6321,9476,15797,14641,2022,'TAPIRA',Tapira,'PR',4126900,1880.0,1880,156.7,156.7,1,100.0,100.0,Pequeno I
4258,4283,412700,5500,4852,1112,2077,3189,1663,5414.08,4857.42,842.67,2424.42,3267.08,1590.33,64969,58289,10112,29093,39205,19084,2022,'TEIXEIRA SOARES',Teixeira Soares,'PR',4127007,4157.0,4157,346.4,346.4,1,90.0,90.0,Pequeno I
4259,4284,412710,18447,14760,2805,3298,6103,8657,18204.42,14810.0,2984.5,3523.42,6507.92,8302.08,218453,177720,35814,42281,78095,99625,2022,'TELEMACO BORBA',Telêmaco Borba,'PR',4127106,30719.0,30719,2559.9,2559.9,3,2059.0,2059.0,Médio
4260,4285,412720,4221,3594,592,882,1474,2120,3885.58,3317.17,561.5,800.08,1361.58,1955.58,46627,39806,6738,9601,16339,23467,2022,'TERRA BOA',Terra Boa,'PR',4127205,7922.0,8967,792.2,896.7,1,876.0,876.0,Pequeno I
4261,4286,412730,8003,6366,1230,2397,3627,2739,7553.75,5996.67,1123.75,2201.25,3325.0,2671.67,90645,71960,13485,26415,39900,32060,2022,'TERRA RICA',Terra Rica,'PR',4127304,4009.0,4009,334.1,334.1,1,273.0,273.0,Pequeno I
4262,4287,412740,6486,4911,1033,754,1787,3124,6079.33,4735.5,1030.92,712.83,1743.75,2991.75,72952,56826,12371,8554,20925,35901,2022,'TERRA ROXA',Terra Roxa,'PR',4127403,0.0,22835,0.0,1902.9,1,0.0,2439.0,Pequeno I
4263,4288,412750,11874,10350,1439,5435,6874,3476,11411.42,10162.25,1180.75,5874.0,7054.75,3107.5,136937,121947,14169,70488,84657,37290,2022,'TIBAGI',Tibagi,'PR',4127502,7088.0,7088,590.7,590.7,1,300.0,300.0,Pequeno I
4264,4289,412760,9429,8279,1871,4159,6030,2249,8832.33,7891.67,1654.33,4134.75,5789.08,2102.58,105988,94700,19852,49617,69469,25231,2022,'TIJUCAS DO SUL',Tijucas do Sul,'PR',4127601,6589.0,6589,549.1,549.1,1,597.0,597.0,Pequeno I
4265,4290,412770,36869,24045,3446,4885,8331,15714,33072.33,22027.75,3114.08,4163.0,7277.08,14750.67,396868,264333,37369,49956,87325,177008,2022,'TOLEDO',Toledo,'PR',4127700,103575.0,103575,8631.2,8631.2,6,8185.0,8185.0,Grande
4266,4291,412780,3734,3000,797,855,1652,1348,3522.25,2906.5,748.58,946.25,1694.83,1211.67,42267,34878,8983,11355,20338,14540,2022,'TOMAZINA',Tomazina,'PR',4127809,3535.0,3535,294.6,294.6,1,332.0,332.0,Pequeno I
4267,4292,412785,5817,4485,632,2757,3389,1096,5600.5,4391.75,575.83,2764.33,3340.17,1051.58,67206,52701,6910,33172,40082,12619,2022,'TRES BARRAS DO PARANA',Três Barras do Paraná,'PR',4127858,5857.0,11404,488.1,950.3,1,0.0,1126.0,Pequeno I
4268,4293,412788,4454,3868,1040,1337,2377,1491,4330.5,3807.0,960.83,1452.33,2413.17,1393.83,51966,45684,11530,17428,28958,16726,2022,'TUNAS DO PARANA',Tunas do Paraná,'PR',4127882,3950.0,3950,438.9,438.9,1,,,Pequeno I
4269,4294,412790,4091,2938,524,961,1485,1453,3950.92,2811.33,495.5,834.25,1329.75,1481.58,47411,33736,5946,10011,15957,17779,2022,'TUNEIRAS DO OESTE',Tuneiras do Oeste,'PR',4127908,2082.0,2082,173.5,173.5,1,74.0,74.0,Pequeno I
4270,4295,412795,3560,2371,407,517,924,1447,3479.0,2295.08,412.92,441.25,854.17,1440.92,41748,27541,4955,5295,10250,17291,2022,'TUPASSI',Tupãssi,'PR',4127957,601.0,601,120.2,120.2,1,172.0,172.0,Pequeno I
4271,4296,412796,7271,6471,1559,1843,3402,3069,7052.0,6327.17,1517.42,1914.5,3431.92,2895.25,84624,75926,18209,22974,41183,34743,2022,'TURVO',Turvo,'PR',4127965,7394.0,7394,672.2,672.2,1,497.0,497.0,Pequeno I
4272,4297,412800,11249,8733,1101,4240,5341,3392,10362.92,8104.25,1067.0,3699.25,4766.25,3338.0,124355,97251,12804,44391,57195,40056,2022,'UBIRATA',Ubiratã,'PR',4128005,12351.0,12351,1029.2,1029.2,1,749.0,749.0,Pequeno II
4273,4298,412810,38933,28471,3743,10722,14465,14006,35931.83,26706.67,3623.0,10128.75,13751.75,12954.92,431182,320480,43476,121545,165021,155459,2022,'UMUARAMA',Umuarama,'PR',4128104,25072.0,25072,2089.3,2089.3,3,1597.0,1597.0,Grande
4274,4299,412820,20003,15449,4081,3933,8014,7435,18971.5,14938.0,3658.83,4462.92,8121.75,6816.25,227658,179256,43906,53555,97461,81795,2022,'UNIAO DA VITORIA',União da Vitória,'PR',4128203,17489.0,17489,1457.4,1457.4,2,1484.0,1484.0,Médio
4275,4300,412830,1092,886,101,222,323,563,1046.58,858.92,101.08,208.17,309.25,549.67,12559,10307,1213,2498,3711,6596,2022,'UNIFLOR',Uniflor,'PR',4128302,787.0,787,65.6,65.6,1,55.0,55.0,Pequeno I
4276,4301,412840,5251,4006,403,2216,2619,1387,5009.25,3856.5,411.42,1974.58,2386.0,1470.5,60111,46278,4937,23695,28632,17646,2022,'URAI',Uraí,'PR',4128401,6267.0,8669,522.2,722.4,1,289.0,289.0,Pequeno I
4277,4302,412850,8197,6798,903,3131,4034,2764,7827.67,6540.83,879.92,2981.67,3861.58,2679.25,93932,78490,10559,35780,46339,32151,2022,'WENCESLAU BRAZ',Wenceslau Braz,'PR',4128500,7494.0,7494,624.5,624.5,1,331.0,331.0,Pequeno I
4278,4303,412853,4538,3977,577,1966,2543,1434,4294.08,3799.58,571.83,1840.75,2412.58,1387.0,51529,45595,6862,22089,28951,16644,2022,'VENTANIA',Ventania,'PR',4128534,6221.0,12218,518.4,1018.2,1,760.0,760.0,Pequeno I
4279,4304,412855,4027,2411,357,429,786,1625,3866.67,2441.42,379.08,464.5,843.58,1597.83,46400,29297,4549,5574,10123,19174,2022,'VERA CRUZ DO OESTE',Vera Cruz do Oeste,'PR',4128559,5400.0,5400,450.0,450.0,1,227.0,227.0,Pequeno I
4280,4305,412860,2172,1638,326,552,878,760,2060.33,1594.08,290.5,612.25,902.75,691.33,24724,19129,3486,7347,10833,8296,2022,'VERE',Verê,'PR',4128609,3983.0,3983,331.9,331.9,1,131.0,131.0,Pequeno I
4281,4306,412862,1892,1458,260,543,803,655,1810.75,1414.33,263.83,529.17,793.0,621.33,21729,16972,3166,6350,9516,7456,2022,'ALTO PARAISO',Vila Alta,'PR',4128625,1344.0,1344,112.0,112.0,1,62.0,62.0,Pequeno I
4282,4307,412863,4187,3826,920,1660,2580,1246,4042.42,3741.25,944.92,1525.08,2470.0,1271.25,48509,44895,11339,18301,29640,15255,2022,'DOUTOR ULYSSES',Doutor Ulysses,'PR',4128633,2336.0,14662,194.7,1221.8,1,351.0,351.0,Pequeno I
4283,4308,412865,2101,1638,444,385,829,809,2033.92,1614.92,418.33,434.58,852.92,762.0,24407,19379,5020,5215,10235,9144,2022,'VIRMOND',Virmond,'PR',4128658,1274.0,1274,106.2,106.2,1,105.0,105.0,Pequeno I
4284,4309,412870,2839,2291,750,591,1341,950,2577.08,2120.67,637.75,641.0,1278.75,841.92,30925,25448,7653,7692,15345,10103,2022,'VITORINO',Vitorino,'PR',4128708,5928.0,7098,538.9,645.3,1,557.0,557.0,Pequeno I
4285,4310,412880,2917,2341,542,759,1301,1040,2699.67,2155.42,463.5,625.75,1089.25,1066.17,32396,25865,5562,7509,13071,12794,2022,'XAMBRE',Xambrê,'PR',4128807,881.0,881,73.4,73.4,1,82.0,82.0,Pequeno I
4286,4311,420005,1512,953,77,450,527,426,1377.0,908.92,79.92,438.58,518.5,390.42,16524,10907,959,5263,6222,4685,2022,'ABDON BATISTA',Abdon Batista,'SC',4200051,5449.0,5449,454.1,454.1,1,637.0,637.0,Pequeno I
4287,4312,420010,8896,6640,474,4797,5271,1369,8664.75,6583.25,478.17,4870.42,5348.58,1234.67,103977,78999,5738,58445,64183,14816,2022,'ABELARDO LUZ',Abelardo Luz,'SC',4200101,3150.0,3150,315.0,315.0,1,208.0,208.0,Pequeno I
4288,4313,420020,1551,1172,262,307,569,603,1550.08,1135.33,242.42,284.92,527.33,608.0,18601,13624,2909,3419,6328,7296,2022,'AGROLANDIA',Agrolândia,'SC',4200200,409.0,409,81.8,81.8,1,72.0,72.0,Pequeno I
4289,4314,420030,505,397,115,97,212,185,436.17,333.08,103.08,83.25,186.33,146.75,5234,3997,1237,999,2236,1761,2022,'AGRONOMICA',Agronômica,'SC',4200309,928.0,928,77.3,77.3,1,80.0,80.0,Pequeno I
4290,4315,420040,2110,1475,312,94,406,1069,1900.0,1331.83,345.25,100.17,445.42,886.42,22800,15982,4143,1202,5345,10637,2022,'AGUA DOCE',Água Doce,'SC',4200408,1340.0,1340,111.7,111.7,1,112.0,112.0,Pequeno I
4291,4316,420050,2148,1588,304,808,1112,476,1864.75,1394.33,315.33,695.17,1010.5,383.83,22377,16732,3784,8342,12126,4606,2022,'AGUAS DE CHAPECO',Águas de Chapecó,'SC',4200507,1727.0,1727,143.9,143.9,1,126.0,126.0,Pequeno I
4292,4317,420055,592,376,79,130,209,167,549.92,348.17,77.25,110.08,187.33,160.83,6599,4178,927,1321,2248,1930,2022,'AGUAS FRIAS',Águas Frias,'SC',4200556,1058.0,1058,88.2,88.2,1,52.0,52.0,Pequeno I
4293,4319,420070,2968,2493,546,1216,1762,731,2660.08,2217.08,502.17,1011.08,1513.25,703.83,31921,26605,6026,12133,18159,8446,2022,'ALFREDO WAGNER',Alfredo Wagner,'SC',4200705,7626.0,7626,635.5,635.5,1,320.0,320.0,Pequeno I
4294,4320,420075,274,166,29,41,70,96,236.5,154.5,25.25,28.83,54.08,100.42,2838,1854,303,346,649,1205,2022,'ALTO BELA VISTA',Alto Bela Vista,'SC',4200754,734.0,734,61.2,61.2,1,40.0,40.0,Pequeno I
4295,4321,420080,1416,1008,211,250,461,547,1297.58,996.08,224.67,336.92,561.58,434.5,15571,11953,2696,4043,6739,5214,2022,'ANCHIETA',Anchieta,'SC',4200804,2229.0,2229,185.8,185.8,1,119.0,119.0,Pequeno I
4296,4322,420090,1623,1163,273,222,495,668,1461.25,1063.92,261.67,209.58,471.25,592.67,17535,12767,3140,2515,5655,7112,2022,'ANGELINA',Angelina,'SC',4200903,865.0,865,72.1,72.1,1,52.0,52.0,Pequeno I
4297,4323,420100,4164,3624,253,2655,2908,716,3843.25,3400.5,211.67,2586.5,2798.17,602.33,46119,40806,2540,31038,33578,7228,2022,'ANITA GARIBALDI',Anita Garibaldi,'SC',4201000,485.0,485,40.4,40.4,1,40.0,40.0,Pequeno I
4298,4324,420110,1086,964,163,510,673,291,953.92,859.58,151.0,455.42,606.42,253.17,11447,10315,1812,5465,7277,3038,2022,'ANITAPOLIS',Anitápolis,'SC',4201109,832.0,832,69.3,69.3,1,26.0,26.0,Pequeno I
4299,4326,420125,1320,1004,207,290,497,507,1216.08,938.83,220.92,296.33,517.25,421.58,14593,11266,2651,3556,6207,5059,2022,'APIUNA',Apiúna,'SC',4201257,1422.0,1422,118.5,118.5,1,108.0,108.0,Pequeno I
4300,4327,420127,1037,526,107,180,287,239,937.0,475.5,95.33,176.5,271.83,203.67,11244,5706,1144,2118,3262,2444,2022,'ARABUTA',Arabutã,'SC',4201273,507.0,507,50.7,50.7,1,23.0,23.0,Pequeno I
4301,4328,420130,15427,12906,2876,4521,7397,5509,13216.58,11270.67,2346.92,4301.75,6648.67,4622.0,158599,135248,28163,51621,79784,55464,2022,'ARAQUARI',Araquari,'SC',4201307,14805.0,14805,1345.9,1345.9,2,437.0,437.0,Pequeno II
4302,4329,420140,14633,12258,3777,2800,6577,5681,12611.83,10638.83,3243.17,2548.83,5792.0,4846.83,151342,127666,38918,30586,69504,58162,2022,'ARARANGUA',Araranguá,'SC',4201406,3927.0,3927,327.2,327.2,1,144.0,144.0,Médio
4303,4330,420150,2102,1735,166,931,1097,638,1896.67,1558.08,163.58,885.17,1048.75,509.33,22760,18697,1963,10622,12585,6112,2022,'ARMAZEM',Armazém,'SC',4201505,493.0,493,44.8,44.8,1,9.0,9.0,Pequeno I
4304,4331,420160,614,318,72,87,159,159,556.25,287.58,59.58,74.75,134.33,153.25,6675,3451,715,897,1612,1839,2022,'ARROIO TRINTA',Arroio Trinta,'SC',4201604,203.0,203,29.0,29.0,1,29.0,29.0,Pequeno I
4305,4332,420165,636,433,110,97,207,226,541.17,383.5,88.67,105.5,194.17,189.33,6494,4602,1064,1266,2330,2272,2022,'ARVOREDO',Arvoredo,'SC',4201653,365.0,365,30.4,30.4,1,21.0,21.0,Pequeno I
4306,4333,420170,1134,919,169,345,514,405,984.83,777.67,146.92,249.75,396.67,381.0,11818,9332,1763,2997,4760,4572,2022,'ASCURRA',Ascurra,'SC',4201703,1725.0,1725,143.8,143.8,1,91.0,91.0,Pequeno I
4307,4334,420180,595,384,73,89,162,222,578.67,395.0,81.08,88.67,169.75,225.25,6944,4740,973,1064,2037,2703,2022,'ATALANTA',Atalanta,'SC',4201802,466.0,466,38.8,38.8,1,20.0,20.0,Pequeno I
4308,4335,420190,742,475,92,136,228,247,687.25,440.67,96.58,141.33,237.92,202.75,8247,5288,1159,1696,2855,2433,2022,'AURORA',Aurora,'SC',4201901,276.0,276,25.1,25.1,1,8.0,8.0,Pequeno I
4309,4336,420195,6053,5164,1440,2108,3548,1616,5165.58,4424.75,1310.17,1601.92,2912.08,1512.67,61987,53097,15722,19223,34945,18152,2022,'BALNEARIO ARROIO DO SILVA',Balneário Arroio do Silva,'SC',4201950,2937.0,2937,293.7,293.7,1,188.0,188.0,Pequeno I
4310,4337,420200,21785,15826,2303,6507,8810,7016,17565.58,12916.17,1983.0,5302.67,7285.67,5630.5,210787,154994,23796,63632,87428,67566,2022,'BALNEARIO CAMBORIU',Balneário Camboriú,'SC',4202008,21482.0,21482,1790.2,1790.2,4,1330.0,1330.0,Grande
4311,4338,420205,6781,5001,783,2449,3232,1769,6078.92,4583.17,770.67,2339.58,3110.25,1472.92,72947,54998,9248,28075,37323,17675,2022,'BALNEARIO BARRA DO SUL',Balneário Barra do Sul,'SC',4202057,1905.0,1905,158.8,158.8,1,138.0,138.0,Pequeno I
4312,4339,420207,6766,4967,1027,1851,2878,2089,5993.0,4423.25,844.67,1694.92,2539.58,1883.67,71916,53079,10136,20339,30475,22604,2022,'BALNEARIO GAIVOTA',Balneário Gaivota,'SC',4202073,5683.0,5683,473.6,473.6,1,315.0,315.0,Pequeno I
4313,4340,420208,1198,834,291,128,419,415,1068.67,751.67,251.83,151.92,403.75,347.92,12824,9020,3022,1823,4845,4175,2022,'BANDEIRANTE',Bandeirante,'SC',4202081,351.0,351,29.2,29.2,1,49.0,49.0,Pequeno I
4314,4341,420209,628,399,51,172,223,176,576.17,384.83,54.83,167.25,222.08,162.75,6914,4618,658,2007,2665,1953,2022,'BARRA BONITA',Barra Bonita,'SC',4202099,1371.0,1371,114.2,114.2,1,50.0,50.0,Pequeno I
4315,4343,420213,2802,2356,497,889,1386,970,2642.83,2309.92,496.67,902.25,1398.92,911.0,31714,27719,5960,10827,16787,10932,2022,'BELA VISTA DO TOLDO',Bela Vista do Toldo,'SC',4202131,2301.0,2301,191.8,191.8,1,160.0,160.0,Pequeno I
4316,4344,420215,844,631,169,177,346,285,756.25,575.67,148.17,165.5,313.67,262.0,9075,6908,1778,1986,3764,3144,2022,'BELMONTE',Belmonte,'SC',4202156,960.0,960,80.0,80.0,1,41.0,41.0,Pequeno I
4317,4345,420220,1237,947,188,312,500,447,1082.58,825.42,155.42,288.42,443.83,381.58,12991,9905,1865,3461,5326,4579,2022,'BENEDITO NOVO',Benedito Novo,'SC',4202206,1978.0,1978,164.8,164.8,1,174.0,174.0,Pequeno I
4318,4346,420230,18969,15905,2224,8342,10566,5339,16867.33,14286.33,1976.5,7589.17,9565.67,4720.67,202408,171436,23718,91070,114788,56648,2022,'BIGUACU',Biguaçu,'SC',4202305,4737.0,4737,394.8,394.8,2,422.0,422.0,Médio
4319,4347,420240,52690,36994,5427,14339,19766,17228,47221.33,33598.83,4748.33,13859.17,18607.5,14991.33,566656,403186,56980,166310,223290,179896,2022,'BLUMENAU',Blumenau,'SC',4202404,109817.0,109817,9151.4,9151.4,7,7729.0,7729.0,Grande
4320,4348,420243,1415,1209,226,748,974,235,1246.42,1096.17,173.83,708.75,882.58,213.58,14957,13154,2086,8505,10591,2563,2022,'BOCAINA DO SUL',Bocaina do Sul,'SC',4202438,311.0,311,25.9,25.9,1,15.0,15.0,Pequeno I
4321,4349,420245,6024,4976,486,2906,3392,1584,4990.92,4166.25,428.42,2484.17,2912.58,1253.67,59891,49995,5141,29810,34951,15044,2022,'BOMBINHAS',Bombinhas,'SC',4202453,770.0,770,64.2,64.2,1,50.0,50.0,Pequeno I
4322,4350,420250,1774,1634,152,1226,1378,256,1530.08,1414.5,142.75,997.25,1140.0,274.5,18361,16974,1713,11967,13680,3294,2022,'BOM JARDIM DA SERRA',Bom Jardim da Serra,'SC',4202503,728.0,728,66.2,66.2,1,95.0,95.0,Pequeno I
4323,4351,420253,1355,1103,99,658,757,346,1250.58,1039.92,91.08,620.83,711.92,328.0,15007,12479,1093,7450,8543,3936,2022,'BOM JESUS',Bom Jesus,'SC',4202537,1021.0,1021,85.1,85.1,1,49.0,49.0,Pequeno I
4324,4352,420257,511,395,83,179,262,133,461.0,355.08,59.5,186.0,245.5,109.58,5532,4261,714,2232,2946,1315,2022,'BOM JESUS DO OESTE',Bom Jesus do Oeste,'SC',4202578,36.0,36,36.0,36.0,1,36.0,36.0,Pequeno I
4325,4353,420260,3595,3107,301,2239,2540,567,3319.25,2876.83,295.0,2118.33,2413.33,463.5,39831,34522,3540,25420,28960,5562,2022,'BOM RETIRO',Bom Retiro,'SC',4202602,1048.0,1048,174.7,174.7,1,,,Pequeno I
4326,4354,420270,1773,962,113,381,494,468,1656.58,948.67,124.0,360.42,484.42,464.25,19879,11384,1488,4325,5813,5571,2022,'BOTUVERA',Botuverá,'SC',4202701,2856.0,2856,259.6,259.6,1,236.0,236.0,Pequeno I
4327,4355,420280,5243,4358,668,1880,2548,1810,4573.0,3934.0,651.42,1716.25,2367.67,1566.33,54876,47208,7817,20595,28412,18796,2022,'BRACO DO NORTE',Braço do Norte,'SC',4202800,3128.0,3128,260.7,260.7,1,484.0,484.0,Pequeno II
4328,4356,420285,541,333,67,69,136,197,396.33,282.08,66.75,55.83,122.58,159.5,4756,3385,801,670,1471,1914,2022,'BRACO DO TROMBUDO',Braço do Trombudo,'SC',4202859,806.0,806,67.2,67.2,1,52.0,52.0,Pequeno I
4329,4357,420287,1279,1037,202,415,617,420,1161.33,955.75,193.33,424.75,618.08,337.67,13936,11469,2320,5097,7417,4052,2022,'BRUNOPOLIS',Brunópolis,'SC',4202875,1234.0,1234,102.8,102.8,1,100.0,100.0,Pequeno I
4330,4358,420290,18847,15681,2602,8201,10803,4878,16806.58,14013.75,2182.67,7556.67,9739.33,4274.42,201679,168165,26192,90680,116872,51293,2022,'BRUSQUE',Brusque,'SC',4202909,5447.0,5447,453.9,453.9,2,482.0,482.0,Grande
4331,4359,420300,26540,16724,3381,4433,7814,8910,23884.83,15677.33,3157.58,4510.08,7667.67,8009.67,286618,188128,37891,54121,92012,96116,2022,'CACADOR',Caçador,'SC',4203006,38250.0,38250,3187.5,3187.5,3,2726.0,2726.0,Médio
4332,4360,420310,2245,1528,184,714,898,630,2188.42,1444.5,154.83,756.17,911.0,533.5,26261,17334,1858,9074,10932,6402,2022,'CAIBI',Caibi,'SC',4203105,2027.0,2027,168.9,168.9,1,95.0,95.0,Pequeno I
4333,4361,420315,2992,2134,287,1013,1300,834,2490.17,1954.25,274.25,1003.17,1277.42,676.83,29882,23451,3291,12038,15329,8122,2022,'CALMON',Calmon,'SC',4203154,1756.0,1756,175.6,175.6,1,223.0,223.0,Pequeno I
4334,4362,420320,20201,17047,5168,4844,10012,7035,17607.67,14838.17,4581.17,4432.92,9014.08,5824.08,211292,178058,54974,53195,108169,69889,2022,'CAMBORIU',Camboriú,'SC',4203204,1173.0,1173,97.8,97.8,1,107.0,107.0,Médio
4335,4363,420325,1121,862,142,286,428,434,1071.17,849.75,132.58,312.0,444.58,405.17,12854,10197,1591,3744,5335,4862,2022,'CAPAO ALTO',Capão Alto,'SC',4203253,84.0,84,9.3,9.3,1,19.0,19.0,Pequeno I
4336,4364,420330,3700,2576,545,723,1268,1308,3219.67,2367.08,490.67,677.08,1167.75,1199.33,38636,28405,5888,8125,14013,14392,2022,'CAMPO ALEGRE',Campo Alegre,'SC',4203303,6533.0,9090,544.4,757.5,1,843.0,843.0,Pequeno I
4337,4365,420340,3693,3064,755,1068,1823,1241,3265.42,2747.17,648.83,880.92,1529.75,1217.42,39185,32966,7786,10571,18357,14609,2022,'CAMPO BELO DO SUL',Campo Belo do Sul,'SC',4203402,1875.0,1875,170.5,170.5,1,101.0,101.0,Pequeno I
4338,4366,420350,3857,3154,389,2036,2425,729,3478.42,2866.17,339.67,1880.42,2220.08,646.08,41741,34394,4076,22565,26641,7753,2022,'CAMPO ERE',Campo Erê,'SC',4203501,1199.0,1199,99.9,99.9,1,55.0,55.0,Pequeno I
4339,4367,420360,9761,6133,1170,481,1651,4482,9023.08,5813.92,1218.5,525.08,1743.58,4070.33,108277,69767,14622,6301,20923,48844,2022,'CAMPOS NOVOS',Campos Novos,'SC',4203600,3914.0,3914,326.2,326.2,1,161.0,161.0,Pequeno II
4340,4368,420370,4174,3586,384,2311,2695,891,3824.83,3321.0,342.17,2175.17,2517.33,803.67,45898,39852,4106,26102,30208,9644,2022,'CANELINHA',Canelinha,'SC',4203709,3083.0,3083,256.9,256.9,1,248.0,248.0,Pequeno I
4341,4369,420380,14169,10925,2316,4382,6698,4227,13155.33,10257.67,2132.5,4140.17,6272.67,3985.0,157864,123092,25590,49682,75272,47820,2022,'CANOINHAS',Canoinhas,'SC',4203808,21495.0,21495,1791.2,1791.2,3,1125.0,1125.0,Médio
4342,4370,420390,3355,2572,550,609,1159,1413,2967.08,2285.42,477.0,622.33,1099.33,1186.08,35605,27425,5724,7468,13192,14233,2022,'CAPINZAL',Capinzal,'SC',4203907,3691.0,3691,307.6,307.6,1,481.0,481.0,Pequeno II
4343,4371,420395,4164,3294,533,470,1003,2291,3852.25,3057.5,558.92,428.92,987.83,2069.67,46227,36690,6707,5147,11854,24836,2022,'CAPIVARI DE BAIXO',Capivari de Baixo,'SC',4203956,3244.0,3244,270.3,270.3,1,259.0,259.0,Pequeno II
4344,4372,420400,3713,2891,397,1461,1858,1033,3335.0,2612.33,374.83,1279.83,1654.67,957.67,40020,31348,4498,15358,19856,11492,2022,'CATANDUVAS',Catanduvas,'SC',4204004,1512.0,1512,126.0,126.0,1,224.0,224.0,Pequeno I
4345,4373,420410,1822,1415,193,784,977,438,1677.58,1367.25,127.92,908.0,1035.92,331.33,20131,16407,1535,10896,12431,3976,2022,'CAXAMBU DO SUL',Caxambu do Sul,'SC',4204103,1573.0,1573,131.1,131.1,1,121.0,121.0,Pequeno I
4346,4374,420415,1190,895,192,372,564,331,1071.58,841.17,195.92,356.5,552.42,288.75,12859,10094,2351,4278,6629,3465,2022,'CELSO RAMOS',Celso Ramos,'SC',4204152,1295.0,1295,107.9,107.9,1,80.0,80.0,Pequeno I
4347,4375,420417,2211,1822,411,862,1273,549,2034.67,1712.92,380.25,846.25,1226.5,486.42,24416,20555,4563,10155,14718,5837,2022,'CERRO NEGRO',Cerro Negro,'SC',4204178,1125.0,1125,93.8,93.8,1,70.0,70.0,Pequeno I
4348,4376,420419,614,454,161,52,213,241,588.67,461.25,194.0,51.75,245.75,215.5,7064,5535,2328,621,2949,2586,2022,'CHAPADAO DO LAGEADO',Chapadão do Lageado,'SC',4204194,392.0,392,35.6,35.6,1,19.0,19.0,Pequeno I
4349,4377,420420,45973,35305,9952,10566,20518,14787,39224.25,30611.33,8626.75,9636.5,18263.25,12348.08,470691,367336,103521,115638,219159,148177,2022,'CHAPECO',Chapecó,'SC',4204202,74759.0,74759,6229.9,6229.9,7,4148.0,4148.0,Grande
4350,4378,420425,2092,1574,181,759,940,634,1938.0,1469.08,155.75,718.83,874.58,594.5,23256,17629,1869,8626,10495,7134,2022,'COCAL DO SUL',Cocal do Sul,'SC',4204251,2484.0,2484,207.0,207.0,1,104.0,104.0,Pequeno I
4351,4379,420430,10711,7466,1424,2660,4084,3382,9662.0,6718.67,1358.0,2409.83,3767.83,2950.83,115944,80624,16296,28918,45214,35410,2022,'CONCORDIA',Concórdia,'SC',4204301,4501.0,4501,375.1,375.1,2,476.0,476.0,Médio
4352,4380,420435,1089,744,169,336,505,239,862.83,592.17,116.25,274.0,390.25,201.92,10354,7106,1395,3288,4683,2423,2022,'CORDILHEIRA ALTA',Cordilheira Alta,'SC',4204350,1028.0,1028,85.7,85.7,1,203.0,203.0,Pequeno I
4353,4381,420440,2623,1894,602,610,1212,682,2289.67,1645.92,424.58,579.33,1003.92,642.0,27476,19751,5095,6952,12047,7704,2022,'CORONEL FREITAS',Coronel Freitas,'SC',4204400,2888.0,2888,240.7,240.7,1,271.0,271.0,Pequeno I
4354,4382,420445,683,473,82,119,201,272,658.42,481.67,83.33,147.25,230.58,251.08,7901,5780,1000,1767,2767,3013,2022,'CORONEL MARTINS',Coronel Martins,'SC',4204459,1536.0,1536,128.0,128.0,1,77.0,77.0,Pequeno I
4355,4383,420450,2996,2344,524,808,1332,1012,2666.5,2108.75,446.83,679.33,1126.17,982.58,31998,25305,5362,8152,13514,11791,2022,'CORUPA',Corupá,'SC',4204509,1098.0,1098,99.8,99.8,1,,,Pequeno I
4356,4384,420455,5997,4901,1205,1959,3164,1737,5527.0,4609.92,1003.33,2064.17,3067.5,1542.42,66324,55319,12040,24770,36810,18509,2022,'CORREIA PINTO',Correia Pinto,'SC',4204558,1328.0,1328,132.8,132.8,1,65.0,65.0,Pequeno I
4357,4385,420460,31201,26137,4132,13582,17714,8423,28452.08,23896.25,3680.92,12406.58,16087.5,7808.75,341425,286755,44171,148879,193050,93705,2022,'CRICIUMA',Criciúma,'SC',4204608,23756.0,23756,1979.7,1979.7,6,1360.0,1360.0,Grande
4358,4386,420470,2059,1241,242,259,501,740,1838.0,1131.83,227.17,260.83,488.0,643.83,22056,13582,2726,3130,5856,7726,2022,'CUNHA PORA',Cunha Porã,'SC',4204707,1942.0,1942,242.8,242.8,1,,,Pequeno I
4359,4387,420475,227,120,23,26,49,71,207.67,111.58,24.83,16.08,40.92,70.67,2492,1339,298,193,491,848,2022,'CUNHATAI',Cunhataí,'SC',4204756,743.0,743,61.9,61.9,1,26.0,26.0,Pequeno I
4360,4388,420480,16973,12595,2401,5153,7554,5041,15210.83,11488.17,2071.25,4799.0,6870.25,4617.92,182530,137858,24855,57588,82443,55415,2022,'CURITIBANOS',Curitibanos,'SC',4204806,2306.0,2306,192.2,192.2,1,189.0,189.0,Pequeno II
4361,4389,420490,1281,933,176,371,547,386,1187.0,903.92,164.42,382.33,546.75,357.17,14244,10847,1973,4588,6561,4286,2022,'DESCANSO',Descanso,'SC',4204905,1750.0,1750,145.8,145.8,1,95.0,95.0,Pequeno I
4362,4390,420500,4418,3372,696,1427,2123,1249,4059.17,3151.58,599.58,1410.0,2009.58,1142.0,48710,37819,7195,16920,24115,13704,2022,'DIONISIO CERQUEIRA',Dionísio Cerqueira,'SC',4205001,6148.0,6148,512.3,512.3,2,294.0,294.0,Pequeno I
4363,4391,420510,496,336,67,78,145,191,492.08,326.83,71.08,76.25,147.33,179.5,5905,3922,853,915,1768,2154,2022,'DONA EMMA',Dona Emma,'SC',4205100,1728.0,1728,144.0,144.0,1,96.0,96.0,Pequeno I
4364,4392,420515,448,337,59,92,151,186,335.33,250.25,47.17,78.5,125.67,124.58,4024,3003,566,942,1508,1495,2022,'DOUTOR PEDRINHO',Doutor Pedrinho,'SC',4205159,2420.0,2420,201.7,201.7,1,183.0,183.0,Pequeno I
4365,4393,420517,2178,1891,230,1097,1327,564,2136.08,1893.33,223.33,1124.5,1347.83,545.5,25633,22720,2680,13494,16174,6546,2022,'ENTRE RIOS',Entre Rios,'SC',4205175,2772.0,2772,231.0,231.0,1,133.0,133.0,Pequeno I
4366,4394,420519,956,758,100,350,450,308,874.58,709.33,83.83,366.17,450.0,259.33,10495,8512,1006,4394,5400,3112,2022,'ERMO',Ermo,'SC',4205191,1475.0,1475,134.1,134.1,1,150.0,150.0,Pequeno I
4367,4395,420520,960,635,106,10,116,519,849.83,573.5,89.75,27.83,117.58,455.92,10198,6882,1077,334,1411,5471,2022,'ERVAL VELHO',Erval Velho,'SC',4205209,741.0,741,74.1,74.1,1,12.0,12.0,Pequeno I
4368,4396,420530,2810,2112,461,541,1002,1110,2643.58,2017.92,399.33,612.5,1011.83,1006.08,31723,24215,4792,7350,12142,12073,2022,'FAXINAL DOS GUEDES',Faxinal Dos Guedes,'SC',4205308,421.0,421,35.1,35.1,1,15.0,15.0,Pequeno I
4369,4397,420535,733,323,37,69,106,217,688.75,332.58,48.67,87.75,136.42,196.17,8265,3991,584,1053,1637,2354,2022,'FLOR DO SERTAO',Flor do Sertão,'SC',4205357,1093.0,1093,91.1,91.1,1,53.0,53.0,Pequeno I
4370,4398,420540,119630,93145,14504,34459,48963,44182,109480.75,86039.17,13304.0,30866.75,44170.75,41868.42,1313769,1032470,159648,370401,530049,502421,2022,'FLORIANOPOLIS',Florianópolis,'SC',4205407,105966.0,105966,8830.5,8830.5,10,7129.0,7129.0,Grande
4371,4399,420543,822,658,103,235,338,320,757.58,624.25,101.17,243.33,344.5,279.75,9091,7491,1214,2920,4134,3357,2022,'FORMOSA DO SUL',Formosa do Sul,'SC',4205431,1200.0,1200,240.0,240.0,1,,,Pequeno I
4372,4400,420545,5501,4415,951,1508,2459,1956,4635.75,3786.25,865.92,1236.83,2102.75,1683.5,55629,45435,10391,14842,25233,20202,2022,'FORQUILHINHA',Forquilhinha,'SC',4205456,5347.0,5347,445.6,445.6,1,412.0,412.0,Pequeno II
4373,4401,420550,13365,9815,1730,3814,5544,4271,11495.25,8851.17,1552.67,3831.83,5384.5,3466.67,137943,106214,18632,45982,64614,41600,2022,'FRAIBURGO',Fraiburgo,'SC',4205506,6466.0,6466,587.8,587.8,1,,,Pequeno II
4374,4402,420555,1163,875,133,403,536,339,1050.83,812.25,109.58,419.08,528.67,283.58,12610,9747,1315,5029,6344,3403,2022,'FREI ROGERIO',Frei Rogério,'SC',4205555,1859.0,1859,154.9,154.9,1,59.0,59.0,Pequeno I
4375,4403,420560,1200,981,150,530,680,301,1086.33,884.83,127.67,531.33,659.0,225.83,13036,10618,1532,6376,7908,2710,2022,'GALVAO',Galvão,'SC',4205605,60.0,60,60.0,60.0,1,60.0,60.0,Pequeno I
4376,4404,420570,9318,7577,1424,3677,5101,2476,8150.0,6734.33,1226.08,3297.33,4523.42,2210.92,97800,80812,14713,39568,54281,26531,2022,'GAROPABA',Garopaba,'SC',4205704,2696.0,2696,224.7,224.7,1,160.0,160.0,Pequeno I
4377,4405,420580,5906,4715,1202,1293,2495,2220,5306.42,4311.67,1006.5,1282.75,2289.25,2022.42,63677,51740,12078,15393,27471,24269,2022,'GARUVA',Garuva,'SC',4205803,2772.0,2772,231.0,231.0,1,251.0,251.0,Pequeno I
4378,4406,420590,10047,7007,1280,1648,2928,4079,8748.5,6152.5,1185.08,1442.5,2627.58,3524.92,104982,73830,14221,17310,31531,42299,2022,'GASPAR',Gaspar,'SC',4205902,10032.0,10032,836.0,836.0,3,355.0,355.0,Médio
4379,4407,420600,4167,3603,407,2161,2568,1035,3566.75,3092.25,390.42,1823.67,2214.08,878.17,42801,37107,4685,21884,26569,10538,2022,'GOVERNADOR CELSO RAMOS',Governador Celso Ramos,'SC',4206009,2950.0,2950,245.8,245.8,1,245.0,245.0,Pequeno I
4380,4408,420610,1846,1388,307,626,933,455,1517.08,1157.25,247.33,515.5,762.83,394.42,18205,13887,2968,6186,9154,4733,2022,'GRAO PARA',Grão Pará,'SC',4206108,1269.0,1269,105.8,105.8,1,102.0,102.0,Pequeno I
4381,4409,420620,2599,2027,402,774,1176,851,2285.08,1811.25,392.5,713.67,1106.17,705.08,27421,21735,4710,8564,13274,8461,2022,'GRAVATAL',Gravatal,'SC',4206207,1371.0,1371,152.3,152.3,1,292.0,292.0,Pequeno I
4382,4410,420630,3782,2851,519,1151,1670,1181,3336.08,2609.83,429.75,1245.92,1675.67,934.17,40033,31318,5157,14951,20108,11210,2022,'GUABIRUBA',Guabiruba,'SC',4206306,957.0,957,79.8,79.8,1,7.0,7.0,Pequeno I
4383,4411,420640,1633,1014,256,45,301,713,1500.67,964.25,295.42,150.0,445.42,518.83,18008,11571,3545,1800,5345,6226,2022,'GUARACIABA',Guaraciaba,'SC',4206405,1198.0,1198,99.8,99.8,1,112.0,112.0,Pequeno I
4384,4412,420650,11344,8360,1401,3096,4497,3863,10925.08,8022.0,1322.58,3020.67,4343.25,3678.75,131101,96264,15871,36248,52119,44145,2022,'GUARAMIRIM',Guaramirim,'SC',4206504,9529.0,9529,794.1,794.1,2,465.0,465.0,Pequeno II
4385,4413,420660,1351,888,165,139,304,584,1231.92,857.33,198.25,163.58,361.83,495.5,14783,10288,2379,1963,4342,5946,2022,'GUARUJA DO SUL',Guarujá do Sul,'SC',4206603,941.0,941,78.4,78.4,1,37.0,37.0,Pequeno I
4386,4414,420665,2210,1676,304,655,959,717,2036.75,1590.25,286.58,644.5,931.08,659.17,24441,19083,3439,7734,11173,7910,2022,'GUATAMBU',Guatambú,'SC',4206652,2677.0,2677,223.1,223.1,1,245.0,245.0,Pequeno I
4387,4415,420670,4169,2693,314,424,738,1955,3904.33,2742.83,408.5,586.83,995.33,1747.5,46852,32914,4902,7042,11944,20970,2022,'HERVAL DOESTE',Herval D´oeste,'SC',4206702,3796.0,3796,316.3,316.3,1,358.0,358.0,Pequeno II
4388,4416,420675,651,487,57,266,323,164,575.5,424.83,54.25,234.5,288.75,136.08,6906,5098,651,2814,3465,1633,2022,'IBIAM',Ibiam,'SC',4206751,273.0,273,30.3,30.3,1,11.0,11.0,Pequeno I
4389,4418,420690,3221,2279,357,624,981,1298,2881.83,2061.83,322.67,553.08,875.75,1186.08,34582,24742,3872,6637,10509,14233,2022,'IBIRAMA',Ibirama,'SC',4206900,209.0,209,104.5,104.5,1,127.0,127.0,Pequeno I
4390,4419,420700,10003,8446,823,5349,6172,2274,8717.5,7408.92,676.25,4760.08,5436.33,1972.58,104610,88907,8115,57121,65236,23671,2022,'ICARA',Içara,'SC',4207007,4504.0,4504,375.3,375.3,2,230.0,230.0,Médio
4391,4420,420710,3740,3198,502,1544,2046,1152,3453.33,2952.08,451.33,1531.33,1982.67,969.42,41440,35425,5416,18376,23792,11633,2022,'ILHOTA',Ilhota,'SC',4207106,3137.0,3137,261.4,261.4,1,269.0,269.0,Pequeno I
4392,4421,420720,4352,3597,621,1947,2568,1029,3939.42,3264.67,561.17,1772.42,2333.58,931.08,47273,39176,6734,21269,28003,11173,2022,'IMARUI',Imaruí,'SC',4207205,1803.0,1803,150.2,150.2,1,158.0,158.0,Pequeno I
4393,4422,420730,11530,9743,1895,4566,6461,3282,9911.92,8411.42,1562.25,4214.75,5777.0,2634.42,118943,100937,18747,50577,69324,31613,2022,'IMBITUBA',Imbituba,'SC',4207304,17581.0,17581,1465.1,1465.1,2,1108.0,1108.0,Pequeno II
4394,4423,420740,1652,1083,272,155,427,656,1561.75,1057.75,273.17,105.33,378.5,679.25,18741,12693,3278,1264,4542,8151,2022,'IMBUIA',Imbuia,'SC',4207403,949.0,949,79.1,79.1,1,20.0,20.0,Pequeno I
4395,4424,420750,7617,5488,1083,1828,2911,2577,6743.58,4943.33,994.92,1683.17,2678.08,2265.25,80923,59320,11939,20198,32137,27183,2022,'INDAIAL',Indaial,'SC',4207502,8062.0,8062,671.8,671.8,4,603.0,603.0,Médio
4396,4426,420760,1334,741,122,194,316,425,1151.08,679.67,111.67,193.58,305.25,374.42,13813,8156,1340,2323,3663,4493,2022,'IPIRA',Ipira,'SC',4207601,1581.0,1581,131.8,131.8,1,160.0,160.0,Pequeno I
4397,4427,420765,1940,1097,203,553,756,341,1631.0,954.58,146.08,504.92,651.0,303.58,19572,11455,1753,6059,7812,3643,2022,'IPORA DO OESTE',Iporã do Oeste,'SC',4207650,656.0,656,59.6,59.6,1,76.0,76.0,Pequeno I
4398,4428,420768,4380,3904,465,2711,3176,728,4090.75,3748.25,387.5,2787.0,3174.5,573.75,49089,44979,4650,33444,38094,6885,2022,'IPUACU',Ipuaçu,'SC',4207684,4032.0,4032,336.0,336.0,1,215.0,215.0,Pequeno I
4399,4429,420770,1077,583,71,80,151,432,1152.42,675.83,86.58,141.67,228.25,447.58,13829,8110,1039,1700,2739,5371,2022,'IPUMIRIM',Ipumirim,'SC',4207700,981.0,981,81.8,81.8,1,76.0,76.0,Pequeno I
4400,4430,420775,972,669,136,216,352,317,908.08,655.33,137.5,211.92,349.42,305.92,10897,7864,1650,2543,4193,3671,2022,'IRACEMINHA',Iraceminha,'SC',4207759,528.0,528,44.0,44.0,1,23.0,23.0,Pequeno I
4401,4431,420780,3279,2183,400,341,741,1442,3042.17,2039.42,360.25,302.42,662.67,1376.75,36506,24473,4323,3629,7952,16521,2022,'IRANI',Irani,'SC',4207809,2543.0,2543,211.9,211.9,1,130.0,130.0,Pequeno I
4402,4432,420785,689,540,50,184,234,306,619.67,489.5,65.0,175.17,240.17,249.33,7436,5874,780,2102,2882,2992,2022,'IRATI',Irati,'SC',4207858,516.0,516,46.9,46.9,1,49.0,49.0,Pequeno I
4403,4433,420790,3924,3182,753,1559,2312,870,3537.58,2923.08,626.58,1553.0,2179.58,743.5,42451,35077,7519,18636,26155,8922,2022,'IRINEOPOLIS',Irineópolis,'SC',4207908,1317.0,1317,109.8,109.8,1,90.0,90.0,Pequeno I
4404,4434,420800,2174,1512,386,718,1104,408,1947.33,1344.25,310.5,654.75,965.25,379.0,23368,16131,3726,7857,11583,4548,2022,'ITA',Itá,'SC',4208005,887.0,887,73.9,73.9,1,152.0,152.0,Pequeno I
4405,4435,420810,5343,4656,1355,1838,3193,1463,4943.0,4397.5,1228.5,1820.92,3049.42,1348.08,59316,52770,14742,21851,36593,16177,2022,'ITAIOPOLIS',Itaiópolis,'SC',4208104,2672.0,2672,222.7,222.7,1,108.0,108.0,Pequeno II
4406,4436,420820,43458,35863,5702,17215,22917,12946,38279.92,31765.25,5362.5,15117.92,20480.42,11284.83,459359,381183,64350,181415,245765,135418,2022,'ITAJAI',Itajaí,'SC',4208203,32803.0,32803,2733.6,2733.6,4,2123.0,2123.0,Grande
4407,4437,420830,15800,12916,2561,5260,7821,5095,14096.17,11700.5,2160.67,4953.83,7114.5,4586.0,169154,140406,25928,59446,85374,55032,2022,'ITAPEMA',Itapema,'SC',4208302,4671.0,4671,667.3,667.3,2,274.0,274.0,Pequeno II
4408,4438,420840,2247,1329,284,112,396,933,1805.92,1120.0,270.0,118.25,388.25,731.75,21671,13440,3240,1419,4659,8781,2022,'ITAPIRANGA',Itapiranga,'SC',4208401,1598.0,1598,133.2,133.2,1,157.0,157.0,Pequeno I
4409,4439,420845,9447,7413,1722,2984,4706,2707,8139.75,6310.92,1443.42,2561.33,4004.75,2306.17,97677,75731,17321,30736,48057,27674,2022,'ITAPOA',Itapoá,'SC',4208450,3423.0,3423,427.9,427.9,1,0.0,0.0,Pequeno I
4410,4440,420850,3919,2979,604,767,1371,1608,3892.17,2817.33,574.42,672.83,1247.25,1570.08,46706,33808,6893,8074,14967,18841,2022,'ITUPORANGA',Ituporanga,'SC',4208500,4513.0,4513,410.3,410.3,1,199.0,199.0,Pequeno II
4411,4441,420860,1240,880,246,203,449,431,1162.58,825.42,200.92,205.5,406.42,419.0,13951,9905,2411,2466,4877,5028,2022,'JABORA',Jaborá,'SC',4208609,1396.0,1396,116.3,116.3,1,98.0,98.0,Pequeno I
4412,4442,420870,2766,2067,482,658,1140,927,2536.83,1979.75,461.17,649.42,1110.58,869.17,30442,23757,5534,7793,13327,10430,2022,'JACINTO MACHADO',Jacinto Machado,'SC',4208708,1246.0,1246,113.3,113.3,1,119.0,119.0,Pequeno I
4413,4443,420880,4271,3617,833,1351,2184,1433,3783.75,3244.08,736.0,1261.33,1997.33,1246.75,45405,38929,8832,15136,23968,14961,2022,'JAGUARUNA',Jaguaruna,'SC',4208807,699.0,699,58.2,58.2,1,35.0,35.0,Pequeno I
4414,4444,420890,25761,17960,2934,5253,8187,9773,24446.42,17579.83,2817.0,5463.08,8280.08,9299.75,293357,210958,33804,65557,99361,111597,2022,'JARAGUA DO SUL',Jaraguá do Sul,'SC',4208906,42870.0,42870,3572.5,3572.5,7,3476.0,3476.0,Grande
4415,4445,420895,669,445,81,171,252,193,576.0,401.33,69.08,161.08,230.17,171.17,6912,4816,829,1933,2762,2054,2022,'JARDINOPOLIS',Jardinópolis,'SC',4208955,402.0,402,50.2,50.2,1,7.0,7.0,Pequeno I
4416,4446,420900,4884,3472,550,1292,1842,1630,4342.25,3163.17,548.17,1239.33,1787.5,1375.67,52107,37958,6578,14872,21450,16508,2022,'JOACABA',Joaçaba,'SC',4209003,9288.0,9288,774.0,774.0,1,522.0,522.0,Pequeno II
4417,4447,420910,114214,87468,15250,33828,49078,38390,101172.33,77234.58,13126.0,29921.83,43047.83,34186.75,1214068,926815,157512,359062,516574,410241,2022,'JOINVILLE',Joinville,'SC',4209102,44672.0,44672,3722.7,3722.7,9,2250.0,2250.0,Grande
4418,4448,420915,1930,1652,297,773,1070,582,1931.67,1601.08,266.0,859.0,1125.0,476.08,23180,19213,3192,10308,13500,5713,2022,'JOSE BOITEUX',José Boiteux,'SC',4209151,1244.0,1244,103.7,103.7,1,63.0,63.0,Pequeno I
4419,4449,420917,1456,731,99,397,496,235,1343.58,670.25,86.0,352.42,438.42,231.83,16123,8043,1032,4229,5261,2782,2022,'JUPIA',Jupiá,'SC',4209177,2119.0,2119,176.6,176.6,1,93.0,93.0,Pequeno I
4420,4450,420920,278,131,7,24,31,100,261.33,140.5,13.67,33.33,47.0,93.5,3136,1686,164,400,564,1122,2022,'LACERDOPOLIS',Lacerdópolis,'SC',4209201,276.0,276,23.0,23.0,1,29.0,29.0,Pequeno I
4421,4451,420930,55137,44706,7172,22407,29579,15127,49845.42,40722.92,6854.17,19666.25,26520.42,14202.5,598145,488675,82250,235995,318245,170430,2022,'LAGES',Lages,'SC',4209300,27779.0,27779,2314.9,2314.9,8,1840.0,1840.0,Grande
4422,4452,420940,10573,7864,1828,1764,3592,4272,9174.58,6837.75,1658.58,1429.58,3088.17,3749.58,110095,82053,19903,17155,37058,44995,2022,'LAGUNA',Laguna,'SC',4209409,6277.0,6277,523.1,523.1,2,580.0,580.0,Médio
4423,4453,420945,702,411,87,140,227,184,604.33,389.92,81.25,141.67,222.92,167.0,7252,4679,975,1700,2675,2004,2022,'LAJEADO GRANDE',Lajeado Grande,'SC',4209458,761.0,761,63.4,63.4,1,39.0,39.0,Pequeno I
4424,4454,420950,1354,970,199,234,433,537,1186.25,837.17,151.92,214.58,366.5,470.67,14235,10046,1823,2575,4398,5648,2022,'LAURENTINO',Laurentino,'SC',4209508,792.0,792,79.2,79.2,1,80.0,80.0,Pequeno I
4425,4455,420960,3285,2637,492,999,1491,1146,3012.83,2459.17,429.0,1052.58,1481.58,977.58,36154,29510,5148,12631,17779,11731,2022,'LAURO MULLER',Lauro Muller,'SC',4209607,2600.0,2600,216.7,216.7,1,198.0,198.0,Pequeno I
4426,4456,420970,7391,5703,1217,1814,3031,2672,7110.08,5573.83,1266.42,1849.33,3115.75,2458.08,85321,66886,15197,22192,37389,29497,2022,'LEBON REGIS',Lebon Régis,'SC',4209706,1313.0,1313,187.6,187.6,1,47.0,47.0,Pequeno I
4427,4457,420980,1069,915,325,183,508,407,1007.42,899.08,342.42,250.0,592.42,306.67,12089,10789,4109,3000,7109,3680,2022,'LEOBERTO LEAL',Leoberto Leal,'SC',4209805,540.0,540,45.0,45.0,1,43.0,43.0,Pequeno I
4428,4458,420985,1255,833,173,198,371,462,1103.83,762.58,177.92,184.67,362.58,400.0,13246,9151,2135,2216,4351,4800,2022,'LINDOIA DO SUL',Lindóia do Sul,'SC',4209854,670.0,670,55.8,55.8,1,10.0,10.0,Pequeno I
4429,4459,420990,1295,890,163,151,314,576,1189.33,811.58,137.25,163.08,300.33,511.25,14272,9739,1647,1957,3604,6135,2022,'LONTRAS',Lontras,'SC',4209904,990.0,990,82.5,82.5,1,53.0,53.0,Pequeno I
4430,4460,421000,2100,1569,360,236,596,973,1872.75,1491.08,355.33,278.0,633.33,857.75,22473,17893,4264,3336,7600,10293,2022,'LUIS ALVES',Luiz Alves,'SC',4210001,1622.0,1622,135.2,135.2,1,52.0,52.0,Pequeno I
4431,4461,421003,1305,542,41,33,74,468,1227.42,524.17,37.75,36.08,73.83,450.33,14729,6290,453,433,886,5404,2022,'LUZERNA',Luzerna,'SC',4210035,240.0,240,80.0,80.0,1,,,Pequeno I
4432,4462,421005,371,279,43,116,159,120,307.58,236.58,53.25,95.42,148.67,87.92,3691,2839,639,1145,1784,1055,2022,'MACIEIRA',Macieira,'SC',4210050,364.0,364,30.3,30.3,1,25.0,25.0,Pequeno I
4433,4463,421010,11981,9522,1925,2957,4882,4640,10624.83,8621.83,1789.08,2589.08,4378.17,4243.67,127498,103462,21469,31069,52538,50924,2022,'MAFRA',Mafra,'SC',4210100,24616.0,27397,2051.3,2283.1,2,3396.0,3396.0,Médio
4434,4464,421020,1487,1260,224,605,829,431,1345.25,1173.42,206.33,573.75,780.08,393.33,16143,14081,2476,6885,9361,4720,2022,'MAJOR GERCINO',Major Gercino,'SC',4210209,1059.0,1059,88.2,88.2,1,122.0,122.0,Pequeno I
4435,4465,421030,3487,2846,677,1004,1681,1165,3050.67,2536.67,629.67,965.42,1595.08,941.58,36608,30440,7556,11585,19141,11299,2022,'MAJOR VIEIRA',Major Vieira,'SC',4210308,2802.0,2802,233.5,233.5,1,153.0,153.0,Pequeno I
4436,4466,421040,1974,1393,170,808,978,415,1782.42,1322.0,140.33,775.17,915.5,406.5,21389,15864,1684,9302,10986,4878,2022,'MARACAJA',Maracajá,'SC',4210407,2894.0,2894,241.2,241.2,1,137.0,137.0,Pequeno I
4437,4467,421050,3930,2778,516,838,1354,1424,3419.17,2513.42,436.17,874.92,1311.08,1202.33,41030,30161,5234,10499,15733,14428,2022,'MARAVILHA',Maravilha,'SC',4210506,5018.0,5018,418.2,418.2,1,626.0,626.0,Pequeno II
4438,4468,421055,565,376,71,135,206,170,496.92,326.58,56.58,156.25,212.83,113.75,5963,3919,679,1875,2554,1365,2022,'MAREMA',Marema,'SC',4210555,837.0,837,69.8,69.8,1,54.0,54.0,Pequeno I
4439,4469,421060,2477,1909,389,740,1129,780,2277.42,1784.58,350.08,758.92,1109.0,675.58,27329,21415,4201,9107,13308,8107,2022,'MASSARANDUBA',Massaranduba,'SC',4210605,1685.0,1685,140.4,140.4,1,48.0,48.0,Pequeno I
4440,4470,421070,2274,1485,312,564,876,609,2179.67,1475.5,253.08,567.58,820.67,654.83,26156,17706,3037,6811,9848,7858,2022,'MATOS COSTA',Matos Costa,'SC',4210704,905.0,905,75.4,75.4,1,61.0,61.0,Pequeno I
4441,4471,421080,1831,1538,298,606,904,634,1689.42,1450.25,280.5,631.17,911.67,538.58,20273,17403,3366,7574,10940,6463,2022,'MELEIRO',Meleiro,'SC',4210803,3525.0,3525,293.8,293.8,1,241.0,241.0,Pequeno I
4442,4472,421085,1169,607,76,90,166,441,1130.5,607.67,69.58,88.33,157.92,449.75,13566,7292,835,1060,1895,5397,2022,'MIRIM DOCE',Mirim Doce,'SC',4210852,532.0,532,44.3,44.3,1,47.0,47.0,Pequeno I
4443,4473,421090,933,562,77,181,258,304,812.42,504.25,64.0,157.33,221.33,282.92,9749,6051,768,1888,2656,3395,2022,'MODELO',Modelo,'SC',4210902,3412.0,3412,284.3,284.3,1,250.0,250.0,Pequeno I
4444,4474,421100,2302,1357,240,321,561,796,2107.08,1257.0,259.67,316.5,576.17,680.83,25285,15084,3116,3798,6914,8170,2022,'MONDAI',Mondaí,'SC',4211009,594.0,594,49.5,49.5,1,34.0,34.0,Pequeno I
4445,4475,421105,4981,3936,774,1521,2295,1641,4761.42,3797.42,643.75,1690.33,2334.08,1463.33,57137,45569,7725,20284,28009,17560,2022,'MONTE CARLO',Monte Carlo,'SC',4211058,1556.0,1556,129.7,129.7,1,77.0,77.0,Pequeno I
4446,4476,421110,3900,3496,375,2204,2579,917,3551.42,3187.58,348.92,2031.75,2380.67,806.92,42617,38251,4187,24381,28568,9683,2022,'MONTE CASTELO',Monte Castelo,'SC',4211108,816.0,816,68.0,68.0,1,73.0,73.0,Pequeno I
4447,4477,421120,3935,3033,467,841,1308,1725,3629.58,2831.5,466.25,744.33,1210.58,1620.92,43555,33978,5595,8932,14527,19451,2022,'MORRO DA FUMACA',Morro da Fumaça,'SC',4211207,1606.0,1606,133.8,133.8,1,95.0,95.0,Pequeno I
4448,4478,421125,1156,866,238,332,570,296,959.58,751.92,235.75,294.33,530.08,221.83,11515,9023,2829,3532,6361,2662,2022,'MORRO GRANDE',Morro Grande,'SC',4211256,594.0,594,49.5,49.5,1,20.0,20.0,Pequeno I
4449,4479,421130,21057,18249,3755,8957,12712,5537,17918.58,15679.17,3134.67,7998.5,11133.17,4546.0,215023,188150,37616,95982,133598,54552,2022,'NAVEGANTES',Navegantes,'SC',4211306,3278.0,3278,273.2,273.2,2,268.0,268.0,Médio
4450,4480,421140,1167,876,205,275,480,396,1047.0,787.83,153.0,280.0,433.0,354.83,12564,9454,1836,3360,5196,4258,2022,'NOVA ERECHIM',Nova Erechim,'SC',4211405,1404.0,1404,127.6,127.6,1,136.0,136.0,Pequeno I
4451,4481,421145,1324,969,291,235,526,443,1276.5,951.58,278.58,236.58,515.17,436.42,15318,11419,3343,2839,6182,5237,2022,'NOVA ITABERABA',Nova Itaberaba,'SC',4211454,2269.0,2269,189.1,189.1,1,234.0,234.0,Pequeno I
4452,4482,421150,2568,1902,398,652,1050,852,2272.5,1723.75,380.17,635.42,1015.58,708.17,27270,20685,4562,7625,12187,8498,2022,'NOVA TRENTO',Nova Trento,'SC',4211504,693.0,693,57.8,57.8,1,32.0,32.0,Pequeno I
4453,4483,421160,2088,1720,292,978,1270,450,1786.92,1485.67,264.0,846.5,1110.5,375.17,21443,17828,3168,10158,13326,4502,2022,'NOVA VENEZA',Nova Veneza,'SC',4211603,1490.0,1490,124.2,124.2,1,221.0,221.0,Pequeno I
4454,4484,421165,821,535,99,137,236,299,733.5,492.42,83.5,165.0,248.5,243.92,8802,5909,1002,1980,2982,2927,2022,'NOVO HORIZONTE',Novo Horizonte,'SC',4211652,1845.0,1845,153.8,153.8,1,153.0,153.0,Pequeno I
4455,4485,421170,3743,3400,327,2474,2801,599,3392.42,3077.83,298.58,2208.08,2506.67,571.17,40709,36934,3583,26497,30080,6854,2022,'ORLEANS',Orleans,'SC',4211702,1558.0,1558,141.6,141.6,1,174.0,174.0,Pequeno II
4456,4486,421175,3367,2396,538,891,1429,967,2882.58,2097.17,419.42,886.5,1305.92,791.25,34591,25166,5033,10638,15671,9495,2022,'OTACILIO COSTA',Otacílio Costa,'SC',4211751,2649.0,2649,220.8,220.8,1,188.0,188.0,Pequeno I
4457,4487,421180,1231,790,112,343,455,335,1149.67,759.33,123.0,319.17,442.17,317.17,13796,9112,1476,3830,5306,3806,2022,'OURO',Ouro,'SC',4211801,2286.0,2286,190.5,190.5,1,38.0,38.0,Pequeno I
4458,4488,421185,992,759,126,315,441,318,915.67,706.75,98.0,342.75,440.75,266.0,10988,8481,1176,4113,5289,3192,2022,'OURO VERDE',Ouro Verde,'SC',4211850,1250.0,1250,113.6,113.6,1,98.0,98.0,Pequeno I
4459,4489,421187,971,643,126,228,354,289,913.42,625.92,117.33,221.67,339.0,286.92,10961,7511,1408,2660,4068,3443,2022,'PAIAL',Paial,'SC',4211876,1385.0,1385,115.4,115.4,1,124.0,124.0,Pequeno I
4460,4490,421189,1366,1119,191,410,601,518,1277.5,1059.92,183.92,406.25,590.17,469.75,15330,12719,2207,4875,7082,5637,2022,'PAINEL',Painel,'SC',4211892,581.0,581,52.8,52.8,1,143.0,143.0,Pequeno I
4461,4491,421190,45305,36598,7054,14941,21995,14603,39157.83,31461.0,6048.75,12396.25,18445.0,13016.0,469894,377532,72585,148755,221340,156192,2022,'PALHOCA',Palhoça,'SC',4211900,33624.0,33624,2802.0,2802.0,5,1994.0,1994.0,Grande
4462,4492,421200,2555,2098,325,1084,1409,689,2297.25,1965.0,327.08,1054.83,1381.92,583.08,27567,23580,3925,12658,16583,6997,2022,'PALMA SOLA',Palma Sola,'SC',4212007,262.0,262,87.3,87.3,1,,,Pequeno I
4463,4493,421205,756,629,144,228,372,257,643.42,533.58,110.08,222.58,332.67,200.92,7721,6403,1321,2671,3992,2411,2022,'PALMEIRA',Palmeira,'SC',4212056,751.0,751,62.6,62.6,1,67.0,67.0,Pequeno I
4464,4494,421210,3402,2308,494,714,1208,1100,3116.92,2174.08,449.75,726.42,1176.17,997.92,37403,26089,5397,8717,14114,11975,2022,'PALMITOS',Palmitos,'SC',4212106,1295.0,1295,129.5,129.5,1,131.0,131.0,Pequeno I
4465,4495,421220,4928,4134,1171,1250,2421,1713,4610.75,3911.67,1109.0,1253.17,2362.17,1549.5,55329,46940,13308,15038,28346,18594,2022,'PAPANDUVA',Papanduva,'SC',4212205,1016.0,1016,84.7,84.7,1,38.0,38.0,Pequeno I
4466,4496,421223,1220,943,206,486,692,251,1071.25,831.83,169.0,470.25,639.25,192.58,12855,9982,2028,5643,7671,2311,2022,'PARAISO',Paraíso,'SC',4212239,1983.0,1983,180.3,180.3,1,45.0,45.0,Pequeno I
4467,4497,421225,3520,3235,453,2077,2530,705,2999.25,2761.92,395.83,1788.83,2184.67,577.25,35991,33143,4750,21466,26216,6927,2022,'PASSO DE TORRES',Passo de Torres,'SC',4212254,2840.0,2840,236.7,236.7,1,280.0,280.0,Pequeno I
4468,4498,421227,2378,1691,377,656,1033,658,2220.17,1628.08,321.33,710.83,1032.17,595.92,26642,19537,3856,8530,12386,7151,2022,'PASSOS MAIA',Passos Maia,'SC',4212270,851.0,851,121.6,121.6,1,154.0,154.0,Pequeno I
4469,4499,421230,1987,1519,328,518,846,673,1732.92,1311.83,291.75,468.67,760.42,551.42,20795,15742,3501,5624,9125,6617,2022,'PAULO LOPES',Paulo Lopes,'SC',4212304,543.0,543,45.2,45.2,1,57.0,57.0,Pequeno I
4470,4500,421240,937,510,98,85,183,327,898.25,509.25,98.5,73.17,171.67,337.58,10779,6111,1182,878,2060,4051,2022,'PEDRAS GRANDES',Pedras Grandes,'SC',4212403,492.0,492,44.7,44.7,1,,,Pequeno I
4471,4501,421250,7833,6486,1065,3588,4653,1833,6507.17,5376.08,823.0,3018.5,3841.5,1534.58,78086,64513,9876,36222,46098,18415,2022,'PENHA',Penha,'SC',4212502,994.0,994,82.8,82.8,1,38.0,38.0,Pequeno II
4472,4502,421260,998,271,52,26,78,193,817.67,228.67,54.75,23.33,78.08,150.58,9812,2744,657,280,937,1807,2022,'PERITIBA',Peritiba,'SC',4212601,2500.0,2500,208.3,208.3,1,126.0,126.0,Pequeno I
4473,4503,421265,2694,2456,203,1978,2181,275,2267.0,2093.67,138.83,1744.5,1883.33,210.33,27204,25124,1666,20934,22600,2524,2022,'PESCARIA BRAVA',Pescaria Brava,'SC',4212650,600.0,600,60.0,60.0,1,90.0,90.0,Pequeno I
4474,4504,421270,1254,772,204,250,454,318,1122.92,685.25,161.25,243.67,404.92,280.33,13475,8223,1935,2924,4859,3364,2022,'PETROLANDIA',Petrolândia,'SC',4212700,365.0,365,30.4,30.4,1,8.0,8.0,Pequeno I
4475,4505,421280,8048,6707,1215,3191,4406,2301,6759.33,5677.17,966.0,2913.67,3879.67,1797.5,81112,68126,11592,34964,46556,21570,2022,'BALNEARIO PICARRAS',Piçarras,'SC',4212809,3956.0,25860,329.7,2155.0,2,1473.0,1473.0,Pequeno I
4476,4506,421290,3655,1901,331,339,670,1231,3298.17,1812.75,315.67,366.67,682.33,1130.42,39578,21753,3788,4400,8188,13565,2022,'PINHALZINHO',Pinhalzinho,'SC',4212908,3360.0,3360,280.0,280.0,2,183.0,183.0,Pequeno I
4477,4507,421300,1071,618,95,94,189,429,908.42,555.67,98.17,90.75,188.92,366.75,10901,6668,1178,1089,2267,4401,2022,'PINHEIRO PRETO',Pinheiro Preto,'SC',4213005,827.0,827,68.9,68.9,1,45.0,45.0,Pequeno I
4478,4508,421310,809,602,196,206,402,200,691.83,535.92,142.83,241.58,384.42,151.5,8302,6431,1714,2899,4613,1818,2022,'PIRATUBA',Piratuba,'SC',4213104,1445.0,1445,131.4,131.4,1,,,Pequeno I
4479,4509,421315,947,640,144,193,337,303,800.33,582.0,122.83,201.25,324.08,257.92,9604,6984,1474,2415,3889,3095,2022,'PLANALTO ALEGRE',Planalto Alegre,'SC',4213153,717.0,717,59.8,59.8,1,59.0,59.0,Pequeno I
4480,4510,421320,2414,1394,122,103,225,1169,2183.08,1307.58,138.25,90.67,228.92,1078.67,26197,15691,1659,1088,2747,12944,2022,'POMERODE',Pomerode,'SC',4213203,4230.0,4230,352.5,352.5,1,236.0,236.0,Pequeno II
4481,4511,421330,2133,1543,337,399,736,807,2003.58,1529.08,345.83,400.67,746.5,782.58,24043,18349,4150,4808,8958,9391,2022,'PONTE ALTA',Ponte Alta,'SC',4213302,334.0,334,27.8,27.8,1,4.0,4.0,Pequeno I
4482,4512,421335,1436,1242,213,573,786,456,1266.08,1123.25,200.0,518.92,718.92,404.33,15193,13479,2400,6227,8627,4852,2022,'PONTE ALTA DO NORTE',Ponte Alta do Norte,'SC',4213351,725.0,725,60.4,60.4,1,65.0,65.0,Pequeno I
4483,4513,421340,4802,3775,679,1440,2119,1656,4410.25,3535.17,604.58,1564.33,2168.92,1366.25,52923,42422,7255,18772,26027,16395,2022,'PONTE SERRADA',Ponte Serrada,'SC',4213401,3774.0,3774,471.8,471.8,1,336.0,336.0,Pequeno I
4484,4514,421350,5161,3945,816,1402,2218,1727,4627.75,3585.5,715.5,1358.25,2073.75,1511.75,55533,43026,8586,16299,24885,18141,2022,'PORTO BELO',Porto Belo,'SC',4213500,1869.0,21836,155.8,1819.7,1,0.0,1420.0,Pequeno I
4485,4515,421360,7104,4881,1449,1179,2628,2253,6580.08,4601.83,1218.25,1342.0,2560.25,2041.58,78961,55222,14619,16104,30723,24499,2022,'PORTO UNIAO',Porto União,'SC',4213609,765.0,765,382.5,382.5,2,,,Pequeno II
4486,4516,421370,2921,1974,381,510,891,1083,2666.5,1886.5,372.58,507.33,879.92,1006.58,31998,22638,4471,6088,10559,12079,2022,'POUSO REDONDO',Pouso Redondo,'SC',4213708,2406.0,2406,218.7,218.7,1,203.0,203.0,Pequeno I
4487,4517,421380,2582,2370,263,1556,1819,551,2425.42,2234.33,271.75,1411.42,1683.17,551.17,29105,26812,3261,16937,20198,6614,2022,'PRAIA GRANDE',Praia Grande,'SC',4213807,716.0,716,59.7,59.7,1,31.0,31.0,Pequeno I
4488,4518,421390,528,286,85,59,144,142,472.08,245.33,64.42,63.5,127.92,117.42,5665,2944,773,762,1535,1409,2022,'PRESIDENTE CASTELLO BRANCO,Presidente Castelo Branco,'SC',4213906,1682.0,1682,140.2,140.2,1,133.0,133.0,Pequeno I
4489,4519,421400,2055,1554,307,630,937,617,1730.33,1291.67,239.5,556.83,796.33,495.33,20764,15500,2874,6682,9556,5944,2022,'PRESIDENTE GETULIO',Presidente Getúlio,'SC',4214003,852.0,852,213.0,213.0,1,130.0,130.0,Pequeno I
4490,4520,421410,657,424,103,135,238,186,578.33,366.83,81.92,113.58,195.5,171.33,6940,4402,983,1363,2346,2056,2022,'PRESIDENTE NEREU',Presidente Nereu,'SC',4214102,1538.0,1538,128.2,128.2,1,57.0,57.0,Pequeno I
4491,4521,421415,649,468,60,158,218,250,608.0,446.58,72.33,154.25,226.58,220.0,7296,5359,868,1851,2719,2640,2022,'PRINCESA',Princesa,'SC',4214151,404.0,404,33.7,33.7,1,24.0,24.0,Pequeno I
4492,4522,421420,2038,1545,212,695,907,638,1838.08,1466.25,169.0,761.5,930.5,535.75,22057,17595,2028,9138,11166,6429,2022,'QUILOMBO',Quilombo,'SC',4214201,511.0,511,85.2,85.2,1,73.0,73.0,Pequeno I
4493,4523,421430,347,238,34,30,64,174,330.92,241.83,30.83,35.42,66.25,175.58,3971,2902,370,425,795,2107,2022,'RANCHO QUEIMADO',Rancho Queimado,'SC',4214300,596.0,596,49.7,49.7,1,39.0,39.0,Pequeno I
4494,4524,421440,2220,1560,313,586,899,661,1969.75,1402.5,262.83,568.58,831.42,571.08,23637,16830,3154,6823,9977,6853,2022,'RIO DAS ANTAS',Rio Das Antas,'SC',4214409,1354.0,1354,112.8,112.8,1,80.0,80.0,Pequeno I
4495,4525,421450,1585,1127,152,135,287,840,1556.25,1086.42,165.17,143.75,308.92,777.5,18675,13037,1982,1725,3707,9330,2022,'RIO DO CAMPO',Rio do Campo,'SC',4214508,3229.0,3229,358.8,358.8,1,,,Pequeno I
4496,4526,421460,1285,816,46,48,94,722,1233.33,817.42,48.92,53.67,102.58,714.83,14800,9809,587,644,1231,8578,2022,'RIO DO OESTE',Rio do Oeste,'SC',4214607,1136.0,1136,94.7,94.7,1,84.0,84.0,Pequeno I
4497,4527,421470,1238,970,144,322,466,504,1030.83,795.33,124.83,281.25,406.08,389.25,12370,9544,1498,3375,4873,4671,2022,'RIO DOS CEDROS',Rio Dos Cedros,'SC',4214706,656.0,656,131.2,131.2,1,67.0,67.0,Pequeno I
4498,4528,421480,10273,7737,1219,3096,4315,3422,8816.25,6733.33,1172.75,2724.5,3897.25,2836.08,105795,80800,14073,32694,46767,34033,2022,'RIO DO SUL',Rio do Sul,'SC',4214805,16160.0,16160,1346.7,1346.7,5,972.0,972.0,Médio
4499,4529,421490,452,308,52,63,115,193,428.92,290.0,55.17,46.58,101.75,188.25,5147,3480,662,559,1221,2259,2022,'RIO FORTUNA',Rio Fortuna,'SC',4214904,680.0,680,56.7,56.7,1,41.0,41.0,Pequeno I
4500,4530,421500,8233,6316,1510,1532,3042,3274,7245.17,5628.58,1460.0,1375.08,2835.08,2793.5,86942,67543,17520,16501,34021,33522,2022,'RIO NEGRINHO',Rio Negrinho,'SC',4215000,2355.0,2355,196.2,196.2,1,101.0,101.0,Pequeno II
4501,4531,421505,996,888,108,534,642,246,927.58,839.67,97.92,535.08,633.0,206.67,11131,10076,1175,6421,7596,2480,2022,'RIO RUFINO',Rio Rufino,'SC',4215059,2602.0,2602,216.8,216.8,1,150.0,150.0,Pequeno I
4502,4532,421507,1377,913,158,354,512,401,1315.08,887.92,170.92,351.92,522.83,365.08,15781,10655,2051,4223,6274,4381,2022,'RIQUEZA',Riqueza,'SC',4215075,3894.0,3894,324.5,324.5,1,200.0,200.0,Pequeno I
4503,4533,421510,1379,971,152,340,492,479,1210.42,885.5,142.0,360.0,502.0,383.5,14525,10626,1704,4320,6024,4602,2022,'RODEIO',Rodeio,'SC',4215109,1832.0,1832,166.5,166.5,1,192.0,192.0,Pequeno I
4504,4534,421520,1463,881,132,252,384,497,1398.58,915.75,132.17,342.75,474.92,440.83,16783,10989,1586,4113,5699,5290,2022,'ROMELANDIA',Romelândia,'SC',4215208,724.0,724,60.3,60.3,1,23.0,23.0,Pequeno I
4505,4535,421530,1224,817,152,118,270,547,1040.33,698.58,136.0,104.25,240.25,458.33,12484,8383,1632,1251,2883,5500,2022,'SALETE',Salete,'SC',4215307,281.0,281,46.8,46.8,1,38.0,38.0,Pequeno I
4506,4536,421535,1388,924,144,462,606,318,1209.0,834.25,128.5,413.08,541.58,292.67,14508,10011,1542,4957,6499,3512,2022,'SALTINHO',Saltinho,'SC',4215356,907.0,907,75.6,75.6,1,74.0,74.0,Pequeno I
4507,4537,421540,992,697,79,252,331,366,874.92,614.08,92.92,204.92,297.83,316.25,10499,7369,1115,2459,3574,3795,2022,'SALTO VELOSO',Salto Veloso,'SC',4215406,2569.0,2569,214.1,214.1,1,381.0,381.0,Pequeno I
4508,4538,421545,2373,1965,444,821,1265,700,2102.42,1801.67,398.42,832.25,1230.67,571.0,25229,21620,4781,9987,14768,6852,2022,'SANGAO',Sangão,'SC',4215455,619.0,619,56.3,56.3,1,27.0,27.0,Pequeno I
4509,4539,421550,7196,5962,1055,2958,4013,1949,6569.5,5580.0,959.83,2989.5,3949.33,1630.67,78834,66960,11518,35874,47392,19568,2022,'SANTA CECILIA',Santa Cecília,'SC',4215505,4333.0,5414,361.1,451.2,1,174.0,174.0,Pequeno I
4510,4540,421555,750,232,40,25,65,167,608.5,248.92,28.58,25.0,53.58,195.33,7302,2987,343,300,643,2344,2022,'SANTA HELENA',Santa Helena,'SC',4215554,958.0,958,79.8,79.8,1,95.0,95.0,Pequeno I
4511,4541,421560,394,253,55,62,117,136,331.5,229.58,39.5,65.58,105.08,124.5,3978,2755,474,787,1261,1494,2022,'SANTA ROSA DE LIMA',Santa Rosa de Lima,'SC',4215604,286.0,286,23.8,23.8,1,8.0,8.0,Pequeno I
4512,4542,421565,3093,2514,654,912,1566,948,2714.42,2215.17,572.33,811.67,1384.0,831.17,32573,26582,6868,9740,16608,9974,2022,'SANTA ROSA DO SUL',Santa Rosa do Sul,'SC',4215653,1356.0,1356,113.0,113.0,1,120.0,120.0,Pequeno I
4513,4544,421568,1102,639,149,175,324,315,1051.33,690.75,139.83,227.58,367.42,323.33,12616,8289,1678,2731,4409,3880,2022,'SANTA TEREZINHA DO PROGRES,Santa Terezinha do Progresso,'SC',4215687,1151.0,1151,95.9,95.9,1,50.0,50.0,Pequeno I
4514,4546,421570,5206,4008,840,1386,2226,1782,4506.83,3563.33,753.75,1254.75,2008.5,1554.83,54082,42760,9045,15057,24102,18658,2022,'SANTO AMARO DA IMPERATRIZ',Santo Amaro da Imperatriz,'SC',4215703,5368.0,5368,447.3,447.3,1,543.0,543.0,Pequeno I
4515,4547,421575,1095,794,132,361,493,301,1000.83,748.67,112.42,370.75,483.17,265.5,12010,8984,1349,4449,5798,3186,2022,'SAO BERNARDINO',São Bernardino,'SC',4215752,284.0,284,23.7,23.7,1,31.0,31.0,Pequeno I
4516,4548,421580,15893,11187,1854,3966,5820,5367,13951.5,10191.17,1667.0,3551.0,5218.0,4973.17,167418,122294,20004,42612,62616,59678,2022,'SAO BENTO DO SUL',São Bento do Sul,'SC',4215802,13302.0,13302,1108.5,1108.5,3,869.0,869.0,Médio
4517,4549,421590,620,510,127,206,333,177,577.83,472.0,113.0,185.67,298.67,173.33,6934,5664,1356,2228,3584,2080,2022,'SAO BONIFACIO',São Bonifácio,'SC',4215901,499.0,499,41.6,41.6,1,38.0,38.0,Pequeno I
4518,4550,421600,1858,1324,252,412,664,660,1715.67,1266.58,263.33,403.42,666.75,599.83,20588,15199,3160,4841,8001,7198,2022,'SAO CARLOS',São Carlos,'SC',4216008,1748.0,1748,145.7,145.7,1,72.0,72.0,Pequeno I
4519,4551,421605,2192,1778,299,724,1023,755,2010.67,1674.17,294.33,765.58,1059.92,614.25,24128,20090,3532,9187,12719,7371,2022,'SAO CRISTOVAO DO SUL',São Cristovão do Sul,'SC',4216057,629.0,629,78.6,78.6,1,,,Pequeno I
4520,4552,421610,3191,2454,550,855,1405,1049,2992.33,2298.92,484.33,745.08,1229.42,1069.5,35908,27587,5812,8941,14753,12834,2022,'SAO DOMINGOS',São Domingos,'SC',4216107,1852.0,1852,154.3,154.3,1,86.0,86.0,Pequeno I
4521,4553,421620,12527,9700,2137,3631,5768,3932,11750.0,9012.33,1971.17,3230.67,5201.83,3810.5,141000,108148,23654,38768,62422,45726,2022,'SAO FRANCISCO DO SUL',São Francisco do Sul,'SC',4216206,20971.0,20971,1747.6,1747.6,4,1038.0,1038.0,Pequeno II
4522,4554,421625,442,253,33,59,92,161,432.75,257.25,39.75,59.5,99.25,158.0,5193,3087,477,714,1191,1896,2022,'SAO JOAO DO OESTE',São João do Oeste,'SC',4216255,478.0,478,39.8,39.8,1,37.0,37.0,Pequeno I
4523,4555,421630,9094,6645,1284,1954,3238,3407,8144.83,6130.5,1174.08,1973.58,3147.67,2982.83,97738,73566,14089,23683,37772,35794,2022,'SAO JOAO BATISTA',São João Batista,'SC',4216305,3849.0,8773,320.8,731.1,1,0.0,4924.0,Pequeno II
4524,4556,421635,1426,1057,111,528,639,418,1141.25,842.42,101.33,421.33,522.67,319.75,13695,10109,1216,5056,6272,3837,2022,'SAO JOAO DO ITAPERIU',São João do Itaperiú,'SC',4216354,2369.0,2369,197.4,197.4,1,159.0,159.0,Pequeno I
4525,4557,421640,2229,1835,452,846,1298,537,2002.17,1668.67,383.33,758.75,1142.08,526.58,24026,20024,4600,9105,13705,6319,2022,'SAO JOAO DO SUL',São João do Sul,'SC',4216404,1259.0,1259,104.9,104.9,1,96.0,96.0,Pequeno I
4526,4558,421650,8710,6683,1568,1940,3508,3175,7726.67,6073.25,1529.42,1884.83,3414.25,2659.0,92720,72879,18353,22618,40971,31908,2022,'SAO JOAQUIM',São Joaquim,'SC',4216503,1366.0,1366,113.8,113.8,1,144.0,144.0,Pequeno II
4527,4559,421660,40952,32960,5336,14930,20266,12694,35595.5,28654.75,4622.42,12813.83,17436.25,11218.5,427146,343857,55469,153766,209235,134622,2022,'SAO JOSE',São José,'SC',4216602,28108.0,28108,2342.3,2342.3,5,2377.0,2377.0,Grande
4528,4560,421670,3064,2183,462,815,1277,906,2629.58,1968.33,400.67,835.0,1235.67,732.67,31555,23620,4808,10020,14828,8792,2022,'SAO JOSE DO CEDRO',São José do Cedro,'SC',4216701,914.0,914,76.2,76.2,1,27.0,27.0,Pequeno I
4529,4561,421680,4476,3896,319,2917,3236,660,3928.67,3447.33,303.92,2603.5,2907.42,539.92,47144,41368,3647,31242,34889,6479,2022,'SAO JOSE DO CERRITO',São José do Cerrito,'SC',4216800,475.0,475,39.6,39.6,1,15.0,15.0,Pequeno I
4530,4562,421690,5173,3903,804,984,1788,2115,4634.42,3568.5,780.42,1015.5,1795.92,1772.58,55613,42822,9365,12186,21551,21271,2022,'SAO LOURENCO DO OESTE',São Lourenço do Oeste,'SC',4216909,7499.0,7499,624.9,624.9,1,419.0,419.0,Pequeno II
4531,4563,421700,2210,1514,288,354,642,872,1958.83,1484.0,336.25,384.58,720.83,763.17,23506,17808,4035,4615,8650,9158,2022,'SAO LUDGERO',São Ludgero,'SC',4217006,510.0,510,46.4,46.4,1,77.0,77.0,Pequeno I
4532,4564,421710,815,467,57,185,242,225,730.42,413.92,57.83,153.0,210.83,203.08,8765,4967,694,1836,2530,2437,2022,'SAO MARTINHO',São Martinho,'SC',4217105,625.0,625,52.1,52.1,1,176.0,176.0,Pequeno I
4533,4565,421715,511,380,79,204,283,97,409.42,317.75,61.58,188.58,250.17,67.58,4913,3813,739,2263,3002,811,2022,'SAO MIGUEL DA BOA VISTA',São Miguel da Boa Vista,'SC',4217154,1298.0,1298,216.3,216.3,1,70.0,70.0,Pequeno I
4534,4566,421720,6921,4606,1099,1126,2225,2381,6363.75,4314.33,1041.75,1143.33,2185.08,2129.25,76365,51772,12501,13720,26221,25551,2022,'SAO MIGUEL DO OESTE',São Miguel do Oeste,'SC',4217204,2559.0,2559,213.2,213.2,2,183.0,183.0,Pequeno II
4535,4567,421725,882,555,90,210,300,255,771.42,509.67,93.33,187.83,281.17,228.5,9257,6116,1120,2254,3374,2742,2022,'SAO PEDRO DE ALCANTARA',São Pedro de Alcântara,'SC',4217253,2707.0,2707,246.1,246.1,1,247.0,247.0,Pequeno I
4536,4568,421730,1911,1260,218,523,741,519,1594.42,1037.58,174.83,467.42,642.25,395.33,19133,12451,2098,5609,7707,4744,2022,'SAUDADES',Saudades,'SC',4217303,1318.0,1318,109.8,109.8,1,155.0,155.0,Pequeno I
4537,4569,421740,2871,2165,412,706,1118,1047,2564.42,1945.75,361.0,642.92,1003.92,941.83,30773,23349,4332,7715,12047,11302,2022,'SCHROEDER',Schroeder,'SC',4217402,3127.0,3127,260.6,260.6,1,233.0,233.0,Pequeno I
4538,4570,421750,2834,1820,420,539,959,861,2417.67,1506.5,337.58,517.08,854.67,651.83,29012,18078,4051,6205,10256,7822,2022,'SEARA',Seara,'SC',4217501,1106.0,1106,92.2,92.2,1,89.0,89.0,Pequeno I
4539,4571,421755,580,344,67,103,170,174,538.42,335.67,65.08,109.67,174.75,160.92,6461,4028,781,1316,2097,1931,2022,'SERRA ALTA',Serra Alta,'SC',4217550,1719.0,1719,143.2,143.2,1,173.0,173.0,Pequeno I
4540,4572,421760,3356,2456,519,778,1297,1159,3042.5,2314.25,509.5,745.08,1254.58,1059.67,36510,27771,6114,8941,15055,12716,2022,'SIDEROPOLIS',Siderópolis,'SC',4217600,5224.0,5224,435.3,435.3,1,523.0,523.0,Pequeno I
4541,4573,421770,7913,6283,1175,2319,3494,2789,7249.33,5879.92,1189.67,2383.5,3573.17,2306.75,86992,70559,14276,28602,42878,27681,2022,'SOMBRIO',Sombrio,'SC',4217709,2644.0,2644,240.4,240.4,1,150.0,150.0,Pequeno II
4542,4574,421775,676,443,52,107,159,284,620.67,430.33,57.83,152.42,210.25,220.08,7448,5164,694,1829,2523,2641,2022,'SUL BRASIL',Sul Brasil,'SC',4217758,596.0,596,49.7,49.7,1,48.0,48.0,Pequeno I
4543,4575,421780,3151,2344,441,893,1334,1010,2854.5,2131.67,437.33,861.75,1299.08,832.58,34254,25580,5248,10341,15589,9991,2022,'TAIO',Taió,'SC',4217808,1454.0,1454,121.2,121.2,1,82.0,82.0,Pequeno I
4544,4576,421790,2946,1875,414,488,902,973,2673.67,1799.92,379.67,595.83,975.5,824.42,32084,21599,4556,7150,11706,9893,2022,'TANGARA',Tangará,'SC',4217907,2042.0,2042,170.2,170.2,1,121.0,121.0,Pequeno I
4545,4577,421795,687,515,81,141,222,293,595.25,452.5,87.42,130.58,218.0,234.5,7143,5430,1049,1567,2616,2814,2022,'TIGRINHOS',Tigrinhos,'SC',4217956,591.0,591,49.2,49.2,1,18.0,18.0,Pequeno I
4546,4578,421800,10730,8684,1531,3939,5470,3214,9314.08,7680.17,1230.0,4063.08,5293.08,2387.08,111769,92162,14760,48757,63517,28645,2022,'TIJUCAS',Tijucas,'SC',4218004,1547.0,1547,140.6,140.6,1,50.0,50.0,Pequeno II
4547,4579,421810,1916,1470,179,708,887,583,1805.83,1421.0,169.5,744.83,914.33,506.67,21670,17052,2034,8938,10972,6080,2022,'TIMBE DO SUL',Timbé do Sul,'SC',4218103,1496.0,1496,124.7,124.7,1,100.0,100.0,Pequeno I
4548,4580,421820,3912,2801,606,745,1351,1450,3443.83,2471.67,516.33,740.92,1257.25,1214.42,41326,29660,6196,8891,15087,14573,2022,'TIMBO',Timbó,'SC',4218202,977.0,977,81.4,81.4,1,56.0,56.0,Pequeno II
4549,4581,421825,4589,4069,323,2887,3210,859,4215.08,3867.25,310.83,2863.5,3174.33,692.92,50581,46407,3730,34362,38092,8315,2022,'TIMBO GRANDE',Timbó Grande,'SC',4218251,1501.0,1501,125.1,125.1,1,38.0,38.0,Pequeno I
4550,4582,421830,6694,5360,1236,1135,2371,2989,5976.0,4972.75,1161.92,1273.0,2434.92,2537.83,71712,59673,13943,15276,29219,30454,2022,'TRES BARRAS',Três Barras,'SC',4218301,3669.0,9334,333.5,848.5,1,503.0,503.0,Pequeno I
4551,4583,421835,744,578,86,323,409,169,676.17,533.08,106.5,262.42,368.92,164.17,8114,6397,1278,3149,4427,1970,2022,'TREVISO',Treviso,'SC',4218350,1312.0,1312,119.3,119.3,1,146.0,146.0,Pequeno I
4552,4584,421840,1312,1087,266,277,543,544,899.67,749.58,157.25,195.17,352.42,397.17,10796,8995,1887,2342,4229,4766,2022,'TREZE DE MAIO',Treze de Maio,'SC',4218400,933.0,933,77.8,77.8,1,76.0,76.0,Pequeno I
4553,4585,421850,1367,927,172,133,305,622,1239.08,864.25,175.33,153.33,328.67,535.58,14869,10371,2104,1840,3944,6427,2022,'TREZE TILIAS',Treze Tílias,'SC',4218509,1200.0,1200,100.0,100.0,1,76.0,76.0,Pequeno I
4554,4586,421860,800,522,85,134,219,303,897.5,615.5,105.33,179.17,284.5,331.0,10770,7386,1264,2150,3414,3972,2022,'TROMBUDO CENTRAL',Trombudo Central,'SC',4218608,683.0,683,56.9,56.9,1,19.0,19.0,Pequeno I
4555,4587,421870,15636,12690,1801,6756,8557,4133,13630.5,11125.17,1546.08,5916.08,7462.17,3663.0,163566,133502,18553,70993,89546,43956,2022,'TUBARAO',Tubarão,'SC',4218707,17055.0,17055,1421.2,1421.2,3,1280.0,1280.0,Médio
4556,4588,421875,1154,498,76,97,173,325,1021.58,475.83,75.67,94.08,169.75,306.08,12259,5710,908,1129,2037,3673,2022,'TUNAPOLIS',Tunápolis,'SC',4218756,2026.0,2026,168.8,168.8,1,88.0,88.0,Pequeno I
4557,4589,421880,2265,1614,305,388,693,921,2120.58,1558.67,315.0,416.92,731.92,826.75,25447,18704,3780,5003,8783,9921,2022,'TURVO',Turvo,'SC',4218806,2302.0,2302,191.8,191.8,1,133.0,133.0,Pequeno I
4558,4590,421885,944,612,88,242,330,282,800.92,558.33,90.83,233.58,324.42,233.92,9611,6700,1090,2803,3893,2807,2022,'UNIAO DO OESTE',União do Oeste,'SC',4218855,1088.0,1088,98.9,98.9,1,131.0,131.0,Pequeno I
4559,4591,421890,3382,2722,500,1486,1986,736,2973.08,2453.75,459.08,1369.92,1829.0,624.75,35677,29445,5509,16439,21948,7497,2022,'URUBICI',Urubici,'SC',4218905,2619.0,2619,218.2,218.2,1,216.0,216.0,Pequeno I
4560,4592,421895,1281,1163,112,766,878,285,1177.5,1079.83,105.08,768.25,873.33,206.5,14130,12958,1261,9219,10480,2478,2022,'URUPEMA',Urupema,'SC',4218954,320.0,320,80.0,80.0,1,69.0,69.0,Pequeno I
4561,4593,421900,3486,2627,393,1040,1433,1194,3204.42,2531.75,374.08,1070.42,1444.5,1087.25,38453,30381,4489,12845,17334,13047,2022,'URUSSANGA',Urussanga,'SC',4219002,1318.0,1318,109.8,109.8,1,121.0,121.0,Pequeno II
4562,4594,421910,1227,744,138,110,248,496,1099.25,721.42,134.33,135.17,269.5,451.92,13191,8657,1612,1622,3234,5423,2022,'VARGEAO',Vargeão,'SC',4219101,1876.0,1876,156.3,156.3,1,61.0,61.0,Pequeno I
4563,4595,421915,1330,847,218,127,345,502,1270.58,845.83,202.25,155.42,357.67,488.17,15247,10150,2427,1865,4292,5858,2022,'VARGEM',Vargem,'SC',4219150,129.0,129,43.0,43.0,1,,,Pequeno I
4564,4596,421917,1751,1236,323,296,619,617,1547.0,1139.08,335.67,312.42,648.08,491.0,18564,13669,4028,3749,7777,5892,2022,'VARGEM BONITA',Vargem Bonita,'SC',4219176,1371.0,1371,124.6,124.6,1,55.0,55.0,Pequeno I
4565,4597,421920,1502,1142,362,317,679,463,1343.58,1061.17,365.0,359.33,724.33,336.83,16123,12734,4380,4312,8692,4042,2022,'VIDAL RAMOS',Vidal Ramos,'SC',4219200,1485.0,1485,123.8,123.8,1,94.0,94.0,Pequeno I
4566,4598,421930,9873,6666,1352,1971,3323,3343,8498.25,5742.42,1231.92,1852.25,3084.17,2658.25,101979,68909,14783,22227,37010,31899,2022,'VIDEIRA',Videira,'SC',4219309,8608.0,8608,717.3,717.3,2,457.0,457.0,Pequeno II
4567,4599,421935,1501,1292,296,700,996,296,1374.92,1192.25,231.42,712.5,943.92,248.33,16499,14307,2777,8550,11327,2980,2022,'VITOR MEIRELES',Vitor Meireles,'SC',4219358,292.0,292,26.5,26.5,1,29.0,29.0,Pequeno I
4568,4600,421940,1250,628,110,168,278,350,1175.33,610.75,99.83,152.33,252.17,358.58,14104,7329,1198,1828,3026,4303,2022,'WITMARSUM',Witmarsum,'SC',4219408,467.0,467,38.9,38.9,1,30.0,30.0,Pequeno I
4569,4601,421950,10158,6881,1410,1652,3062,3819,8974.17,6149.0,1318.33,1518.67,2837.0,3312.0,107690,73788,15820,18224,34044,39744,2022,'XANXERE',Xanxerê,'SC',4219507,9518.0,9518,793.2,793.2,2,638.0,638.0,Pequeno II
4570,4602,421960,471,314,38,90,128,186,447.75,295.83,39.0,84.67,123.67,172.17,5373,3550,468,1016,1484,2066,2022,'XAVANTINA',Xavantina,'SC',4219606,1091.0,1091,90.9,90.9,1,80.0,80.0,Pequeno I
4571,4603,421970,6398,4368,927,1554,2481,1887,5695.75,4079.83,840.0,1594.17,2434.17,1645.67,68349,48958,10080,19130,29210,19748,2022,'XAXIM',Xaxim,'SC',4219705,8845.0,8845,737.1,737.1,2,489.0,489.0,Pequeno II
4572,4604,421985,1059,784,97,354,451,333,992.92,753.75,99.75,328.42,428.17,325.58,11915,9045,1197,3941,5138,3907,2022,'ZORTEA',Zortéa,'SC',4219853,2306.0,2306,192.2,192.2,1,154.0,154.0,Pequeno I
4573,4605,422000,5944,5151,517,3447,3964,1187,5509.0,4878.58,454.0,3377.42,3831.42,1047.17,66108,58543,5448,40529,45977,12566,2022,'BALNEARIO RINCAO',Balneário Rincão,'SC',4220000,2602.0,2602,216.8,216.8,1,333.0,333.0,Pequeno I
4574,4607,430005,1000,812,47,523,570,242,868.0,698.92,53.58,413.08,466.67,232.25,10416,8387,643,4957,5600,2787,2022,'AGUA SANTA',Água Santa,'RS',4300059,1839.0,1839,153.2,153.2,1,155.0,155.0,Pequeno I
4575,4608,430010,4904,3989,752,2132,2884,1105,4627.42,3871.58,724.75,2180.75,2905.5,966.08,55529,46459,8697,26169,34866,11593,2022,'AGUDO',Agudo,'RS',4300109,3543.0,3543,295.2,295.2,1,164.0,164.0,Pequeno I
4576,4609,430020,1510,1241,170,728,898,343,1446.5,1205.83,157.42,714.42,871.83,334.0,17358,14470,1889,8573,10462,4008,2022,'AJURICABA',Ajuricaba,'RS',4300208,1559.0,1559,129.9,129.9,1,132.0,132.0,Pequeno I
4577,4610,430030,2895,1894,292,972,1264,630,2643.92,1750.75,315.17,803.58,1118.75,632.0,31727,21009,3782,9643,13425,7584,2022,'ALECRIM',Alecrim,'RS',4300307,1613.0,1613,134.4,134.4,1,72.0,72.0,Pequeno I
4578,4611,430040,27090,19795,5538,4941,10479,9316,26201.75,19241.25,5224.92,4666.58,9891.5,9349.75,314421,230895,62699,55999,118698,112197,2022,'ALEGRETE',Alegrete,'RS',4300406,33393.0,36077,2782.8,3006.4,2,1389.0,4073.0,Médio
4579,4612,430045,1504,1194,84,854,938,256,1387.67,1109.42,91.0,796.17,887.17,222.25,16652,13313,1092,9554,10646,2667,2022,'ALEGRIA',Alegria,'RS',4300455,2850.0,2850,237.5,237.5,1,202.0,202.0,Pequeno I
4580,4613,430047,636,305,49,102,151,154,590.5,287.75,54.17,90.58,144.75,143.0,7086,3453,650,1087,1737,1716,2022,'ALMIRANTE TAMANDARE DO SUL,Almirante Tamandaré do Sul,'RS',4300471,1456.0,1456,121.3,121.3,1,137.0,137.0,Pequeno I
4581,4614,430050,2397,1645,323,707,1030,615,2260.92,1553.5,309.08,627.08,936.17,617.33,27131,18642,3709,7525,11234,7408,2022,'ALPESTRE',Alpestre,'RS',4300505,1188.0,1188,99.0,99.0,1,67.0,67.0,Pequeno I
4582,4615,430055,744,401,40,179,219,182,734.83,416.0,50.0,183.08,233.08,182.92,8818,4992,600,2197,2797,2195,2022,'ALTO ALEGRE',Alto Alegre,'RS',4300554,831.0,831,69.2,69.2,1,250.0,250.0,Pequeno I
4583,4617,430060,64557,56139,10221,29157,39378,16761,56207.83,49160.33,8814.83,25852.67,34667.5,14492.83,674494,589924,105778,310232,416010,173914,2022,'ALVORADA',Alvorada,'RS',4300604,19455.0,19455,1621.2,1621.2,5,1410.0,1410.0,Grande
4584,4618,430063,2340,2047,386,1148,1534,513,2293.58,2017.5,380.0,1152.75,1532.75,484.75,27523,24210,4560,13833,18393,5817,2022,'AMARAL FERRADOR',Amaral Ferrador,'RS',4300638,3317.0,3317,276.4,276.4,1,263.0,263.0,Pequeno I
4585,4619,430064,3537,2805,534,1421,1955,850,3322.5,2676.0,464.25,1392.33,1856.58,819.42,39870,32112,5571,16708,22279,9833,2022,'AMETISTA DO SUL',Ametista do Sul,'RS',4300646,2072.0,2072,172.7,172.7,1,94.0,94.0,Pequeno I
4586,4620,430066,286,235,28,177,205,30,255.33,206.75,23.83,156.67,180.5,26.25,3064,2481,286,1880,2166,315,2022,'ANDRE DA ROCHA',André da Rocha,'RS',4300661,523.0,523,47.5,47.5,1,78.0,78.0,Pequeno I
4587,4621,430070,1957,530,98,68,166,364,1950.25,511.42,107.83,58.42,166.25,345.17,23403,6137,1294,701,1995,4142,2022,'ANTA GORDA',Anta Gorda,'RS',4300703,1300.0,1300,108.3,108.3,1,83.0,83.0,Pequeno I
4588,4622,430080,2717,1752,308,811,1119,633,2529.25,1690.33,309.83,773.58,1083.42,606.92,30351,20284,3718,9283,13001,7283,2022,'ANTONIO PRADO',Antônio Prado,'RS',4300802,1800.0,1800,150.0,150.0,1,154.0,154.0,Pequeno I
4589,4623,430085,2288,1584,276,693,969,615,2162.83,1539.42,240.17,715.92,956.08,583.33,25954,18473,2882,8591,11473,7000,2022,'ARAMBARE',Arambaré,'RS',4300851,737.0,737,61.4,61.4,1,67.0,67.0,Pequeno I
4590,4624,430087,2588,2305,247,1461,1708,597,2309.58,2082.17,216.42,1402.5,1618.92,463.25,27715,24986,2597,16830,19427,5559,2022,'ARARICA',Araricá,'RS',4300877,867.0,867,78.8,78.8,1,114.0,114.0,Pequeno I
4591,4625,430090,1366,671,130,123,253,418,1309.83,636.83,111.83,126.08,237.92,398.92,15718,7642,1342,1513,2855,4787,2022,'ARATIBA',Aratiba,'RS',4300901,831.0,831,69.2,69.2,1,76.0,76.0,Pequeno I
4592,4626,430100,2950,1942,355,604,959,983,2659.33,1815.75,360.67,524.25,884.92,930.83,31912,21789,4328,6291,10619,11170,2022,'ARROIO DO MEIO',Arroio do Meio,'RS',4301008,275.0,275,91.7,91.7,1,93.0,93.0,Pequeno I
4593,4627,430105,4227,3332,561,1619,2180,1152,3814.83,3013.75,507.67,1417.75,1925.42,1088.33,45778,36165,6092,17013,23105,13060,2022,'ARROIO DO SAL',Arroio do Sal,'RS',4301057,2693.0,2693,224.4,224.4,1,106.0,106.0,Pequeno I
4594,4628,430107,549,291,39,73,112,179,531.33,287.33,33.92,80.75,114.67,172.67,6376,3448,407,969,1376,2072,2022,'ARROIO DO PADRE',Arroio do Padre,'RS',4301073,361.0,361,30.1,30.1,1,17.0,17.0,Pequeno I
4595,4629,430110,6237,5222,934,2392,3326,1896,6035.33,5088.25,891.0,2425.17,3316.17,1772.08,72424,61059,10692,29102,39794,21265,2022,'ARROIO DOS RATOS',Arroio Dos Ratos,'RS',4301107,5565.0,5565,463.8,463.8,1,401.0,401.0,Pequeno I
4596,4630,430120,4142,2974,506,1249,1755,1219,3946.67,2857.58,481.17,1265.58,1746.75,1110.83,47360,34291,5774,15187,20961,13330,2022,'ARROIO DO TIGRE',Arroio do Tigre,'RS',4301206,2349.0,2349,195.8,195.8,1,98.0,98.0,Pequeno I
4597,4631,430130,9143,7599,2604,1866,4470,3129,8706.67,7281.75,2405.67,1936.92,4342.58,2939.17,104480,87381,28868,23243,52111,35270,2022,'ARROIO GRANDE',Arroio Grande,'RS',4301305,391.0,391,32.6,32.6,1,31.0,31.0,Pequeno I
4598,4632,430140,3079,2406,424,1103,1527,879,2915.67,2315.17,380.08,1165.75,1545.83,769.33,34988,27782,4561,13989,18550,9232,2022,'ARVOREZINHA',Arvorezinha,'RS',4301404,2725.0,2725,227.1,227.1,1,93.0,93.0,Pequeno I
4599,4633,430150,1676,1059,242,264,506,553,1600.67,1047.92,233.75,285.25,519.0,528.92,19208,12575,2805,3423,6228,6347,2022,'AUGUSTO PESTANA',Augusto Pestana,'RS',4301503,4536.0,4536,378.0,378.0,1,188.0,188.0,Pequeno I
4600,4634,430155,680,364,60,44,104,260,657.58,374.67,72.25,60.25,132.5,242.17,7891,4496,867,723,1590,2906,2022,'AUREA',Áurea,'RS',4301552,623.0,623,51.9,51.9,1,22.0,22.0,Pequeno I
4601,4635,430160,56006,48786,4475,33007,37482,11304,52496.75,45822.17,4572.83,29940.92,34513.75,11308.42,629961,549866,54874,359291,414165,135701,2022,'BAGE',Bagé,'RS',4301602,8724.0,8724,727.0,727.0,3,595.0,595.0,Grande
4602,4636,430163,8738,6964,237,5402,5639,1325,8231.83,6623.75,275.33,4999.42,5274.75,1349.0,98782,79485,3304,59993,63297,16188,2022,'BALNEARIO PINHAL',Balneário Pinhal,'RS',4301636,2141.0,2141,178.4,178.4,2,265.0,265.0,Pequeno I
4603,4637,430165,961,423,34,55,89,334,862.58,387.42,36.83,58.67,95.5,291.92,10351,4649,442,704,1146,3503,2022,'BARAO',Barão,'RS',4301651,1546.0,1546,128.8,128.8,1,145.0,145.0,Pequeno I
4604,4638,430170,2806,1241,312,142,454,787,2708.5,1250.92,273.25,159.08,432.33,818.58,32502,15011,3279,1909,5188,9823,2022,'BARAO DE COTEGIPE',Barão de Cotegipe,'RS',4301701,5997.0,5997,499.8,499.8,1,383.0,383.0,Pequeno I
4605,4639,430175,2427,2147,387,1195,1582,565,2251.08,2019.33,368.67,1097.83,1466.5,552.83,27013,24232,4424,13174,17598,6634,2022,'BARAO DO TRIUNFO',Barão do Triunfo,'RS',4301750,2384.0,2384,238.4,238.4,1,191.0,191.0,Pequeno I
4606,4640,430180,1955,1527,306,637,943,584,1798.67,1471.5,236.17,747.33,983.5,488.0,21584,17658,2834,8968,11802,5856,2022,'BARRACAO',Barracão,'RS',4301800,4435.0,4435,369.6,369.6,1,475.0,475.0,Pequeno I
4607,4641,430185,1891,1077,292,174,466,611,1852.67,1087.75,283.08,193.25,476.33,611.42,22232,13053,3397,2319,5716,7337,2022,'BARRA DO GUARITA',Barra do Guarita,'RS',4301859,1844.0,1844,153.7,153.7,1,137.0,137.0,Pequeno I
4608,4642,430187,2022,1704,187,1166,1353,351,1880.58,1580.92,177.67,1064.17,1241.83,339.08,22567,18971,2132,12770,14902,4069,2022,'BARRA DO QUARAI',Barra do Quaraí,'RS',4301875,2228.0,2228,185.7,185.7,1,302.0,302.0,Pequeno I
4609,4643,430190,4231,3589,685,1583,2268,1321,3945.42,3410.08,651.33,1595.83,2247.17,1162.92,47345,40921,7816,19150,26966,13955,2022,'BARRA DO RIBEIRO',Barra do Ribeiro,'RS',4301909,1723.0,1723,143.6,143.6,1,238.0,238.0,Pequeno I
4610,4644,430192,357,164,34,43,77,87,352.75,161.42,30.0,37.58,67.58,93.83,4233,1937,360,451,811,1126,2022,'BARRA DO RIO AZUL',Barra do Rio Azul,'RS',4301925,269.0,269,24.5,24.5,1,,,Pequeno I
4611,4645,430195,1440,261,29,38,67,194,1366.83,267.5,23.42,40.5,63.92,203.58,16402,3210,281,486,767,2443,2022,'BARRA FUNDA',Barra Funda,'RS',4301958,347.0,347,28.9,28.9,1,28.0,28.0,Pequeno I
4612,4646,430200,3664,3119,910,778,1688,1431,3471.75,2983.33,925.58,851.58,1777.17,1206.17,41661,35800,11107,10219,21326,14474,2022,'BARROS CASSAL',Barros Cassal,'RS',4302006,472.0,472,47.2,47.2,1,50.0,50.0,Pequeno I
4613,4647,430205,1321,1233,30,1126,1156,77,1245.25,1157.83,35.17,1047.58,1082.75,75.08,14943,13894,422,12571,12993,901,2022,'BENJAMIN CONSTANT DO SUL',Benjamin Constant do Sul,'RS',4302055,546.0,546,45.5,45.5,1,28.0,28.0,Pequeno I
4614,4648,430210,21527,13938,2141,3104,5245,8693,18969.17,13397.67,2260.08,3101.25,5361.33,8036.33,227630,160772,27121,37215,64336,96436,2022,'BENTO GONCALVES',Bento Gonçalves,'RS',4302105,17143.0,17143,1428.6,1428.6,3,1239.0,1239.0,Grande
4615,4649,430215,953,651,110,265,375,276,912.83,634.75,101.5,267.5,369.0,265.75,10954,7617,1218,3210,4428,3189,2022,'BOA VISTA DAS MISSOES',Boa Vista Das Missões,'RS',4302154,1118.0,1118,93.2,93.2,1,76.0,76.0,Pequeno I
4616,4650,430220,1678,704,94,184,278,426,1689.67,726.58,90.92,180.42,271.33,455.25,20276,8719,1091,2165,3256,5463,2022,'BOA VISTA DO BURICA',Boa Vista do Buricá,'RS',4302204,2913.0,2913,242.8,242.8,1,141.0,141.0,Pequeno I
4617,4651,430222,747,565,104,188,292,273,684.42,530.5,85.33,177.92,263.25,267.25,8213,6366,1024,2135,3159,3207,2022,'BOA VISTA DO CADEADO',Boa Vista do Cadeado,'RS',4302220,2988.0,2988,249.0,249.0,1,215.0,215.0,Pequeno I
4618,4652,430223,813,677,76,384,460,217,739.58,618.58,62.75,357.33,420.08,198.5,8875,7423,753,4288,5041,2382,2022,'BOA VISTA DO INCRA',Boa Vista do Incra,'RS',4302238,388.0,388,38.8,38.8,1,35.0,35.0,Pequeno I
4619,4654,430230,6086,5504,330,4352,4682,822,5774.5,5227.58,355.0,4052.42,4407.42,820.17,69294,62731,4260,48629,52889,9842,2022,'BOM JESUS',Bom Jesus,'RS',4302303,2312.0,2312,210.2,210.2,1,97.0,97.0,Pequeno I
4620,4655,430235,1385,985,158,214,372,613,1250.08,904.75,162.0,201.0,363.0,541.75,15001,10857,1944,2412,4356,6501,2022,'BOM PRINCIPIO',Bom Princípio,'RS',4302352,3070.0,3070,255.8,255.8,1,196.0,196.0,Pequeno I
4621,4656,430237,1359,1113,71,847,918,195,1303.25,1081.5,66.33,827.67,894.0,187.5,15639,12978,796,9932,10728,2250,2022,'BOM PROGRESSO',Bom Progresso,'RS',4302378,1336.0,1336,111.3,111.3,1,105.0,105.0,Pequeno I
4622,4657,430240,3711,2411,361,998,1359,1052,3485.83,2303.17,335.08,1008.08,1343.17,960.0,41830,27638,4021,12097,16118,11520,2022,'BOM RETIRO DO SUL',Bom Retiro do Sul,'RS',4302402,4361.0,4361,363.4,363.4,1,420.0,420.0,Pequeno I
4623,4658,430245,2238,1901,343,1135,1478,423,2139.08,1828.5,318.83,1099.0,1417.83,410.67,25669,21942,3826,13188,17014,4928,2022,'BOQUEIRAO DO LEAO',Boqueirão do Leão,'RS',4302451,3743.0,3743,311.9,311.9,1,323.0,323.0,Pequeno I
4624,4659,430250,2846,2268,812,487,1299,969,2600.75,2122.92,801.33,383.75,1185.08,937.83,31209,25475,9616,4605,14221,11254,2022,'BOSSOROCA',Bossoroca,'RS',4302501,4584.0,4584,382.0,382.0,1,297.0,297.0,Pequeno I
4625,4661,430260,2027,1512,200,827,1027,485,1959.58,1511.58,193.08,857.75,1050.83,460.75,23515,18139,2317,10293,12610,5529,2022,'BRAGA',Braga,'RS',4302600,700.0,700,58.3,58.3,1,16.0,16.0,Pequeno I
4626,4662,430265,781,616,86,233,319,297,711.42,559.5,84.67,219.75,304.42,255.08,8537,6714,1016,2637,3653,3061,2022,'BROCHIER',Brochier,'RS',4302659,1000.0,1000,83.3,83.3,1,26.0,26.0,Pequeno I
4627,4663,430270,8692,7519,986,5073,6059,1460,8074.58,7025.75,914.42,4725.92,5640.33,1385.42,96895,84309,10973,56711,67684,16625,2022,'BUTIA',Butiá,'RS',4302709,3362.0,3362,280.2,280.2,1,351.0,351.0,Pequeno II
4628,4664,430280,13495,10611,1806,5192,6998,3613,12886.25,10212.0,1767.75,4899.42,6667.17,3544.83,154635,122544,21213,58793,80006,42538,2022,'CACAPAVA DO SUL',Caçapava do Sul,'RS',4302808,3562.0,3562,296.8,296.8,2,341.0,341.0,Pequeno II
4629,4665,430290,5610,4993,439,3632,4071,922,5453.25,4911.75,325.17,3803.17,4128.33,783.42,65439,58941,3902,45638,49540,9401,2022,'CACEQUI',Cacequi,'RS',4302907,4785.0,4785,531.7,531.7,1,530.0,530.0,Pequeno I
4630,4666,430300,29659,24620,3527,13856,17383,7237,28084.33,23451.58,3445.5,13033.67,16479.17,6972.42,337012,281419,41346,156404,197750,83669,2022,'CACHOEIRA DO SUL',Cachoeira do Sul,'RS',4303004,14053.0,14053,1171.1,1171.1,3,1421.0,1421.0,Médio
4631,4667,430310,39108,30928,4252,16445,20697,10231,35785.67,28188.92,3765.0,14458.25,18223.25,9965.67,429428,338267,45180,173499,218679,119588,2022,'CACHOEIRINHA',Cachoeirinha,'RS',4303103,52841.0,52841,4403.4,4403.4,4,2167.0,2167.0,Grande
4632,4668,430320,2664,1740,170,926,1096,644,2710.0,1782.42,167.92,1027.08,1195.0,587.42,32520,21389,2015,12325,14340,7049,2022,'CACIQUE DOBLE',Cacique Doble,'RS',4303202,2148.0,2148,179.0,179.0,1,116.0,116.0,Pequeno I
4633,4669,430330,1830,1183,221,368,589,594,1787.0,1197.67,187.58,428.33,615.92,581.75,21444,14372,2251,5140,7391,6981,2022,'CAIBATE',Caibaté,'RS',4303301,1950.0,1950,162.5,162.5,1,113.0,113.0,Pequeno I
4634,4670,430340,1654,1274,182,782,964,310,1595.67,1241.08,167.08,764.08,931.17,309.92,19148,14893,2005,9169,11174,3719,2022,'CAICARA',Caiçara,'RS',4303400,2227.0,2227,185.6,185.6,1,183.0,183.0,Pequeno I
4635,4671,430350,24037,20003,2792,11423,14215,5788,22561.0,18949.25,2300.67,11347.67,13648.33,5300.92,270732,227391,27608,136172,163780,63611,2022,'CAMAQUA',Camaquã,'RS',4303509,13198.0,13198,1099.8,1099.8,3,990.0,990.0,Médio
4636,4672,430355,1068,501,93,45,138,363,1008.83,464.67,82.5,43.83,126.33,338.33,12106,5576,990,526,1516,4060,2022,'CAMARGO',Camargo,'RS',4303558,813.0,813,67.8,67.8,1,65.0,65.0,Pequeno I
4637,4673,430360,2438,1710,439,451,890,820,2289.42,1673.33,402.83,524.5,927.33,746.0,27473,20080,4834,6294,11128,8952,2022,'CAMBARA DO SUL',Cambará do Sul,'RS',4303608,2811.0,2811,234.2,234.2,1,184.0,184.0,Pequeno I
4638,4674,430367,871,621,115,337,452,169,841.83,593.17,120.25,295.25,415.5,177.67,10102,7118,1443,3543,4986,2132,2022,'CAMPESTRE DA SERRA',Campestre da Serra,'RS',4303673,1274.0,1274,106.2,106.2,1,152.0,152.0,Pequeno I
4639,4675,430370,1516,696,153,134,287,409,1483.42,694.92,131.25,138.67,269.92,425.0,17801,8339,1575,1664,3239,5100,2022,'CAMPINA DAS MISSOES',Campina Das Missões,'RS',4303707,1704.0,1704,154.9,154.9,1,168.0,168.0,Pequeno I
4640,4676,430380,1806,1132,236,239,475,657,1781.17,1128.5,235.42,269.17,504.58,623.92,21374,13542,2825,3230,6055,7487,2022,'CAMPINAS DO SUL',Campinas do Sul,'RS',4303806,2218.0,2218,184.8,184.8,1,243.0,243.0,Pequeno I
4641,4677,430390,10037,7428,1617,729,2346,5082,9310.58,6872.5,1612.58,753.67,2366.25,4506.25,111727,82470,19351,9044,28395,54075,2022,'CAMPO BOM',Campo Bom,'RS',4303905,9212.0,9212,767.7,767.7,2,997.0,997.0,Médio
4642,4678,430400,2516,2048,351,1065,1416,632,2396.33,1973.67,312.0,982.42,1294.42,679.25,28756,23684,3744,11789,15533,8151,2022,'CAMPO NOVO',Campo Novo,'RS',4304002,2183.0,2183,181.9,181.9,1,113.0,113.0,Pequeno I
4643,4679,430410,1446,1167,124,822,946,221,1395.0,1130.33,113.67,780.92,894.58,235.75,16740,13564,1364,9371,10735,2829,2022,'CAMPOS BORGES',Campos Borges,'RS',4304101,1430.0,1430,119.2,119.2,1,127.0,127.0,Pequeno I
4644,4680,430420,8766,7100,1079,3988,5067,2033,8014.0,6605.83,1049.75,3737.83,4787.58,1818.25,96168,79270,12597,44854,57451,21819,2022,'CANDELARIA',Candelária,'RS',4304200,3324.0,3324,277.0,277.0,1,182.0,182.0,Pequeno II
4645,4681,430430,1489,788,157,121,278,510,1513.67,835.83,177.67,146.83,324.5,511.33,18164,10030,2132,1762,3894,6136,2022,'CANDIDO GODOI',Cândido Godói,'RS',4304309,1483.0,1483,123.6,123.6,1,156.0,156.0,Pequeno I
4646,4682,430435,4996,3993,710,1919,2629,1364,4560.67,3746.83,643.33,1876.92,2520.25,1226.58,54728,44962,7720,22523,30243,14719,2022,'CANDIOTA',Candiota,'RS',4304358,1630.0,1630,181.1,181.1,1,180.0,180.0,Pequeno I
4647,4683,430440,13676,11938,1447,7466,8913,3025,12061.83,10585.42,1147.25,6643.0,7790.25,2795.17,144742,127025,13767,79716,93483,33542,2022,'CANELA',Canela,'RS',4304408,17967.0,42328,1497.2,3527.3,2,824.0,824.0,Pequeno II
4648,4684,430450,20391,17484,3279,9180,12459,5025,19013.42,16460.5,3031.42,8671.5,11702.92,4757.58,228161,197526,36377,104058,140435,57091,2022,'CANGUCU',Canguçu,'RS',4304507,3682.0,3682,306.8,306.8,1,269.0,269.0,Médio
4649,4685,430460,113084,91492,13861,48094,61955,29537,102620.67,84939.75,12591.42,45398.67,57990.08,26949.67,1231448,1019277,151097,544784,695881,323396,2022,'CANOAS',Canoas,'RS',4304606,35943.0,35943,2995.2,2995.2,4,2431.0,2431.0,Grande
4650,4686,430461,651,283,67,90,157,126,631.0,266.0,60.92,87.75,148.67,117.33,7572,3192,731,1053,1784,1408,2022,'CANUDOS DO VALE',Canudos do Vale,'RS',4304614,614.0,614,51.2,51.2,1,28.0,28.0,Pequeno I
4651,4687,430462,935,558,105,133,238,320,888.25,561.83,111.58,134.08,245.67,316.17,10659,6742,1339,1609,2948,3794,2022,'CAPAO BONITO DO SUL',Capão Bonito do Sul,'RS',4304622,957.0,957,79.8,79.8,1,74.0,74.0,Pequeno I
4652,4688,430463,21924,17649,3904,7555,11459,6190,19443.33,15905.67,3360.58,7090.25,10450.83,5454.83,233320,190868,40327,85083,125410,65458,2022,'CAPAO DA CANOA',Capão da Canoa,'RS',4304630,6461.0,6461,538.4,538.4,3,485.0,485.0,Pequeno II
4653,4689,430465,1601,1175,216,626,842,333,1396.5,1103.42,180.08,657.83,837.92,265.5,16758,13241,2161,7894,10055,3186,2022,'CAPAO DO CIPO',Capão do Cipó,'RS',4304655,1258.0,1258,104.8,104.8,1,84.0,84.0,Pequeno I
4654,4690,430466,13636,11897,2158,6347,8505,3392,12610.58,11069.17,1981.58,5867.0,7848.58,3220.58,151327,132830,23779,70404,94183,38647,2022,'CAPAO DO LEAO',Capão do Leão,'RS',4304663,14091.0,14091,1174.2,1174.2,2,1618.0,1618.0,Pequeno II
4655,4691,430467,1419,1164,137,659,796,368,1322.33,1088.67,146.75,590.33,737.08,351.58,15868,13064,1761,7084,8845,4219,2022,'CAPIVARI DO SUL',Capivari do Sul,'RS',4304671,2435.0,2435,202.9,202.9,1,130.0,130.0,Pequeno I
4656,4692,430468,3993,3518,314,2556,2870,648,3642.83,3217.92,314.0,2336.5,2650.5,567.42,43714,38615,3768,28038,31806,6809,2022,'CAPELA DE SANTANA',Capela de Santana,'RS',4304689,5210.0,5210,434.2,434.2,1,409.0,409.0,Pequeno I
4657,4693,430469,1939,408,46,98,144,264,1840.58,353.0,38.58,56.92,95.5,257.5,22087,4236,463,683,1146,3090,2022,'CAPITAO',Capitão,'RS',4304697,713.0,713,59.4,59.4,1,25.0,25.0,Pequeno I
4658,4694,430470,17169,13019,3844,2931,6775,6244,16225.67,12466.92,3684.08,3157.58,6841.67,5625.25,194708,149603,44209,37891,82100,67503,2022,'CARAZINHO',Carazinho,'RS',4304705,18412.0,18412,1534.3,1534.3,2,1246.0,1246.0,Médio
4659,4696,430480,1986,1385,233,329,562,823,1889.5,1361.92,221.75,320.0,541.75,820.17,22674,16343,2661,3840,6501,9842,2022,'CARLOS BARBOSA',Carlos Barbosa,'RS',4304804,1364.0,1364,113.7,113.7,1,120.0,120.0,Pequeno II
4660,4697,430485,498,258,48,60,108,150,473.5,245.17,36.42,59.17,95.58,149.58,5682,2942,437,710,1147,1795,2022,'CARLOS GOMES',Carlos Gomes,'RS',4304853,258.0,258,21.5,21.5,1,7.0,7.0,Pequeno I
4661,4698,430490,1282,836,106,346,452,384,1192.83,777.25,95.67,314.5,410.17,367.08,14314,9327,1148,3774,4922,4405,2022,'CASCA',Casca,'RS',4304903,3819.0,3819,347.2,347.2,1,,,Pequeno I
4662,4699,430495,1221,931,157,426,583,348,1145.83,885.25,144.58,393.42,538.0,347.25,13750,10623,1735,4721,6456,4167,2022,'CASEIROS',Caseiros,'RS',4304952,558.0,558,46.5,46.5,1,26.0,26.0,Pequeno I
4663,4700,430500,2886,2298,843,540,1383,915,2764.42,2228.58,754.83,631.75,1386.58,842.0,33173,26743,9058,7581,16639,10104,2022,'CATUIPE',Catuípe,'RS',4305009,3140.0,3140,261.7,261.7,1,267.0,267.0,Pequeno I
4664,4701,430510,84307,66611,13092,26582,39674,26937,79783.42,63622.08,11747.17,26885.33,38632.5,24989.58,957401,763465,140966,322624,463590,299875,2022,'CAXIAS DO SUL',Caxias do Sul,'RS',4305108,33063.0,33063,2755.2,2755.2,6,2496.0,2496.0,Grande
4665,4702,430511,1056,462,58,52,110,352,1051.0,485.0,56.42,51.67,108.08,376.92,12612,5820,677,620,1297,4523,2022,'CENTENARIO',Centenário,'RS',4305116,346.0,346,28.8,28.8,1,34.0,34.0,Pequeno I
4666,4703,430512,2609,2245,535,923,1458,787,2474.67,2111.75,466.5,901.0,1367.5,744.25,29696,25341,5598,10812,16410,8931,2022,'CERRITO',Cerrito,'RS',4305124,325.0,325,46.4,46.4,1,52.0,52.0,Pequeno I
4667,4704,430513,2133,1185,183,587,770,415,2079.0,1169.92,190.5,554.58,745.08,424.83,24948,14039,2286,6655,8941,5098,2022,'CERRO BRANCO',Cerro Branco,'RS',4305132,1900.0,1900,158.3,158.3,1,153.0,153.0,Pequeno I
4668,4705,430515,1186,921,119,401,520,401,1143.17,905.42,122.92,447.08,570.0,335.42,13718,10865,1475,5365,6840,4025,2022,'CERRO GRANDE',Cerro Grande,'RS',4305157,1572.0,1572,131.0,131.0,1,150.0,150.0,Pequeno I
4669,4706,430517,4316,3469,560,1923,2483,986,3972.83,3241.17,485.25,1879.33,2364.58,876.58,47674,38894,5823,22552,28375,10519,2022,'CERRO GRANDE DO SUL',Cerro Grande do Sul,'RS',4305173,3373.0,3373,281.1,281.1,1,134.0,134.0,Pequeno I
4670,4707,430520,3845,2370,388,542,930,1440,3727.0,2307.42,401.08,553.58,954.67,1352.75,44724,27689,4813,6643,11456,16233,2022,'CERRO LARGO',Cerro Largo,'RS',4305207,3872.0,3872,322.7,322.7,1,364.0,364.0,Pequeno I
4671,4708,430530,2694,1342,220,344,564,778,2605.67,1338.83,217.17,350.5,567.67,771.17,31268,16066,2606,4206,6812,9254,2022,'CHAPADA',Chapada,'RS',4305306,1559.0,1559,129.9,129.9,1,91.0,91.0,Pequeno I
4672,4709,430535,10604,8374,1271,4023,5294,3080,10040.42,8107.92,1167.75,4033.25,5201.0,2906.92,120485,97295,14013,48399,62412,34883,2022,'CHARQUEADAS',Charqueadas,'RS',4305355,9845.0,9845,820.4,820.4,1,647.0,647.0,Pequeno II
4673,4710,430537,1489,1343,120,1007,1127,216,1382.25,1249.75,90.58,956.08,1046.67,203.08,16587,14997,1087,11473,12560,2437,2022,'CHARRUA',Charrua,'RS',4305371,2026.0,2026,168.8,168.8,1,125.0,125.0,Pequeno I
4674,4711,430540,1612,1144,180,597,777,367,1592.58,1135.33,173.92,617.08,791.0,344.33,19111,13624,2087,7405,9492,4132,2022,'CHIAPETTA',Chiapetta,'RS',4305405,553.0,553,46.1,46.1,1,34.0,34.0,Pequeno I
4675,4712,430543,2225,1648,370,509,879,769,2040.58,1507.75,280.75,570.5,851.25,656.5,24487,18093,3369,6846,10215,7878,2022,'CHUI',Chuí,'RS',4305439,432.0,432,36.0,36.0,1,36.0,36.0,Pequeno I
4676,4713,430544,2198,1593,433,507,940,653,2196.0,1630.25,429.08,548.58,977.67,652.58,26352,19563,5149,6583,11732,7831,2022,'CHUVISCA',Chuvisca,'RS',4305447,3004.0,3004,250.3,250.3,1,340.0,340.0,Pequeno I
4677,4714,430545,7395,6258,1073,3370,4443,1815,6817.75,5813.08,895.83,3382.17,4278.0,1535.08,81813,69757,10750,40586,51336,18421,2022,'CIDREIRA',Cidreira,'RS',4305454,4408.0,4408,400.7,400.7,1,353.0,353.0,Pequeno I
4678,4715,430550,1163,916,248,244,492,424,1093.25,875.5,209.5,266.0,475.5,400.0,13119,10506,2514,3192,5706,4800,2022,'CIRIACO',Ciríaco,'RS',4305504,897.0,897,74.8,74.8,1,46.0,46.0,Pequeno I
4679,4716,430558,397,191,7,89,96,95,384.0,184.33,11.58,76.08,87.67,96.67,4608,2212,139,913,1052,1160,2022,'COLINAS',Colinas,'RS',4305587,409.0,409,37.2,37.2,1,,,Pequeno I
4680,4717,430560,782,509,81,144,225,284,734.33,487.17,81.67,153.92,235.58,251.58,8812,5846,980,1847,2827,3019,2022,'COLORADO',Colorado,'RS',4305603,781.0,781,65.1,65.1,1,85.0,85.0,Pequeno I
4681,4718,430570,2328,1794,448,660,1108,686,2266.92,1783.17,406.92,722.5,1129.42,653.75,27203,21398,4883,8670,13553,7845,2022,'CONDOR',Condor,'RS',4305702,2446.0,2446,203.8,203.8,1,160.0,160.0,Pequeno I
4682,4719,430580,2398,1993,450,867,1317,676,2235.08,1851.5,418.67,854.25,1272.92,578.58,26821,22218,5024,10251,15275,6943,2022,'CONSTANTINA',Constantina,'RS',4305801,2742.0,2742,228.5,228.5,1,211.0,211.0,Pequeno I
4683,4720,430583,516,135,13,24,37,98,506.83,135.25,8.08,23.58,31.67,103.58,6082,1623,97,283,380,1243,2022,'COQUEIRO BAIXO',Coqueiro Baixo,'RS',4305835,1587.0,1587,132.2,132.2,1,104.0,104.0,Pequeno I
4684,4721,430585,567,339,83,87,170,169,576.92,356.33,80.5,103.08,183.58,172.75,6923,4276,966,1237,2203,2073,2022,'COQUEIROS DO SUL',Coqueiros do Sul,'RS',4305850,1576.0,1576,131.3,131.3,1,66.0,66.0,Pequeno I
4685,4722,430587,621,519,67,224,291,228,591.83,497.08,59.17,211.75,270.92,226.17,7102,5965,710,2541,3251,2714,2022,'CORONEL BARROS',Coronel Barros,'RS',4305871,163.0,163,13.6,13.6,1,8.0,8.0,Pequeno I
4686,4723,430590,3694,3138,360,2043,2403,735,3546.17,3071.58,324.17,2152.17,2476.33,595.25,42554,36859,3890,25826,29716,7143,2022,'CORONEL BICACO',Coronel Bicaco,'RS',4305900,1268.0,1268,115.3,115.3,1,56.0,56.0,Pequeno I
4687,4725,430595,1195,365,50,41,91,274,1187.25,399.58,47.58,62.75,110.33,289.25,14247,4795,571,753,1324,3471,2022,'COTIPORA',Cotiporã,'RS',4305959,1059.0,1059,96.3,96.3,1,115.0,115.0,Pequeno I
4688,4726,430597,1285,752,61,174,235,517,1220.75,750.75,71.17,175.33,246.5,504.25,14649,9009,854,2104,2958,6051,2022,'COXILHA',Coxilha,'RS',4305975,1228.0,1228,102.3,102.3,1,55.0,55.0,Pequeno I
4689,4727,430600,5844,2774,438,518,956,1818,5550.92,2699.33,411.0,574.75,985.75,1713.58,66611,32392,4932,6897,11829,20563,2022,'CRISSIUMAL',Crissiumal,'RS',4306007,4632.0,4632,386.0,386.0,1,223.0,223.0,Pequeno I
4690,4728,430605,3885,3119,479,1325,1804,1315,3740.58,3038.17,431.58,1421.25,1852.83,1185.33,44887,36458,5179,17055,22234,14224,2022,'CRISTAL',Cristal,'RS',4306056,2364.0,2364,236.4,236.4,1,,,Pequeno I
4691,4729,430607,1752,1264,101,773,874,390,1618.33,1226.42,79.42,800.25,879.67,346.75,19420,14717,953,9603,10556,4161,2022,'CRISTAL DO SUL',Cristal do Sul,'RS',4306072,990.0,990,82.5,82.5,1,85.0,85.0,Pequeno I
4692,4730,430610,16647,13457,3910,4503,8413,5044,15534.08,12462.92,3628.75,3582.58,7211.33,5251.58,186409,149555,43545,42991,86536,63019,2022,'CRUZ ALTA',Cruz Alta,'RS',4306106,5118.0,5118,426.5,426.5,2,615.0,615.0,Médio
4693,4731,430613,681,242,26,55,81,161,676.83,242.0,32.33,52.75,85.08,156.92,8122,2904,388,633,1021,1883,2022,'CRUZALTENSE',Cruzaltense,'RS',4306130,1596.0,1596,133.0,133.0,1,125.0,125.0,Pequeno I
4694,4732,430620,2163,1736,399,749,1148,588,1920.83,1573.58,339.5,734.67,1074.17,499.42,23050,18883,4074,8816,12890,5993,2022,'CRUZEIRO DO SUL',Cruzeiro do Sul,'RS',4306205,950.0,950,79.2,79.2,1,78.0,78.0,Pequeno I
4695,4733,430630,1357,464,78,124,202,262,1272.92,447.5,83.58,106.42,190.0,257.5,15275,5370,1003,1277,2280,3090,2022,'DAVID CANABARRO',David Canabarro,'RS',4306304,1642.0,1642,136.8,136.8,1,87.0,87.0,Pequeno I
4696,4734,430632,1284,595,103,197,300,295,1241.25,609.67,99.17,228.58,327.75,281.92,14895,7316,1190,2743,3933,3383,2022,'DERRUBADAS',Derrubadas,'RS',4306320,587.0,587,48.9,48.9,1,44.0,44.0,Pequeno I
4697,4735,430635,1450,1129,103,800,903,226,1417.5,1130.58,81.42,836.33,917.75,212.83,17010,13567,977,10036,11013,2554,2022,'DEZESSEIS DE NOVEMBRO',Dezesseis de Novembro,'RS',4306353,2165.0,2165,180.4,180.4,1,285.0,285.0,Pequeno I
4698,4736,430637,1387,1134,122,691,813,321,1211.08,1030.42,112.58,669.42,782.0,248.42,14533,12365,1351,8033,9384,2981,2022,'DILERMANDO DE AGUIAR',Dilermando de Aguiar,'RS',4306379,872.0,872,72.7,72.7,1,40.0,40.0,Pequeno I
4699,4737,430640,3517,2614,423,863,1286,1328,3281.0,2486.67,395.5,906.5,1302.0,1184.67,39372,29840,4746,10878,15624,14216,2022,'DOIS IRMAOS',Dois Irmãos,'RS',4306403,2442.0,2442,203.5,203.5,1,163.0,163.0,Pequeno II
4700,4738,430642,1159,758,135,272,407,351,1072.83,781.42,138.67,312.42,451.08,330.33,12874,9377,1664,3749,5413,3964,2022,'DOIS IRMAOS DAS MISSOES',Dois Irmãos Das Missões,'RS',4306429,224.0,224,18.7,18.7,1,18.0,18.0,Pequeno I
4701,4739,430645,441,245,33,62,95,150,412.17,217.67,32.92,57.83,90.75,126.92,4946,2612,395,694,1089,1523,2022,'DOIS LAJEADOS',Dois Lajeados,'RS',4306452,280.0,280,25.5,25.5,1,,,Pequeno I
4702,4740,430650,5540,4596,1328,1916,3244,1352,5302.83,4507.67,1227.5,2077.08,3304.58,1203.08,63634,54092,14730,24925,39655,14437,2022,'DOM FELICIANO',Dom Feliciano,'RS',4306502,4329.0,4329,360.8,360.8,1,261.0,261.0,Pequeno I
4703,4741,430655,857,572,84,276,360,212,816.08,555.42,91.58,253.75,345.33,210.08,9793,6665,1099,3045,4144,2521,2022,'DOM PEDRO DE ALCANTARA',Dom Pedro de Alcântara,'RS',4306551,252.0,252,21.0,21.0,1,10.0,10.0,Pequeno I
4704,4742,430660,15050,12527,2337,6155,8492,4035,14168.17,12037.0,2185.58,6074.75,8260.33,3776.67,170018,144444,26227,72897,99124,45320,2022,'DOM PEDRITO',Dom Pedrito,'RS',4306601,15225.0,15225,1268.8,1268.8,2,1502.0,1502.0,Pequeno II
4705,4743,430670,1655,1279,220,545,765,514,1617.0,1312.25,218.67,592.83,811.5,500.75,19404,15747,2624,7114,9738,6009,2022,'DONA FRANCISCA',Dona Francisca,'RS',4306700,883.0,883,73.6,73.6,1,49.0,49.0,Pequeno I
4706,4744,430673,1327,747,164,249,413,334,1284.92,721.42,131.92,258.17,390.08,331.33,15419,8657,1583,3098,4681,3976,2022,'DOUTOR MAURICIO CARDOSO',Doutor Maurício Cardoso,'RS',4306734,2760.0,2760,230.0,230.0,1,130.0,130.0,Pequeno I
4707,4745,430675,790,219,39,31,70,149,787.08,238.17,38.83,35.0,73.83,164.33,9445,2858,466,420,886,1972,2022,'DOUTOR RICARDO',Doutor Ricardo,'RS',4306759,561.0,561,46.8,46.8,1,34.0,34.0,Pequeno I
4708,4746,430676,16512,14204,2324,8222,10546,3658,15013.67,13155.75,1899.08,8021.75,9920.83,3234.92,180164,157869,22789,96261,119050,38819,2022,'ELDORADO DO SUL',Eldorado do Sul,'RS',4306767,5773.0,5773,481.1,481.1,1,495.0,495.0,Pequeno II
4709,4747,430680,3509,2537,846,673,1519,1018,3194.5,2286.42,734.58,588.58,1323.17,963.25,38334,27437,8815,7063,15878,11559,2022,'ENCANTADO',Encantado,'RS',4306809,3914.0,3914,326.2,326.2,1,298.0,298.0,Pequeno II
4710,4748,430690,9385,7950,2488,3057,5545,2405,8743.0,7514.92,2270.42,2912.67,5183.08,2331.83,104916,90179,27245,34952,62197,27982,2022,'ENCRUZILHADA DO SUL',Encruzilhada do Sul,'RS',4306908,9008.0,9008,750.7,750.7,2,576.0,576.0,Pequeno II
4711,4749,430692,686,607,32,470,502,105,675.92,596.58,34.75,472.33,507.08,89.5,8111,7159,417,5668,6085,1074,2022,'ENGENHO VELHO',Engenho Velho,'RS',4306924,2397.0,2397,199.8,199.8,1,187.0,187.0,Pequeno I
4712,4750,430693,2851,1967,481,504,985,982,2697.08,1913.0,425.42,508.83,934.25,978.75,32365,22956,5105,6106,11211,11745,2022,'ENTRE-IJUIS',Entre-ijuís,'RS',4306932,1596.0,1596,133.0,133.0,1,73.0,73.0,Pequeno I
4713,4751,430695,1053,692,127,284,411,281,1041.17,702.92,105.25,326.83,432.08,270.83,12494,8435,1263,3922,5185,3250,2022,'ENTRE RIOS DO SUL',Entre Rios do Sul,'RS',4306957,1958.0,1958,163.2,163.2,1,95.0,95.0,Pequeno I
4714,4752,430697,1408,1221,195,760,955,266,1255.33,1084.67,184.33,655.67,840.0,244.67,15064,13016,2212,7868,10080,2936,2022,'EREBANGO',Erebango,'RS',4306973,4510.0,4510,375.8,375.8,1,350.0,350.0,Pequeno I
4715,4753,430700,22887,16503,3861,3532,7393,9110,21490.92,15702.25,3492.08,3779.25,7271.33,8430.92,257891,188427,41905,45351,87256,101171,2022,'ERECHIM',Erechim,'RS',4307005,21927.0,21927,1827.2,1827.2,3,1578.0,1578.0,Médio
4716,4754,430705,959,575,68,209,277,298,955.08,582.58,68.17,226.17,294.33,288.25,11461,6991,818,2714,3532,3459,2022,'ERNESTINA',Ernestina,'RS',4307054,3227.0,3227,268.9,268.9,1,182.0,182.0,Pequeno I
4717,4755,430710,4195,3215,220,2381,2601,614,3949.42,3113.42,294.5,2113.83,2408.33,705.08,47393,37361,3534,25366,28900,8461,2022,'HERVAL',Herval,'RS',4307104,7095.0,7095,591.2,591.2,1,510.0,510.0,Pequeno I
4718,4756,430720,2202,1393,179,688,867,526,2128.5,1352.25,172.5,664.67,837.17,515.08,25542,16227,2070,7976,10046,6181,2022,'ERVAL GRANDE',Erval Grande,'RS',4307203,1726.0,1726,143.8,143.8,1,379.0,379.0,Pequeno I
4719,4757,430730,2894,2190,322,878,1200,990,2859.42,2221.08,301.17,994.83,1296.0,925.08,34313,26653,3614,11938,15552,11101,2022,'ERVAL SECO',Erval Seco,'RS',4307302,4868.0,4868,405.7,405.7,1,182.0,182.0,Pequeno I
4720,4758,430740,2078,1249,255,334,589,660,1996.0,1220.75,234.0,344.0,578.0,642.75,23952,14649,2808,4128,6936,7713,2022,'ESMERALDA',Esmeralda,'RS',4307401,1356.0,1356,113.0,113.0,1,103.0,103.0,Pequeno I
4721,4759,430745,1319,1017,181,499,680,337,1167.58,889.25,162.58,395.83,558.42,330.83,14011,10671,1951,4750,6701,3970,2022,'ESPERANCA DO SUL',Esperança do Sul,'RS',4307450,649.0,649,59.0,59.0,1,58.0,58.0,Pequeno I
4722,4760,430750,4654,3391,889,1255,2144,1247,4246.5,3202.0,852.08,1220.67,2072.75,1129.25,50958,38424,10225,14648,24873,13551,2022,'ESPUMOSO',Espumoso,'RS',4307500,5996.0,8071,499.7,672.6,1,563.0,563.0,Pequeno I
4723,4761,430755,1298,998,105,538,643,355,1217.08,917.42,94.42,471.75,566.17,351.25,14605,11009,1133,5661,6794,4215,2022,'ESTACAO',Estação,'RS',4307559,3304.0,3304,330.4,330.4,1,244.0,244.0,Pequeno I
4724,4762,430760,7007,5984,1317,2696,4013,1971,6216.92,5338.58,1157.08,2462.83,3619.92,1718.67,74603,64063,13885,29554,43439,20624,2022,'ESTANCIA VELHA',Estância Velha,'RS',4307609,374.0,374,31.2,31.2,1,34.0,34.0,Pequeno II
4725,4763,430770,21003,18149,2309,11329,13638,4511,19329.5,16799.83,2082.67,10714.0,12796.67,4003.17,231954,201598,24992,128568,153560,48038,2022,'ESTEIO',Esteio,'RS',4307708,12352.0,12352,1029.3,1029.3,2,907.0,907.0,Médio
4726,4764,430780,6064,4624,851,2165,3016,1608,5526.0,4214.58,743.0,2006.0,2749.0,1465.58,66312,50575,8916,24072,32988,17587,2022,'ESTRELA',Estrela,'RS',4307807,11545.0,11545,962.1,962.1,2,816.0,816.0,Pequeno II
4727,4765,430781,1757,1215,437,363,800,415,1585.92,1090.5,351.25,318.75,670.0,420.5,19031,13086,4215,3825,8040,5046,2022,'ESTRELA VELHA',Estrela Velha,'RS',4307815,300.0,300,25.0,25.0,1,32.0,32.0,Pequeno I
4728,4766,430783,904,674,157,315,472,202,871.33,661.58,120.67,345.58,466.25,195.33,10456,7939,1448,4147,5595,2344,2022,'EUGENIO DE CASTRO',Eugênio de Castro,'RS',4307831,767.0,767,63.9,63.9,1,34.0,34.0,Pequeno I
4729,4767,430786,121,89,15,9,24,65,115.5,83.0,14.5,10.0,24.5,58.5,1386,996,174,120,294,702,2022,'FAGUNDES VARELA',Fagundes Varela,'RS',4307864,304.0,304,25.3,25.3,1,2.0,2.0,Pequeno I
4730,4768,430790,13742,11068,1394,6232,7626,3442,12709.58,10278.33,1201.92,5896.33,7098.25,3180.08,152515,123340,14423,70756,85179,38161,2022,'FARROUPILHA',Farroupilha,'RS',4307906,36985.0,53384,3082.1,4448.7,2,3157.0,3157.0,Médio
4731,4769,430800,2086,1747,130,1261,1391,356,1982.42,1673.5,116.25,1174.08,1290.33,383.17,23789,20082,1395,14089,15484,4598,2022,'FAXINAL DO SOTURNO',Faxinal do Soturno,'RS',4308003,691.0,691,69.1,69.1,1,115.0,115.0,Pequeno I
4732,4770,430805,1105,817,37,591,628,189,1011.58,746.25,46.58,515.67,562.25,184.0,12139,8955,559,6188,6747,2208,2022,'FAXINALZINHO',Faxinalzinho,'RS',4308052,633.0,633,52.8,52.8,1,65.0,65.0,Pequeno I
4733,4771,430807,1655,1112,197,380,577,535,1561.5,1077.83,170.08,453.58,623.67,454.17,18738,12934,2041,5443,7484,5450,2022,'FAZENDA VILANOVA',Fazenda Vilanova,'RS',4308078,1184.0,1184,98.7,98.7,1,78.0,78.0,Pequeno I
4734,4772,430810,2079,1203,200,404,604,599,1982.5,1133.58,196.33,375.67,572.0,561.58,23790,13603,2356,4508,6864,6739,2022,'FELIZ',Feliz,'RS',4308102,3825.0,3825,347.7,347.7,1,,,Pequeno I
4735,4773,430820,4280,2815,473,754,1227,1588,3834.33,2647.42,425.58,783.25,1208.83,1438.58,46012,31769,5107,9399,14506,17263,2022,'FLORES DA CUNHA',Flores da Cunha,'RS',4308201,7038.0,7038,586.5,586.5,1,597.0,597.0,Pequeno II
4736,4774,430825,700,298,43,96,139,159,705.17,292.67,38.17,99.08,137.25,155.42,8462,3512,458,1189,1647,1865,2022,'FLORIANO PEIXOTO',Floriano Peixoto,'RS',4308250,1135.0,1135,94.6,94.6,1,70.0,70.0,Pequeno I
4737,4775,430830,5630,4871,324,3514,3838,1033,5278.58,4595.58,370.33,3198.67,3569.0,1026.58,63343,55147,4444,38384,42828,12319,2022,'FONTOURA XAVIER',Fontoura Xavier,'RS',4308300,954.0,954,79.5,79.5,1,98.0,98.0,Pequeno I
4738,4776,430840,3199,2461,330,1472,1802,659,2806.33,2202.92,290.17,1407.92,1698.08,504.83,33676,26435,3482,16895,20377,6058,2022,'FORMIGUEIRO',Formigueiro,'RS',4308409,2206.0,2206,183.8,183.8,1,215.0,215.0,Pequeno I
4739,4777,430843,506,262,22,90,112,150,462.25,251.83,16.58,80.92,97.5,154.33,5547,3022,199,971,1170,1852,2022,'FORQUETINHA',Forquetinha,'RS',4308433,502.0,502,41.8,41.8,1,43.0,43.0,Pequeno I
4740,4778,430845,1345,994,142,558,700,294,1259.42,951.83,107.17,544.08,651.25,300.58,15113,11422,1286,6529,7815,3607,2022,'FORTALEZA DOS VALOS',Fortaleza Dos Valos,'RS',4308458,1585.0,1585,144.1,144.1,1,,,Pequeno I
4741,4779,430850,7158,5482,1623,1389,3012,2470,6762.5,5285.67,1357.0,1684.5,3041.5,2244.17,81150,63428,16284,20214,36498,26930,2022,'FREDERICO WESTPHALEN',Frederico Westphalen,'RS',4308508,12199.0,12199,1016.6,1016.6,1,732.0,732.0,Pequeno II
4742,4780,430860,3221,1912,368,691,1059,853,2766.08,1645.25,280.33,637.58,917.92,727.33,33193,19743,3364,7651,11015,8728,2022,'GARIBALDI',Garibaldi,'RS',4308607,2503.0,2503,208.6,208.6,1,205.0,205.0,Pequeno II
4743,4781,430865,1621,1135,311,246,557,578,1518.75,1116.67,304.17,238.75,542.92,573.75,18225,13400,3650,2865,6515,6885,2022,'GARRUCHOS',Garruchos,'RS',4308656,1180.0,1180,107.3,107.3,1,,,Pequeno I
4744,4782,430870,1626,817,167,136,303,514,1597.25,840.5,157.92,169.17,327.08,513.42,19167,10086,1895,2030,3925,6161,2022,'GAURAMA',Gaurama,'RS',4308706,2638.0,2638,219.8,219.8,1,176.0,176.0,Pequeno I
4745,4783,430880,3800,2955,415,1847,2262,693,3651.42,2886.25,387.92,1764.67,2152.58,733.67,43817,34635,4655,21176,25831,8804,2022,'GENERAL CAMARA',General Câmara,'RS',4308805,2588.0,2588,215.7,215.7,1,147.0,147.0,Pequeno I
4746,4784,430885,538,378,32,251,283,95,486.92,326.25,33.92,201.67,235.58,90.67,5843,3915,407,2420,2827,1088,2022,'GENTIL',Gentil,'RS',4308854,249.0,249,27.7,27.7,1,60.0,60.0,Pequeno I
4747,4785,430890,3148,2331,526,216,742,1589,2938.0,2217.58,404.67,297.92,702.58,1515.0,35256,26611,4856,3575,8431,18180,2022,'GETULIO VARGAS',Getúlio Vargas,'RS',4308904,2264.0,2264,188.7,188.7,1,207.0,207.0,Pequeno I
4748,4786,430900,7657,6032,396,4105,4501,1531,7261.92,5810.0,421.58,3947.58,4369.17,1440.83,87143,69720,5059,47371,52430,17290,2022,'GIRUA',Giruá,'RS',4309001,2803.0,2803,233.6,233.6,1,235.0,235.0,Pequeno I
4749,4787,430905,2691,2011,394,733,1127,884,2515.75,1915.08,367.33,724.5,1091.83,823.25,30189,22981,4408,8694,13102,9879,2022,'GLORINHA',Glorinha,'RS',4309050,3404.0,3404,283.7,283.7,1,228.0,228.0,Pequeno I
4750,4788,430910,6915,5526,1013,2192,3205,2321,6513.58,5336.83,938.0,2267.0,3205.0,2131.83,78163,64042,11256,27204,38460,25582,2022,'GRAMADO',Gramado,'RS',4309100,10303.0,10303,858.6,858.6,2,620.0,620.0,Pequeno II
4751,4789,430912,1637,1165,163,655,818,347,1541.25,1171.5,116.25,719.75,836.0,335.5,18495,14058,1395,8637,10032,4026,2022,'GRAMADO DOS LOUREIROS',Gramado Dos Loureiros,'RS',4309126,1122.0,1122,93.5,93.5,1,71.0,71.0,Pequeno I
4752,4790,430915,1714,1206,369,301,670,536,1631.17,1239.5,387.08,356.5,743.58,495.92,19574,14874,4645,4278,8923,5951,2022,'GRAMADO XAVIER',Gramado Xavier,'RS',4309159,705.0,705,58.8,58.8,1,16.0,16.0,Pequeno I
4753,4791,430920,77980,67027,8791,41388,50179,16848,70369.33,60715.08,7836.67,37784.25,45620.92,15094.17,844432,728581,94040,453411,547451,181130,2022,'GRAVATAI',Gravataí,'RS',4309209,52172.0,52172,4347.7,4347.7,5,3374.0,3374.0,Grande
4754,4792,430925,222,134,19,64,83,51,203.83,119.42,13.25,57.75,71.0,48.42,2446,1433,159,693,852,581,2022,'GUABIJU',Guabiju,'RS',4309258,250.0,250,22.7,22.7,1,,,Pequeno I
4755,4793,430930,32179,26238,3350,15418,18768,7470,29211.08,23565.08,3344.83,12833.0,16177.83,7387.25,350533,282781,40138,153996,194134,88647,2022,'GUAIBA',Guaíba,'RS',4309308,5489.0,5489,457.4,457.4,2,539.0,539.0,Médio
4756,4794,430940,3680,2732,639,922,1561,1171,3247.17,2395.42,537.92,798.25,1336.17,1059.25,38966,28745,6455,9579,16034,12711,2022,'GUAPORE',Guaporé,'RS',4309407,1928.0,1928,160.7,160.7,1,95.0,95.0,Pequeno II
4757,4795,430950,2124,1551,151,1031,1182,369,2026.58,1480.17,143.0,968.83,1111.83,368.33,24319,17762,1716,11626,13342,4420,2022,'GUARANI DAS MISSOES',Guarani Das Missões,'RS',4309506,1559.0,1559,129.9,129.9,1,136.0,136.0,Pequeno I
4758,4796,430955,1252,376,66,88,154,222,1158.25,353.75,64.92,87.92,152.83,200.92,13899,4245,779,1055,1834,2411,2022,'HARMONIA',Harmonia,'RS',4309555,1642.0,1642,136.8,136.8,1,182.0,182.0,Pequeno I
4759,4797,430957,691,625,119,347,466,159,623.0,575.75,107.42,343.33,450.75,125.0,7476,6909,1289,4120,5409,1500,2022,'HERVEIRAS',Herveiras,'RS',4309571,418.0,418,34.8,34.8,1,26.0,26.0,Pequeno I
4760,4798,430960,3847,2606,661,789,1450,1156,3645.75,2485.5,579.67,866.5,1446.17,1039.33,43749,29826,6956,10398,17354,12472,2022,'HORIZONTINA',Horizontina,'RS',4309605,2528.0,2528,210.7,210.7,1,239.0,239.0,Pequeno I
4761,4799,430965,4053,3479,162,2705,2867,612,3882.08,3349.33,152.08,2596.5,2748.58,600.75,46585,40192,1825,31158,32983,7209,2022,'HULHA NEGRA',Hulha Negra,'RS',4309654,0.0,18987,0.0,1582.2,1,0.0,1504.0,Pequeno I
4762,4800,430970,1061,704,113,307,420,284,990.58,650.0,100.42,304.08,404.5,245.5,11887,7800,1205,3649,4854,2946,2022,'HUMAITA',Humaitá,'RS',4309704,2599.0,2599,216.6,216.6,1,242.0,242.0,Pequeno I
4763,4801,430975,1594,1278,248,430,678,600,1563.92,1273.92,244.58,506.17,750.75,523.17,18767,15287,2935,6074,9009,6278,2022,'IBARAMA',Ibarama,'RS',4309753,643.0,643,53.6,53.6,1,28.0,28.0,Pequeno I
4764,4802,430980,1143,754,117,320,437,317,1025.92,698.5,84.58,321.08,405.67,292.83,12311,8382,1015,3853,4868,3514,2022,'IBIACA',Ibiaçá,'RS',4309803,1236.0,1236,112.4,112.4,1,35.0,35.0,Pequeno I
4765,4803,430990,1909,1429,233,651,884,545,1810.42,1360.67,233.17,601.67,834.83,525.83,21725,16328,2798,7220,10018,6310,2022,'IBIRAIARAS',Ibiraiaras,'RS',4309902,2280.0,2280,190.0,190.0,1,183.0,183.0,Pequeno I
4766,4804,430995,1551,1240,200,649,849,391,1503.08,1230.33,180.17,651.5,831.67,398.67,18037,14764,2162,7818,9980,4784,2022,'IBIRAPUITA',Ibirapuitã,'RS',4309951,1055.0,1055,87.9,87.9,1,92.0,92.0,Pequeno I
4767,4805,431000,3779,1954,329,150,479,1475,3584.92,1941.17,375.5,144.92,520.42,1420.75,43019,23294,4506,1739,6245,17049,2022,'IBIRUBA',Ibirubá,'RS',4310009,4523.0,4523,376.9,376.9,1,250.0,250.0,Pequeno I
4768,4806,431010,7985,6335,1294,2002,3296,3039,7274.83,5896.92,1255.42,1773.33,3028.75,2868.17,87298,70763,15065,21280,36345,34418,2022,'IGREJINHA',Igrejinha,'RS',4310108,2986.0,2986,248.8,248.8,1,205.0,205.0,Pequeno II
4769,4807,431020,22160,15381,2859,6300,9159,6222,19910.5,14266.75,2788.33,5522.67,8311.0,5955.75,238926,171201,33460,66272,99732,71469,2022,'IJUI',Ijuí,'RS',4310207,7362.0,76876,613.5,6406.3,2,379.0,7182.0,Médio
4770,4808,431030,1041,620,145,78,223,397,1010.0,619.33,145.75,94.33,240.08,379.25,12120,7432,1749,1132,2881,4551,2022,'ILOPOLIS',Ilópolis,'RS',4310306,553.0,553,46.1,46.1,1,31.0,31.0,Pequeno I
4771,4809,431033,11292,8679,1895,3188,5083,3596,10456.08,8091.5,1706.08,3103.5,4809.58,3281.92,125473,97098,20473,37242,57715,39383,2022,'IMBE',Imbé,'RS',4310330,7323.0,7323,610.2,610.2,1,708.0,708.0,Pequeno I
4772,4810,431036,767,228,8,62,70,158,748.67,223.75,13.25,56.67,69.92,153.83,8984,2685,159,680,839,1846,2022,'IMIGRANTE',Imigrante,'RS',4310363,630.0,630,52.5,52.5,1,41.0,41.0,Pequeno I
4773,4812,431041,1112,849,165,339,504,345,1096.83,867.92,136.92,413.25,550.17,317.75,13162,10415,1643,4959,6602,3813,2022,'INHACORA',Inhacorá,'RS',4310413,874.0,874,72.8,72.8,1,20.0,20.0,Pequeno I
4774,4813,431043,1218,848,109,447,556,292,1035.25,719.5,113.58,362.67,476.25,243.25,12423,8634,1363,4352,5715,2919,2022,'IPE',Ipê,'RS',4310439,965.0,965,80.4,80.4,1,71.0,71.0,Pequeno I
4775,4814,431046,308,143,22,23,45,98,292.08,136.08,19.58,21.5,41.08,95.0,3505,1633,235,258,493,1140,2022,'IPIRANGA DO SUL',Ipiranga do Sul,'RS',4310462,278.0,278,30.9,30.9,1,,,Pequeno I
4776,4815,431050,3428,2747,449,1501,1950,797,3387.25,2724.75,458.5,1453.58,1912.08,812.67,40647,32697,5502,17443,22945,9752,2022,'IRAI',Iraí,'RS',4310504,1245.0,1245,103.8,103.8,1,51.0,51.0,Pequeno I
4777,4816,431053,2037,1292,270,334,604,688,1927.92,1251.58,246.5,344.83,591.33,660.25,23135,15019,2958,4138,7096,7923,2022,'ITAARA',Itaara,'RS',4310538,3984.0,3984,332.0,332.0,1,345.0,345.0,Pequeno I
4778,4817,431055,1619,1355,143,930,1073,282,1557.83,1327.92,117.67,953.75,1071.42,256.5,18694,15935,1412,11445,12857,3078,2022,'ITACURUBI',Itacurubi,'RS',4310553,1050.0,1050,87.5,87.5,1,94.0,94.0,Pequeno I
4779,4818,431057,712,480,107,159,266,214,685.58,460.92,103.25,159.0,262.25,198.67,8227,5531,1239,1908,3147,2384,2022,'ITAPUCA',Itapuca,'RS',4310579,526.0,526,43.8,43.8,1,7.0,7.0,Pequeno I
4780,4819,431060,15974,12494,3186,4306,7492,5002,15374.83,12054.42,2953.67,4072.5,7026.17,5028.25,184498,144653,35444,48870,84314,60339,2022,'ITAQUI',Itaqui,'RS',4310603,5875.0,5875,489.6,489.6,1,480.0,480.0,Pequeno II
4781,4820,431065,1319,990,153,499,652,338,1129.83,912.25,134.42,467.17,601.58,310.67,13558,10947,1613,5606,7219,3728,2022,'ITATI',Itati,'RS',4310652,3526.0,3526,293.8,293.8,1,299.0,299.0,Pequeno I
4782,4822,431075,835,517,121,191,312,205,740.58,476.83,116.92,159.67,276.58,200.25,8887,5722,1403,1916,3319,2403,2022,'IVORA',Ivorá,'RS',4310751,1907.0,1907,158.9,158.9,1,65.0,65.0,Pequeno I
4783,4823,431080,2024,1533,254,439,693,840,1755.92,1353.67,233.92,440.42,674.33,679.33,21071,16244,2807,5285,8092,8152,2022,'IVOTI',Ivoti,'RS',4310801,3098.0,3098,258.2,258.2,1,334.0,334.0,Pequeno I
4784,4824,431085,2280,1330,173,564,737,593,2195.17,1413.5,161.17,685.92,847.08,566.42,26342,16962,1934,8231,10165,6797,2022,'JABOTICABA',Jaboticaba,'RS',4310850,2887.0,2887,240.6,240.6,1,167.0,167.0,Pequeno I
4785,4825,431087,1261,1059,144,624,768,291,1224.42,1033.75,134.08,599.42,733.5,300.25,14693,12405,1609,7193,8802,3603,2022,'JACUIZINHO',Jacuizinho,'RS',4310876,276.0,276,23.0,23.0,1,32.0,32.0,Pequeno I
4786,4826,431090,1094,562,88,114,202,360,1043.33,545.33,92.83,131.58,224.42,320.92,12520,6544,1114,1579,2693,3851,2022,'JACUTINGA',Jacutinga,'RS',4310900,1054.0,1054,87.8,87.8,1,20.0,20.0,Pequeno I
4787,4827,431100,10405,8556,861,5595,6456,2100,9174.42,7543.5,794.0,4745.67,5539.67,2003.83,110093,90522,9528,56948,66476,24046,2022,'JAGUARAO',Jaguarão,'RS',4311007,9126.0,9126,760.5,760.5,2,959.0,959.0,Pequeno II
4788,4828,431110,3834,2915,456,1375,1831,1084,3595.0,2751.25,471.0,1268.67,1739.67,1011.58,43140,33015,5652,15224,20876,12139,2022,'JAGUARI',Jaguari,'RS',4311106,1392.0,1392,116.0,116.0,1,151.0,151.0,Pequeno I
4789,4829,431112,1869,1632,227,1043,1270,362,1796.0,1586.5,214.83,1015.25,1230.08,356.42,21552,19038,2578,12183,14761,4277,2022,'JAQUIRANA',Jaquirana,'RS',4311122,4228.0,4228,352.3,352.3,1,196.0,196.0,Pequeno I
4790,4831,431115,3159,2642,382,1664,2046,596,2944.33,2500.42,300.75,1600.33,1901.08,599.33,35332,30005,3609,19204,22813,7192,2022,'JOIA',Jóia,'RS',4311155,2766.0,2766,230.5,230.5,1,135.0,135.0,Pequeno I
4791,4832,431120,7834,5860,1438,1978,3416,2444,7524.0,5751.25,1451.67,1884.92,3336.58,2414.67,90288,69015,17420,22619,40039,28976,2022,'JULIO DE CASTILHOS',Júlio de Castilhos,'RS',4311205,3236.0,3236,269.7,269.7,1,225.0,225.0,Pequeno I
4792,4833,431123,1037,753,128,360,488,265,1028.0,757.58,132.5,393.25,525.75,231.83,12336,9091,1590,4719,6309,2782,2022,'LAGOA BONITA DO SUL',Lagoa Bonita do Sul,'RS',4311239,577.0,577,48.1,48.1,1,38.0,38.0,Pequeno I
4793,4834,431125,3387,2617,735,1305,2040,577,3156.0,2562.25,731.67,1274.33,2006.0,556.25,37872,30747,8780,15292,24072,6675,2022,'LAGOAO',Lagoão,'RS',4311254,3668.0,3668,305.7,305.7,1,379.0,379.0,Pequeno I
4794,4835,431127,636,218,29,31,60,158,585.42,222.42,27.0,30.42,57.42,165.0,7025,2669,324,365,689,1980,2022,'LAGOA DOS TRES CANTOS',Lagoa Dos Três Cantos,'RS',4311270,1077.0,1077,89.8,89.8,1,38.0,38.0,Pequeno I
4795,4836,431130,9226,7827,1404,3855,5259,2568,8649.75,7365.08,1136.58,3928.08,5064.67,2300.42,103797,88381,13639,47137,60776,27605,2022,'LAGOA VERMELHA',Lagoa Vermelha,'RS',4311304,1760.0,1760,146.7,146.7,1,57.0,57.0,Pequeno II
4796,4837,431140,16471,11221,1593,4357,5950,5271,15297.0,10743.25,1453.08,4073.58,5526.67,5216.58,183564,128919,17437,48883,66320,62599,2022,'LAJEADO',Lajeado,'RS',4311403,12488.0,12488,1040.7,1040.7,2,820.0,820.0,Médio
4797,4838,431142,1735,1425,226,906,1132,293,1588.83,1326.25,204.67,852.25,1056.92,269.33,19066,15915,2456,10227,12683,3232,2022,'LAJEADO DO BUGRE',Lajeado do Bugre,'RS',4311429,977.0,977,81.4,81.4,1,50.0,50.0,Pequeno I
4798,4839,431150,3023,2422,389,1215,1604,818,2920.58,2381.0,408.08,1170.75,1578.83,802.17,35047,28572,4897,14049,18946,9626,2022,'LAVRAS DO SUL',Lavras do Sul,'RS',4311502,4105.0,4105,342.1,342.1,1,488.0,488.0,Pequeno I
4799,4840,431160,2010,1470,394,419,813,657,1972.83,1453.67,344.58,412.08,756.67,697.0,23674,17444,4135,4945,9080,8364,2022,'LIBERATO SALZANO',Liberato Salzano,'RS',4311601,1843.0,1843,153.6,153.6,1,70.0,70.0,Pequeno I
4800,4841,431162,1606,1228,146,658,804,424,1537.83,1137.0,128.67,579.5,708.17,428.83,18454,13644,1544,6954,8498,5146,2022,'LINDOLFO COLLOR',Lindolfo Collor,'RS',4311627,1959.0,1959,178.1,178.1,1,260.0,260.0,Pequeno I
4801,4843,431170,1410,1118,296,229,525,593,1336.92,1067.58,291.92,275.67,567.58,500.0,16043,12811,3503,3308,6811,6000,2022,'MACHADINHO',Machadinho,'RS',4311700,2226.0,2226,185.5,185.5,1,72.0,72.0,Pequeno I
4802,4844,431171,2210,1992,351,1414,1765,227,1956.67,1776.92,311.0,1214.0,1525.0,251.92,23480,21323,3732,14568,18300,3023,2022,'MACAMBARA',Maçambara,'RS',4311718,1037.0,1037,94.3,94.3,1,,,Pequeno I
4803,4845,431173,1337,1102,390,295,685,417,1274.83,1068.33,366.67,322.17,688.83,379.5,15298,12820,4400,3866,8266,4554,2022,'MAMPITUBA',Mampituba,'RS',4311734,584.0,584,48.7,48.7,1,28.0,28.0,Pequeno I
4804,4846,431175,3477,2424,342,1041,1383,1041,3310.92,2376.33,348.25,977.67,1325.92,1050.42,39731,28516,4179,11732,15911,12605,2022,'MANOEL VIANA',Manoel Viana,'RS',4311759,321.0,321,160.5,160.5,1,0.0,0.0,Pequeno I
4805,4847,431177,2722,2270,482,1201,1683,587,2494.83,2129.33,416.58,1207.17,1623.75,505.58,29938,25552,4999,14486,19485,6067,2022,'MAQUINE',Maquiné,'RS',4311775,781.0,781,65.1,65.1,1,55.0,55.0,Pequeno I
4806,4848,431179,832,362,75,104,179,183,786.33,330.58,67.33,101.5,168.83,161.75,9436,3967,808,1218,2026,1941,2022,'MARATA',Maratá,'RS',4311791,722.0,722,60.2,60.2,1,69.0,69.0,Pequeno I
4807,4849,431180,7081,4872,1088,898,1986,2886,6470.58,4528.67,1030.17,1021.92,2052.08,2476.58,77647,54344,12362,12263,24625,29719,2022,'MARAU',Marau,'RS',4311809,8261.0,8261,688.4,688.4,1,845.0,845.0,Pequeno II
4808,4850,431190,1691,818,89,128,217,601,1643.75,823.83,108.08,159.5,267.58,556.25,19725,9886,1297,1914,3211,6675,2022,'MARCELINO RAMOS',Marcelino Ramos,'RS',4311908,1202.0,1202,100.2,100.2,1,123.0,123.0,Pequeno I
4809,4851,431198,1329,1155,264,473,737,418,1270.5,1116.17,278.75,482.33,761.08,355.08,15246,13394,3345,5788,9133,4261,2022,'MARIANA PIMENTEL',Mariana Pimentel,'RS',4311981,1320.0,1320,110.0,110.0,1,104.0,104.0,Pequeno I
4810,4852,431200,953,316,57,44,101,215,942.5,306.5,63.08,39.25,102.33,204.17,11310,3678,757,471,1228,2450,2022,'MARIANO MORO',Mariano Moro,'RS',4312005,341.0,341,28.4,28.4,1,13.0,13.0,Pequeno I
4811,4853,431205,717,450,131,128,259,191,657.17,409.0,124.42,119.83,244.25,164.75,7886,4908,1493,1438,2931,1977,2022,'MARQUES DE SOUZA',Marques de Souza,'RS',4312054,1601.0,1601,133.4,133.4,1,125.0,125.0,Pequeno I
4812,4854,431210,1703,1459,307,746,1053,406,1613.5,1400.92,309.5,704.08,1013.58,387.33,19362,16811,3714,8449,12163,4648,2022,'MATA',Mata,'RS',4312104,700.0,700,58.3,58.3,1,60.0,60.0,Pequeno I
4813,4855,431213,805,650,63,302,365,285,774.17,631.83,41.75,326.17,367.92,263.92,9290,7582,501,3914,4415,3167,2022,'MATO CASTELHANO',Mato Castelhano,'RS',4312138,999.0,999,83.2,83.2,1,75.0,75.0,Pequeno I
4814,4856,431215,1680,1033,129,457,586,447,1614.33,1001.25,115.0,466.0,581.0,420.25,19372,12015,1380,5592,6972,5043,2022,'MATO LEITAO',Mato Leitão,'RS',4312153,1821.0,1821,151.8,151.8,1,117.0,117.0,Pequeno I
4815,4857,431217,500,370,85,137,222,148,472.08,356.42,86.58,138.67,225.25,131.17,5665,4277,1039,1664,2703,1574,2022,'MATO QUEIMADO',Mato Queimado,'RS',4312179,383.0,383,31.9,31.9,1,10.0,10.0,Pequeno I
4816,4858,431220,1678,1206,261,543,804,402,1579.42,1132.5,176.92,533.08,710.0,422.5,18953,13590,2123,6397,8520,5070,2022,'MAXIMILIANO DE ALMEIDA',Maximiliano de Almeida,'RS',4312203,2488.0,2488,207.3,207.3,1,131.0,131.0,Pequeno I
4817,4859,431225,4015,3329,384,2219,2603,726,3806.17,3203.42,311.83,2209.67,2521.5,681.92,45674,38441,3742,26516,30258,8183,2022,'MINAS DO LEAO',Minas do Leão,'RS',4312252,1200.0,1200,100.0,100.0,1,142.0,142.0,Pequeno I
4818,4860,431230,2244,1739,405,718,1123,616,2117.08,1720.17,375.83,795.33,1171.17,549.0,25405,20642,4510,9544,14054,6588,2022,'MIRAGUAI',Miraguaí,'RS',4312302,3643.0,3643,303.6,303.6,1,129.0,129.0,Pequeno I
4819,4861,431235,554,92,0,20,20,72,520.83,88.42,1.08,19.75,20.83,67.58,6250,1061,13,237,250,811,2022,'MONTAURI',Montauri,'RS',4312351,257.0,257,21.4,21.4,1,10.0,10.0,Pequeno I
4820,4862,431237,1252,1025,166,500,666,359,1195.5,1009.42,186.92,467.5,654.42,355.0,14346,12113,2243,5610,7853,4260,2022,'MONTE ALEGRE DOS CAMPOS',Monte Alegre Dos Campos,'RS',4312377,547.0,547,54.7,54.7,1,,,Pequeno I
4821,4864,431240,14716,12679,1651,7648,9299,3380,13276.58,11512.67,1444.5,7035.58,8480.08,3032.58,159319,138152,17334,84427,101761,36391,2022,'MONTENEGRO',Montenegro,'RS',4312401,4955.0,4955,450.5,450.5,1,183.0,183.0,Médio
4822,4865,431242,853,714,111,411,522,192,766.0,676.0,84.83,457.92,542.75,133.25,9192,8112,1018,5495,6513,1599,2022,'MORMACO',Mormaço,'RS',4312427,873.0,873,72.8,72.8,1,85.0,85.0,Pequeno I
4823,4866,431244,1088,635,103,248,351,284,1026.58,601.25,87.25,216.08,303.33,297.92,12319,7215,1047,2593,3640,3575,2022,'MORRINHOS DO SUL',Morrinhos do Sul,'RS',4312443,665.0,665,55.4,55.4,1,35.0,35.0,Pequeno I
4824,4867,431245,3470,2532,259,1189,1448,1084,3336.92,2476.92,207.75,1249.17,1456.92,1020.0,40043,29723,2493,14990,17483,12240,2022,'MORRO REDONDO',Morro Redondo,'RS',4312450,4578.0,4578,381.5,381.5,1,161.0,161.0,Pequeno I
4825,4868,431247,772,547,91,216,307,240,739.17,515.0,90.58,215.58,306.17,208.83,8870,6180,1087,2587,3674,2506,2022,'MORRO REUTER',Morro Reuter,'RS',4312476,498.0,498,41.5,41.5,1,46.0,46.0,Pequeno I
4826,4869,431250,5274,4499,988,2312,3300,1199,4869.42,4216.67,884.67,2306.25,3190.92,1025.75,58433,50600,10616,27675,38291,12309,2022,'MOSTARDAS',Mostardas,'RS',4312500,1298.0,1298,118.0,118.0,1,88.0,88.0,Pequeno I
4827,4870,431260,999,691,93,253,346,345,878.5,617.0,88.75,223.58,312.33,304.67,10542,7404,1065,2683,3748,3656,2022,'MUCUM',Muçum,'RS',4312609,321.0,321,26.8,26.8,1,36.0,36.0,Pequeno I
4828,4871,431261,925,817,101,421,522,295,888.67,790.17,102.33,417.58,519.92,270.25,10664,9482,1228,5011,6239,3243,2022,'MUITOS CAPOES',Muitos Capões,'RS',4312617,1763.0,1763,146.9,146.9,1,165.0,165.0,Pequeno I
4829,4872,431262,888,543,105,259,364,179,902.17,549.58,81.17,295.17,376.33,173.25,10826,6595,974,3542,4516,2079,2022,'MULITERNO',Muliterno,'RS',4312625,936.0,936,78.0,78.0,1,21.0,21.0,Pequeno I
4830,4873,431265,4234,2004,387,472,859,1145,4068.75,2055.92,359.42,521.0,880.42,1175.5,48825,24671,4313,6252,10565,14106,2022,'NAO-ME-TOQUE',Não-me-toque,'RS',4312658,4050.0,4050,337.5,337.5,1,277.0,277.0,Pequeno I
4831,4874,431267,709,508,72,284,356,152,671.5,483.33,52.33,295.17,347.5,135.83,8058,5800,628,3542,4170,1630,2022,'NICOLAU VERGUEIRO',Nicolau Vergueiro,'RS',4312674,1562.0,1562,130.2,130.2,1,164.0,164.0,Pequeno I
4832,4875,431270,7201,4513,1137,1465,2602,1911,6820.58,4364.58,1005.42,1460.17,2465.58,1899.0,81847,52375,12065,17522,29587,22788,2022,'NONOAI',Nonoai,'RS',4312708,0.0,19021,0.0,1585.1,1,0.0,1256.0,Pequeno I
4833,4876,431275,472,330,68,160,228,102,427.0,292.17,67.58,116.25,183.83,108.33,5124,3506,811,1395,2206,1300,2022,'NOVA ALVORADA',Nova Alvorada,'RS',4312757,491.0,491,40.9,40.9,1,28.0,28.0,Pequeno I
4834,4877,431280,912,479,88,95,183,296,734.25,355.5,60.67,45.0,105.67,249.83,8811,4266,728,540,1268,2998,2022,'NOVA ARACA',Nova Araçá,'RS',4312807,3011.0,3011,250.9,250.9,1,270.0,270.0,Pequeno I
4835,4878,431290,1253,884,173,135,308,576,1168.42,833.25,185.75,130.08,315.83,517.42,14021,9999,2229,1561,3790,6209,2022,'NOVA BASSANO',Nova Bassano,'RS',4312906,5040.0,5040,420.0,420.0,1,282.0,282.0,Pequeno I
4836,4880,431300,898,282,44,72,116,166,866.25,256.67,31.17,76.92,108.08,148.58,10395,3080,374,923,1297,1783,2022,'NOVA BRESCIA',Nova Bréscia,'RS',4313003,1068.0,1068,89.0,89.0,1,79.0,79.0,Pequeno I
4837,4881,431301,838,258,42,25,67,191,828.75,252.5,45.33,24.5,69.83,182.67,9945,3030,544,294,838,2192,2022,'NOVA CANDELARIA',Nova Candelária,'RS',4313011,1223.0,1223,101.9,101.9,1,59.0,59.0,Pequeno I
4838,4882,431303,1875,1244,106,463,569,675,1771.17,1214.83,98.58,465.42,564.0,650.83,21254,14578,1183,5585,6768,7810,2022,'NOVA ESPERANCA DO SUL',Nova Esperança do Sul,'RS',4313037,1158.0,1158,96.5,96.5,1,77.0,77.0,Pequeno I
4839,4883,431306,6270,4438,655,1634,2289,2149,5948.58,4348.92,561.42,1716.25,2277.67,2071.25,71383,52187,6737,20595,27332,24855,2022,'NOVA HARTZ',Nova Hartz,'RS',4313060,3481.0,3481,290.1,290.1,1,142.0,142.0,Pequeno I
4840,4885,431310,1573,1143,182,517,699,444,1541.17,1176.33,176.17,533.5,709.67,466.67,18494,14116,2114,6402,8516,5600,2022,'NOVA PALMA',Nova Palma,'RS',4313102,696.0,696,58.0,58.0,1,35.0,35.0,Pequeno I
4841,4886,431320,2202,1500,264,414,678,822,2077.67,1415.92,254.83,396.83,651.67,764.25,24932,16991,3058,4762,7820,9171,2022,'NOVA PETROPOLIS',Nova Petrópolis,'RS',4313201,3400.0,3400,283.3,283.3,1,238.0,238.0,Pequeno I
4842,4887,431330,5170,3376,460,1526,1986,1390,4687.92,3035.0,459.17,1255.42,1714.58,1320.42,56255,36420,5510,15065,20575,15845,2022,'NOVA PRATA',Nova Prata,'RS',4313300,3188.0,3188,265.7,265.7,1,460.0,460.0,Pequeno II
4843,4888,431333,637,396,67,109,176,220,604.75,377.5,57.83,114.33,172.17,205.33,7257,4530,694,1372,2066,2464,2022,'NOVA RAMADA',Nova Ramada,'RS',4313334,1283.0,1283,106.9,106.9,1,79.0,79.0,Pequeno I
4844,4890,431337,10531,9357,707,7286,7993,1364,8932.83,7856.33,793.0,5664.5,6457.5,1398.83,107194,94276,9516,67974,77490,16786,2022,'NOVA SANTA RITA',Nova Santa Rita,'RS',4313375,4746.0,4746,395.5,395.5,1,538.0,538.0,Pequeno II
4845,4891,431339,1292,979,240,371,611,368,1221.25,985.0,222.08,418.0,640.08,344.92,14655,11820,2665,5016,7681,4139,2022,'NOVO CABRAIS',Novo Cabrais,'RS',4313391,1233.0,1233,102.8,102.8,1,150.0,150.0,Pequeno I
4846,4892,431340,53876,42847,6781,20939,27720,15127,50060.58,40067.58,6281.83,19540.5,25822.33,14245.25,600727,480811,75382,234486,309868,170943,2022,'NOVO HAMBURGO',Novo Hamburgo,'RS',4313409,11602.0,11602,966.8,966.8,5,1061.0,1061.0,Grande
4847,4893,431342,1051,850,124,556,680,170,1016.17,825.58,99.58,575.33,674.92,150.67,12194,9907,1195,6904,8099,1808,2022,'NOVO MACHADO',Novo Machado,'RS',4313425,2558.0,2558,213.2,213.2,1,221.0,221.0,Pequeno I
4848,4894,431344,1032,657,99,343,442,215,1032.42,688.92,102.83,332.67,435.5,253.42,12389,8267,1234,3992,5226,3041,2022,'NOVO TIRADENTES',Novo Tiradentes,'RS',4313441,962.0,962,80.2,80.2,1,65.0,65.0,Pequeno I
4849,4895,431346,596,266,57,42,99,167,578.67,270.67,48.25,42.25,90.5,180.17,6944,3248,579,507,1086,2162,2022,'NOVO XINGU',Novo Xingu,'RS',4313466,1270.0,1270,105.8,105.8,1,152.0,152.0,Pequeno I
4850,4896,431349,2500,1749,302,964,1266,483,2246.75,1585.25,266.0,834.58,1100.58,484.67,26961,19023,3192,10015,13207,5816,2022,'NOVO BARREIRO',Novo Barreiro,'RS',4313490,4685.0,4685,390.4,390.4,1,380.0,380.0,Pequeno I
4851,4897,431350,13769,11649,1697,6648,8345,3304,12638.5,10719.58,1460.67,6127.42,7588.08,3131.5,151662,128635,17528,73529,91057,37578,2022,'OSORIO',Osório,'RS',4313508,3338.0,3338,278.2,278.2,1,203.0,203.0,Pequeno II
4852,4898,431360,1555,913,286,237,523,390,1469.58,883.75,264.08,226.58,490.67,393.08,17635,10605,3169,2719,5888,4717,2022,'PAIM FILHO',Paim Filho,'RS',4313607,1208.0,1208,100.7,100.7,1,34.0,34.0,Pequeno I
4853,4899,431365,5861,5033,334,3973,4307,726,5417.25,4703.5,301.17,3706.5,4007.67,695.83,65007,56442,3614,44478,48092,8350,2022,'PALMARES DO SUL',Palmares do Sul,'RS',4313656,3396.0,3396,283.0,283.0,1,456.0,456.0,Pequeno I
4854,4900,431370,13529,11072,2258,5724,7982,3090,12631.92,10420.0,2061.0,5462.42,7523.42,2896.58,151583,125040,24732,65549,90281,34759,2022,'PALMEIRA DAS MISSOES',Palmeira Das Missões,'RS',4313706,10958.0,10958,913.2,913.2,1,1201.0,1201.0,Pequeno II
4855,4901,431380,2774,2413,532,1312,1844,569,2600.17,2276.58,406.08,1327.83,1733.92,542.67,31202,27319,4873,15934,20807,6512,2022,'PALMITINHO',Palmitinho,'RS',4313805,4005.0,4005,333.8,333.8,1,249.0,249.0,Pequeno I
4856,4902,431390,7703,5671,700,2711,3411,2260,7312.92,5427.08,683.42,2566.25,3249.67,2177.42,87755,65125,8201,30795,38996,26129,2022,'PANAMBI',Panambi,'RS',4313904,3985.0,3985,332.1,332.1,2,293.0,293.0,Pequeno II
4857,4903,431395,4477,3764,398,2522,2920,844,4022.92,3394.58,416.25,2188.25,2604.5,790.08,48275,40735,4995,26259,31254,9481,2022,'PANTANO GRANDE',Pantano Grande,'RS',4313953,2947.0,2947,245.6,245.6,1,294.0,294.0,Pequeno I
4858,4904,431400,1017,635,124,110,234,401,933.42,603.75,119.08,104.25,223.33,380.42,11201,7245,1429,1251,2680,4565,2022,'PARAI',Paraí,'RS',4314001,470.0,470,39.2,39.2,1,32.0,32.0,Pequeno I
4859,4905,431402,2248,1824,237,1163,1400,424,2143.33,1758.17,229.5,1158.92,1388.42,369.75,25720,21098,2754,13907,16661,4437,2022,'PARAISO DO SUL',Paraíso do Sul,'RS',4314027,964.0,964,96.4,96.4,1,,,Pequeno I
4860,4906,431403,634,522,151,160,311,211,605.92,509.17,127.42,192.67,320.08,189.08,7271,6110,1529,2312,3841,2269,2022,'PARECI NOVO',Pareci Novo,'RS',4314035,1207.0,1207,109.7,109.7,1,,,Pequeno I
4861,4907,431405,16823,14254,2722,6470,9192,5062,15068.67,12982.83,2410.83,6073.33,8484.17,4498.67,180824,155794,28930,72880,101810,53984,2022,'PAROBE',Parobé,'RS',4314050,2920.0,2920,243.3,243.3,1,90.0,90.0,Médio
4862,4908,431406,1757,1242,295,447,742,500,1688.08,1247.58,272.58,506.83,779.42,468.17,20257,14971,3271,6082,9353,5618,2022,'PASSA SETE',Passa Sete,'RS',4314068,2149.0,2149,179.1,179.1,1,187.0,187.0,Pequeno I
4863,4909,431407,1619,1133,175,499,674,459,1513.0,1161.75,167.08,676.33,843.42,318.33,18156,13941,2005,8116,10121,3820,2022,'PASSO DO SOBRADO',Passo do Sobrado,'RS',4314076,1664.0,1664,138.7,138.7,1,135.0,135.0,Pequeno I
4864,4910,431410,54373,43068,6653,23088,29741,13327,50011.5,39801.75,5939.5,21312.75,27252.25,12549.5,600138,477621,71274,255753,327027,150594,2022,'PASSO FUNDO',Passo Fundo,'RS',4314100,45400.0,45400,3783.3,3783.3,4,4145.0,4145.0,Grande
4865,4911,431413,793,216,21,60,81,135,740.83,211.5,22.83,49.92,72.75,138.75,8890,2538,274,599,873,1665,2022,'PAULO BENTO',Paulo Bento,'RS',4314134,1349.0,1349,112.4,112.4,1,113.0,113.0,Pequeno I
4866,4912,431415,2075,1563,340,576,916,647,1911.67,1441.75,300.25,582.75,883.0,558.75,22940,17301,3603,6993,10596,6705,2022,'PAVERAMA',Paverama,'RS',4314159,0.0,22513,0.0,1876.1,1,0.0,1700.0,Pequeno I
4867,4913,431417,1341,971,175,511,686,285,1334.58,990.92,180.92,518.25,699.17,291.75,16015,11891,2171,6219,8390,3501,2022,'PEDRAS ALTAS',Pedras Altas,'RS',4314175,635.0,635,52.9,52.9,1,74.0,74.0,Pequeno I
4868,4914,431420,4232,3564,320,2274,2594,970,4017.08,3423.17,318.17,2157.08,2475.25,947.92,48205,41078,3818,25885,29703,11375,2022,'PEDRO OSORIO',Pedro Osório,'RS',4314209,507.0,507,42.2,42.2,1,46.0,46.0,Pequeno I
4869,4915,431430,1634,986,156,286,442,544,1582.67,962.17,159.92,289.0,448.92,513.25,18992,11546,1919,3468,5387,6159,2022,'PEJUCARA',Pejuçara,'RS',4314308,5378.0,5378,448.2,448.2,1,441.0,441.0,Pequeno I
4870,4916,431440,98633,82191,14498,40775,55273,26918,85613.17,70406.0,12334.75,32323.67,44658.42,25747.58,1027358,844872,148017,387884,535901,308971,2022,'PELOTAS',Pelotas,'RS',4314407,29385.0,29385,2448.8,2448.8,6,1951.0,1951.0,Grande
4871,4917,431442,522,284,44,36,80,204,455.42,269.92,47.25,38.75,86.0,183.92,5465,3239,567,465,1032,2207,2022,'PICADA CAFE',Picada Café,'RS',4314423,868.0,868,78.9,78.9,1,,,Pequeno I
4872,4918,431445,1137,394,44,62,106,288,1109.25,390.58,33.42,48.58,82.0,308.58,13311,4687,401,583,984,3703,2022,'PINHAL',Pinhal,'RS',4314456,1265.0,1265,105.4,105.4,1,92.0,92.0,Pequeno I
4873,4919,431446,951,795,96,416,512,283,875.25,729.92,91.58,384.25,475.83,254.08,10503,8759,1099,4611,5710,3049,2022,'PINHAL DA SERRA',Pinhal da Serra,'RS',4314464,1447.0,1447,120.6,120.6,1,62.0,62.0,Pequeno I
4874,4920,431447,2212,1400,232,451,683,717,2140.33,1415.5,243.33,439.33,682.67,732.83,25684,16986,2920,5272,8192,8794,2022,'PINHAL GRANDE',Pinhal Grande,'RS',4314472,1265.0,1265,105.4,105.4,1,70.0,70.0,Pequeno I
4875,4921,431449,2238,1643,262,765,1027,616,2170.83,1604.08,266.0,703.75,969.75,634.33,26050,19249,3192,8445,11637,7612,2022,'PINHEIRINHO DO VALE',Pinheirinho do Vale,'RS',4314498,1198.0,1198,108.9,108.9,1,70.0,70.0,Pequeno I
4876,4922,431450,5504,4583,323,3472,3795,788,5150.08,4336.25,191.17,3410.0,3601.17,735.08,61801,52035,2294,40920,43214,8821,2022,'PINHEIRO MACHADO',Pinheiro Machado,'RS',4314506,2118.0,2118,176.5,176.5,1,113.0,113.0,Pequeno I
4877,4924,431455,1478,853,77,403,480,373,1458.83,849.33,76.67,392.25,468.92,380.42,17506,10192,920,4707,5627,4565,2022,'PIRAPO',Pirapó,'RS',4314555,320.0,320,26.7,26.7,1,10.0,10.0,Pequeno I
4878,4925,431460,8165,5878,1295,2276,3571,2307,7640.92,5762.33,1332.33,2073.25,3405.58,2356.75,91691,69148,15988,24879,40867,28281,2022,'PIRATINI',Piratini,'RS',4314605,1480.0,1480,211.4,211.4,1,,,Pequeno I
4879,4926,431470,4269,3336,698,1177,1875,1461,4124.67,3279.75,654.83,1234.08,1888.92,1390.83,49496,39357,7858,14809,22667,16690,2022,'PLANALTO',Planalto,'RS',4314704,1473.0,1473,122.8,122.8,1,117.0,117.0,Pequeno I
4880,4927,431475,802,189,12,13,25,164,743.75,199.83,14.17,16.08,30.25,169.58,8925,2398,170,193,363,2035,2022,'POCO DAS ANTAS',Poço Das Antas,'RS',4314753,600.0,600,50.0,50.0,1,38.0,38.0,Pequeno I
4881,4928,431477,1351,850,191,259,450,400,1240.25,818.08,164.17,271.67,435.83,382.25,14883,9817,1970,3260,5230,4587,2022,'PONTAO',Pontão,'RS',4314779,678.0,678,61.6,61.6,1,61.0,61.0,Pequeno I
4882,4929,431478,680,171,27,14,41,130,644.67,174.08,27.67,14.75,42.42,131.67,7736,2089,332,177,509,1580,2022,'PONTE PRETA',Ponte Preta,'RS',4314787,344.0,344,28.7,28.7,1,18.0,18.0,Pequeno I
4883,4930,431480,9973,8547,2110,3359,5469,3078,9369.58,8094.5,1915.08,3728.5,5643.58,2450.92,112435,97134,22981,44742,67723,29411,2022,'PORTAO',Portão,'RS',4314803,1783.0,1783,148.6,148.6,1,112.0,112.0,Pequeno II
4884,4931,431490,347355,292667,21148,209611,230759,61908,302616.0,256415.83,18827.42,183172.83,202000.25,54415.58,3631392,3076990,225929,2198074,2424003,652987,2022,'PORTO ALEGRE',Porto Alegre,'RS',4314902,224661.0,236058,18721.8,19671.5,22,13399.0,13399.0,Metrópole
4885,4932,431500,1370,1111,164,537,701,410,1334.5,1100.0,164.42,560.58,725.0,375.0,16014,13200,1973,6727,8700,4500,2022,'PORTO LUCENA',Porto Lucena,'RS',4315008,1749.0,1749,145.8,145.8,1,75.0,75.0,Pequeno I
4886,4933,431505,691,538,50,377,427,111,660.42,525.33,47.92,366.08,414.0,111.33,7925,6304,575,4393,4968,1336,2022,'PORTO MAUA',Porto Mauá,'RS',4315057,684.0,684,57.0,57.0,1,58.0,58.0,Pequeno I
4887,4934,431507,829,401,120,48,168,233,820.08,414.0,134.92,48.0,182.92,231.08,9841,4968,1619,576,2195,2773,2022,'PORTO VERA CRUZ',Porto Vera Cruz,'RS',4315073,1791.0,1791,149.2,149.2,1,66.0,66.0,Pequeno I
4888,4935,431510,4955,3663,1209,970,2179,1484,4672.67,3519.42,973.08,1110.42,2083.5,1435.92,56072,42233,11677,13325,25002,17231,2022,'PORTO XAVIER',Porto Xavier,'RS',4315107,2568.0,2568,214.0,214.0,1,72.0,72.0,Pequeno I
4889,4936,431513,553,344,91,71,162,182,534.92,343.0,107.67,68.33,176.0,167.0,6419,4116,1292,820,2112,2004,2022,'POUSO NOVO',Pouso Novo,'RS',4315131,677.0,677,56.4,56.4,1,18.0,18.0,Pequeno I
4890,4937,431514,369,322,13,192,205,117,331.33,283.08,9.67,173.0,182.67,100.42,3976,3397,116,2076,2192,1205,2022,'PRESIDENTE LUCENA',Presidente Lucena,'RS',4315149,1572.0,1572,174.7,174.7,1,241.0,241.0,Pequeno I
4891,4938,431515,1445,1163,279,590,869,294,1322.67,1080.0,250.83,571.42,822.25,257.75,15872,12960,3010,6857,9867,3093,2022,'PROGRESSO',Progresso,'RS',4315156,3189.0,3189,265.8,265.8,1,250.0,250.0,Pequeno I
4892,4939,431517,230,192,30,81,111,81,200.08,173.67,21.5,78.33,99.83,73.83,2401,2084,258,940,1198,886,2022,'PROTASIO ALVES',Protásio Alves,'RS',4315172,285.0,285,23.8,23.8,1,22.0,22.0,Pequeno I
4893,4940,431520,1053,524,97,184,281,243,1020.83,526.92,83.08,188.75,271.83,255.08,12250,6323,997,2265,3262,3061,2022,'PUTINGA',Putinga,'RS',4315206,538.0,538,44.8,44.8,1,56.0,56.0,Pequeno I
4894,4941,431530,13501,9552,2184,3860,6044,3508,12526.5,9102.75,1796.42,3841.83,5638.25,3464.5,150318,109233,21557,46102,67659,41574,2022,'QUARAI',Quaraí,'RS',4315305,1315.0,1315,109.6,109.6,1,19.0,19.0,Pequeno II
4895,4942,431531,600,399,77,137,214,185,551.58,391.67,63.25,135.17,198.42,193.25,6619,4700,759,1622,2381,2319,2022,'QUATRO IRMAOS',Quatro Irmãos,'RS',4315313,1154.0,1154,96.2,96.2,1,128.0,128.0,Pequeno I
4896,4943,431532,1541,997,177,463,640,357,1426.42,982.42,196.25,434.0,630.25,352.17,17117,11789,2355,5208,7563,4226,2022,'QUEVEDOS',Quevedos,'RS',4315321,575.0,575,52.3,52.3,1,33.0,33.0,Pequeno I
4897,4944,431535,876,455,80,86,166,289,797.0,422.83,79.92,78.92,158.83,264.0,9564,5074,959,947,1906,3168,2022,'QUINZE DE NOVEMBRO',Quinze de Novembro,'RS',4315354,259.0,259,21.6,21.6,1,8.0,8.0,Pequeno I
4898,4945,431540,6044,5765,319,4469,4788,977,5850.17,5628.0,286.83,4481.17,4768.0,860.0,70202,67536,3442,53774,57216,10320,2022,'REDENTORA',Redentora,'RS',4315404,3512.0,3512,292.7,292.7,1,188.0,188.0,Pequeno I
4899,4946,431545,979,241,32,84,116,125,950.25,224.33,23.5,75.5,99.0,125.33,11403,2692,282,906,1188,1504,2022,'RELVADO',Relvado,'RS',4315453,462.0,462,38.5,38.5,1,27.0,27.0,Pequeno I
4900,4947,431550,6176,4734,721,2395,3116,1618,5971.33,4671.92,750.33,2375.25,3125.58,1546.33,71656,56063,9004,28503,37507,18556,2022,'RESTINGA SECA',Restinga Seca,'RS',4315503,1374.0,1374,114.5,114.5,1,154.0,154.0,Pequeno I
4901,4948,431555,1766,1186,115,672,787,399,1664.0,1149.75,125.92,663.75,789.67,360.08,19968,13797,1511,7965,9476,4321,2022,'RIO DOS INDIOS',Rio Dos Índios,'RS',4315552,6298.0,9898,572.5,899.8,1,800.0,800.0,Pequeno I
4902,4949,431560,72050,56530,10438,23147,33585,22945,66713.08,52688.5,10098.17,21235.0,31333.17,21355.33,800557,632262,121178,254820,375998,256264,2022,'RIO GRANDE',Rio Grande,'RS',4315602,39691.0,39691,3307.6,3307.6,4,2642.0,2642.0,Grande
4903,4950,431570,13501,12152,966,9491,10457,1695,12082.17,10920.67,820.25,8513.42,9333.67,1587.0,144986,131048,9843,102161,112004,19044,2022,'RIO PARDO',Rio Pardo,'RS',4315701,13408.0,13408,1218.9,1218.9,2,483.0,483.0,Pequeno II
4904,4952,431580,1954,1433,222,732,954,479,1726.17,1268.83,180.5,646.5,827.0,441.83,20714,15226,2166,7758,9924,5302,2022,'ROCA SALES',Roca Sales,'RS',4315800,2997.0,2997,249.8,249.8,1,330.0,330.0,Pequeno I
4905,4953,431590,2355,1796,449,573,1022,774,2093.17,1635.5,356.75,582.33,939.08,696.42,25118,19626,4281,6988,11269,8357,2022,'RODEIO BONITO',Rodeio Bonito,'RS',4315909,4375.0,4375,364.6,364.6,1,266.0,266.0,Pequeno I
4906,4954,431595,1108,778,166,248,414,364,1069.83,767.33,156.5,256.58,413.08,354.25,12838,9208,1878,3079,4957,4251,2022,'ROLADOR',Rolador,'RS',4315958,1645.0,1645,137.1,137.1,1,189.0,189.0,Pequeno I
4907,4955,431600,5122,4096,817,1598,2415,1681,4398.67,3569.67,706.58,1558.75,2265.33,1304.33,52784,42836,8479,18705,27184,15652,2022,'ROLANTE',Rolante,'RS',4316006,3447.0,3447,287.2,287.2,1,102.0,102.0,Pequeno I
4908,4956,431610,3950,2861,501,1249,1750,1111,3826.67,2865.58,439.67,1366.75,1806.42,1059.17,45920,34387,5276,16401,21677,12710,2022,'RONDA ALTA',Ronda Alta,'RS',4316105,3900.0,3900,325.0,325.0,1,120.0,120.0,Pequeno I
4909,4957,431620,1331,777,186,334,520,257,1296.42,745.33,178.08,309.75,487.83,257.5,15557,8944,2137,3717,5854,3090,2022,'RONDINHA',Rondinha,'RS',4316204,2782.0,2782,231.8,231.8,1,195.0,195.0,Pequeno I
4910,4958,431630,3678,2004,512,542,1054,950,3521.42,1976.17,428.58,606.67,1035.25,940.92,42257,23714,5143,7280,12423,11291,2022,'ROQUE GONZALES',Roque Gonzales,'RS',4316303,607.0,607,50.6,50.6,1,22.0,22.0,Pequeno I
4911,4959,431640,17813,15919,2137,10311,12448,3471,16633.33,15122.33,1724.75,10533.58,12258.33,2864.0,199600,181468,20697,126403,147100,34368,2022,'ROSARIO DO SUL',Rosário do Sul,'RS',4316402,2090.0,2090,174.2,174.2,1,245.0,245.0,Pequeno II
4912,4960,431642,1681,1141,209,501,710,431,1591.17,1100.92,176.92,468.08,645.0,455.92,19094,13211,2123,5617,7740,5471,2022,'SAGRADA FAMILIA',Sagrada Família,'RS',4316428,2813.0,2813,234.4,234.4,1,100.0,100.0,Pequeno I
4913,4961,431643,1012,565,52,188,240,325,969.0,548.17,58.83,170.67,229.5,318.67,11628,6578,706,2048,2754,3824,2022,'SALDANHA MARINHO',Saldanha Marinho,'RS',4316436,1815.0,1815,151.2,151.2,1,80.0,80.0,Pequeno I
4914,4962,431645,5331,4552,96,3876,3972,580,4805.08,4148.75,122.0,3515.83,3637.83,510.92,57661,49785,1464,42190,43654,6131,2022,'SALTO DO JACUI',Salto do Jacuí,'RS',4316451,3571.0,3571,297.6,297.6,1,379.0,379.0,Pequeno I
4915,4963,431647,834,337,36,69,105,232,813.5,337.67,39.08,85.25,124.33,213.33,9762,4052,469,1023,1492,2560,2022,'SALVADOR DAS MISSOES',Salvador Das Missões,'RS',4316477,541.0,541,45.1,45.1,1,76.0,76.0,Pequeno I
4916,4964,431650,471,388,61,142,203,185,396.92,330.0,51.0,113.08,164.08,165.92,4763,3960,612,1357,1969,1991,2022,'SALVADOR DO SUL',Salvador do Sul,'RS',4316501,944.0,944,78.7,78.7,1,75.0,75.0,Pequeno I
4917,4965,431660,2734,1582,315,333,648,934,2586.67,1499.58,304.58,325.25,629.83,869.75,31040,17995,3655,3903,7558,10437,2022,'SANANDUVA',Sananduva,'RS',4316600,463.0,463,38.6,38.6,1,70.0,70.0,Pequeno I
4918,4966,431670,3371,2292,380,992,1372,920,3152.75,2167.25,373.67,917.08,1290.75,876.5,37833,26007,4484,11005,15489,10518,2022,'SANTA BARBARA DO SUL',Santa Bárbara do Sul,'RS',4316709,3011.0,3011,250.9,250.9,1,193.0,193.0,Pequeno I
4919,4967,431673,657,324,43,88,131,193,647.67,333.0,43.58,77.33,120.92,212.08,7772,3996,523,928,1451,2545,2022,'SANTA CECILIA DO SUL',Santa Cecília do Sul,'RS',4316733,3083.0,3083,256.9,256.9,1,103.0,103.0,Pequeno I
4920,4968,431675,1059,375,49,41,90,285,1038.33,395.67,52.17,58.08,110.25,285.42,12460,4748,626,697,1323,3425,2022,'SANTA CLARA DO SUL',Santa Clara do Sul,'RS',4316758,1567.0,1567,130.6,130.6,1,99.0,99.0,Pequeno I
4921,4969,431680,27497,22080,4790,10280,15070,7010,24653.17,20102.42,4223.75,9324.58,13548.33,6554.08,295838,241229,50685,111895,162580,78649,2022,'SANTA CRUZ DO SUL',Santa Cruz do Sul,'RS',4316808,15074.0,15074,1256.2,1256.2,3,1044.0,1044.0,Grande
4922,4970,431690,75866,59843,10485,31110,41595,18248,68775.92,54414.0,9258.92,27798.67,37057.58,17356.42,825311,652968,111107,333584,444691,208277,2022,'SANTA MARIA',Santa Maria,'RS',4316907,21455.0,21455,1787.9,1787.9,3,2733.0,2733.0,Grande
4923,4971,431695,632,423,99,202,301,122,587.92,395.08,84.33,188.25,272.58,122.5,7055,4741,1012,2259,3271,1470,2022,'SANTA MARIA DO HERVAL',Santa Maria do Herval,'RS',4316956,1015.0,1015,92.3,92.3,1,93.0,93.0,Pequeno I
4924,4972,431697,1214,1016,185,567,752,264,1168.67,993.42,153.33,580.25,733.58,259.83,14024,11921,1840,6963,8803,3118,2022,'SANTA MARGARIDA DO SUL',Santa Margarida do Sul,'RS',4316972,872.0,872,72.7,72.7,1,56.0,56.0,Pequeno I
4925,4974,431710,38850,32151,4341,19618,23959,8192,35805.17,29674.92,4116.58,17718.83,21835.42,7839.5,429662,356099,49399,212626,262025,94074,2022,'SANTANA DO LIVRAMENTO',Santana do Livramento,'RS',4317103,6668.0,6668,555.7,555.7,2,545.0,545.0,Médio
4926,4975,431720,19376,13380,3524,2452,5976,7404,18229.67,12834.42,3194.67,2777.83,5972.5,6861.92,218756,154013,38336,33334,71670,82343,2022,'SANTA ROSA',Santa Rosa,'RS',4317202,35313.0,35313,2942.8,2942.8,2,3014.0,3014.0,Médio
4927,4977,431730,12236,9422,1922,4380,6302,3120,11174.92,8656.5,1725.5,3939.17,5664.67,2991.83,134099,103878,20706,47270,67976,35902,2022,'SANTA VITORIA DO PALMAR',Santa Vitória do Palmar,'RS',4317301,6646.0,6646,553.8,553.8,2,367.0,367.0,Pequeno II
4928,4978,431740,14562,11084,2839,3026,5865,5219,13769.33,10624.25,2812.33,2915.5,5727.83,4896.42,165232,127491,33748,34986,68734,58757,2022,'SANTIAGO',Santiago,'RS',4317400,28491.0,28491,2374.2,2374.2,3,2171.0,2171.0,Pequeno II
4929,4979,431750,24846,19993,5053,6709,11762,8231,22729.67,18994.83,4648.58,7052.33,11700.92,7293.92,272756,227938,55783,84628,140411,87527,2022,'SANTO ANGELO',Santo Ângelo,'RS',4317509,19236.0,19236,1603.0,1603.0,2,899.0,899.0,Médio
4930,4980,431755,993,310,40,68,108,202,942.75,301.5,37.67,61.67,99.33,202.17,11313,3618,452,740,1192,2426,2022,'SANTO ANTONIO DO PALMA',Santo Antônio do Palma,'RS',4317558,989.0,989,82.4,82.4,1,78.0,78.0,Pequeno I
4931,4981,431760,14011,10758,1422,5932,7354,3404,13189.08,10286.0,1280.08,5972.0,7252.08,3033.92,158269,123432,15361,71664,87025,36407,2022,'SANTO ANTONIO DA PATRULHA',Santo Antônio da Patrulha,'RS',4317608,2914.0,2914,242.8,242.8,1,276.0,276.0,Pequeno II
4932,4982,431770,5260,4418,744,2791,3535,883,4949.75,4227.42,547.92,2878.08,3426.0,801.42,59397,50729,6575,34537,41112,9617,2022,'SANTO ANTONIO DAS MISSOES',Santo Antônio Das Missões,'RS',4317707,1402.0,1402,116.8,116.8,1,84.0,84.0,Pequeno I
4933,4983,431775,634,403,107,82,189,214,576.83,373.17,91.67,68.0,159.67,213.5,6922,4478,1100,816,1916,2562,2022,'SANTO ANTONIO DO PLANALTO',Santo Antônio do Planalto,'RS',4317756,1110.0,1110,92.5,92.5,1,53.0,53.0,Pequeno I
4934,4984,431780,5895,4291,776,1410,2186,2105,5671.25,4180.0,712.17,1595.17,2307.33,1872.67,68055,50160,8546,19142,27688,22472,2022,'SANTO AUGUSTO',Santo Augusto,'RS',4317806,3309.0,3309,275.8,275.8,2,228.0,228.0,Pequeno I
4935,4985,431790,2317,1744,383,719,1102,642,2169.58,1615.0,276.42,688.67,965.08,649.92,26035,19380,3317,8264,11581,7799,2022,'SANTO CRISTO',Santo Cristo,'RS',4317905,2367.0,2367,197.2,197.2,1,281.0,281.0,Pequeno I
4936,4986,431795,763,426,71,111,182,244,751.17,429.5,75.92,119.92,195.83,233.67,9014,5154,911,1439,2350,2804,2022,'SANTO EXPEDITO DO SUL',Santo Expedito do Sul,'RS',4317954,1000.0,1000,83.3,83.3,1,49.0,49.0,Pequeno I
4937,4987,431800,23003,17255,5676,1795,7471,9784,21766.83,16446.25,5171.75,1873.75,7045.5,9400.75,261202,197355,62061,22485,84546,112809,2022,'SAO BORJA',São Borja,'RS',4318002,17680.0,17680,1473.3,1473.3,3,1437.0,1437.0,Médio
4938,4988,431805,783,231,5,3,8,223,773.75,248.92,8.92,6.17,15.08,233.83,9285,2987,107,74,181,2806,2022,'SAO DOMINGOS DO SUL',São Domingos do Sul,'RS',4318051,462.0,462,42.0,42.0,1,33.0,33.0,Pequeno I
4939,4989,431810,8445,5970,996,3065,4061,1909,8182.33,5846.25,933.75,2919.0,3852.75,1993.5,98188,70155,11205,35028,46233,23922,2022,'SAO FRANCISCO DE ASSIS',São Francisco de Assis,'RS',4318101,1042.0,1042,94.7,94.7,1,124.0,124.0,Pequeno I
4940,4990,431820,6479,5475,1428,2274,3702,1773,6160.67,5283.5,1439.75,2245.67,3685.42,1598.08,73928,63402,17277,26948,44225,19177,2022,'SAO FRANCISCO DE PAULA',São Francisco de Paula,'RS',4318200,4392.0,4392,366.0,366.0,1,259.0,259.0,Pequeno II
4941,4991,431830,22612,18486,6177,2990,9167,9319,21441.33,17841.58,5826.25,3610.67,9436.92,8404.67,257296,214099,69915,43328,113243,100856,2022,'SAO GABRIEL',São Gabriel,'RS',4318309,3272.0,3272,272.7,272.7,2,176.0,176.0,Médio
4942,4992,431840,8063,6951,1163,4082,5245,1706,7530.92,6593.08,915.0,4189.0,5104.0,1489.08,90371,79117,10980,50268,61248,17869,2022,'SAO JERONIMO',São Jerônimo,'RS',4318408,155.0,155,15.5,15.5,1,9.0,9.0,Pequeno II
4943,4993,431842,1395,587,127,112,239,348,1317.08,572.0,113.5,160.83,274.33,297.67,15805,6864,1362,1930,3292,3572,2022,'SAO JOAO DA URTIGA',São João da Urtiga,'RS',4318424,1393.0,1393,116.1,116.1,1,102.0,102.0,Pequeno I
4944,4994,431843,941,674,172,261,433,241,920.5,699.5,148.83,293.08,441.92,257.58,11046,8394,1786,3517,5303,3091,2022,'SAO JOAO DO POLESINE',São João do Polêsine,'RS',4318432,1596.0,1596,133.0,133.0,1,84.0,84.0,Pequeno I
4945,4995,431844,551,247,50,52,102,145,554.5,245.08,49.0,57.67,106.67,138.42,6654,2941,588,692,1280,1661,2022,'SAO JORGE',São Jorge,'RS',4318440,1442.0,1442,120.2,120.2,1,136.0,136.0,Pequeno I
4946,4996,431845,1416,1016,101,595,696,320,1389.58,1038.58,95.33,620.75,716.08,322.5,16675,12463,1144,7449,8593,3870,2022,'SAO JOSE DAS MISSOES',São José Das Missões,'RS',4318457,2948.0,2948,268.0,268.0,1,287.0,287.0,Pequeno I
4947,4997,431846,811,742,35,650,685,57,770.75,710.0,33.5,624.0,657.5,52.5,9249,8520,402,7488,7890,630,2022,'SAO JOSE DO HERVAL',São José do Herval,'RS',4318465,268.0,268,22.3,22.3,1,20.0,20.0,Pequeno I
4948,4998,431848,472,287,36,61,97,190,450.08,276.83,38.75,65.08,103.83,173.0,5401,3322,465,781,1246,2076,2022,'SAO JOSE DO HORTENCIO',São José do Hortêncio,'RS',4318481,200.0,200,16.7,16.7,1,12.0,12.0,Pequeno I
4949,4999,431849,1038,225,32,30,62,163,1004.33,243.67,29.17,32.92,62.08,181.58,12052,2924,350,395,745,2179,2022,'SAO JOSE DO INHACORA',São José do Inhacorá,'RS',4318499,983.0,983,81.9,81.9,1,57.0,57.0,Pequeno I
4950,5000,431850,13214,10795,2895,3082,5977,4818,12422.33,10335.67,2626.83,3364.83,5991.67,4344.0,149068,124028,31522,40378,71900,52128,2022,'SAO JOSE DO NORTE',São José do Norte,'RS',4318507,1992.0,1992,166.0,166.0,1,150.0,150.0,Pequeno II
4951,5001,431860,1758,1131,180,653,833,298,1655.0,1068.5,143.25,630.92,774.17,294.33,19860,12822,1719,7571,9290,3532,2022,'SAO JOSE DO OURO',São José do Ouro,'RS',4318606,988.0,988,89.8,89.8,1,79.0,79.0,Pequeno I
4952,5002,431861,318,215,54,53,107,108,304.08,214.33,51.58,60.42,112.0,102.33,3649,2572,619,725,1344,1228,2022,'SAO JOSE DO SUL',São José do Sul,'RS',4318614,728.0,728,60.7,60.7,1,89.0,89.0,Pequeno I
4953,5003,431862,1780,1582,366,674,1040,542,1650.25,1473.33,339.17,665.67,1004.83,468.5,19803,17680,4070,7988,12058,5622,2022,'SAO JOSE DOS AUSENTES',São José Dos Ausentes,'RS',4318622,1221.0,1221,101.8,101.8,1,71.0,71.0,Pequeno I
4954,5004,431870,67175,58205,6491,36138,42629,15576,61530.33,53819.25,6079.67,33403.5,39483.17,14336.08,738364,645831,72956,400842,473798,172033,2022,'SAO LEOPOLDO',São Leopoldo,'RS',4318705,40031.0,40031,3335.9,3335.9,5,2689.0,2689.0,Grande
4955,5005,431880,11773,9461,1426,4850,6276,3185,11041.08,8938.58,1298.17,4553.42,5851.58,3087.0,132493,107263,15578,54641,70219,37044,2022,'SAO LOURENCO DO SUL',São Lourenço do Sul,'RS',4318804,1606.0,1606,133.8,133.8,1,75.0,75.0,Pequeno II
4956,5006,431890,14294,10090,2929,2520,5449,4641,13390.67,9643.75,2820.33,2440.5,5260.83,4382.92,160688,115725,33844,29286,63130,52595,2022,'SAO LUIZ GONZAGA',São Luiz Gonzaga,'RS',4318903,11692.0,11692,974.3,974.3,1,1123.0,1123.0,Pequeno II
4957,5007,431900,3062,2273,441,949,1390,883,2828.92,2110.08,376.5,933.17,1309.67,800.42,33947,25321,4518,11198,15716,9605,2022,'SAO MARCOS',São Marcos,'RS',4319000,2298.0,2298,191.5,191.5,1,143.0,143.0,Pequeno II
4958,5008,431910,2068,923,152,204,356,567,1973.83,920.83,136.58,232.33,368.92,551.92,23686,11050,1639,2788,4427,6623,2022,'SAO MARTINHO',São Martinho,'RS',4319109,1788.0,1788,149.0,149.0,1,106.0,106.0,Pequeno I
4959,5009,431912,1513,1309,196,835,1031,278,1443.5,1253.67,189.67,814.58,1004.25,249.42,17322,15044,2276,9775,12051,2993,2022,'SAO MARTINHO DA SERRA',São Martinho da Serra,'RS',4319125,2918.0,2918,243.2,243.2,1,134.0,134.0,Pequeno I
4960,5010,431915,2969,2548,179,1950,2129,419,2814.83,2413.5,156.42,1797.75,1954.17,459.33,33778,28962,1877,21573,23450,5512,2022,'SAO MIGUEL DAS MISSOES',São Miguel Das Missões,'RS',4319158,1098.0,1098,99.8,99.8,1,,,Pequeno I
4961,5011,431920,3156,2797,81,2420,2501,296,3048.42,2729.17,83.08,2353.33,2436.42,292.75,36581,32750,997,28240,29237,3513,2022,'SAO NICOLAU',São Nicolau,'RS',4319208,910.0,910,75.8,75.8,1,54.0,54.0,Pequeno I
4962,5012,431930,2137,1630,561,505,1066,564,1991.83,1537.58,480.58,573.75,1054.33,483.25,23902,18451,5767,6885,12652,5799,2022,'SAO PAULO DAS MISSOES',São Paulo Das Missões,'RS',4319307,1309.0,1309,109.1,109.1,1,60.0,60.0,Pequeno I
4963,5013,431935,257,204,27,29,56,148,245.42,196.0,35.58,42.33,77.92,118.08,2945,2352,427,508,935,1417,2022,'SAO PEDRO DA SERRA',São Pedro da Serra,'RS',4319356,348.0,348,29.0,29.0,1,29.0,29.0,Pequeno I
4964,5014,431936,955,574,113,289,402,172,915.67,569.17,110.75,273.75,384.5,184.67,10988,6830,1329,3285,4614,2216,2022,'SAO PEDRO DAS MISSOES',São Pedro Das Missões,'RS',4319364,1078.0,1078,89.8,89.8,1,107.0,107.0,Pequeno I
4965,5015,431937,481,356,77,113,190,166,435.33,324.67,60.67,114.5,175.17,149.5,5224,3896,728,1374,2102,1794,2022,'SAO PEDRO DO BUTIA',São Pedro do Butiá,'RS',4319372,944.0,944,78.7,78.7,1,30.0,30.0,Pequeno I
4966,5016,431940,7978,5752,470,3492,3962,1790,7640.08,5490.0,463.92,3192.33,3656.25,1833.75,91681,65880,5567,38308,43875,22005,2022,'SAO PEDRO DO SUL',São Pedro do Sul,'RS',4319406,1572.0,1572,131.0,131.0,1,345.0,345.0,Pequeno I
4967,5017,431950,6391,5413,1368,2150,3518,1895,5879.75,5070.42,1248.08,2169.42,3417.5,1652.92,70557,60845,14977,26033,41010,19835,2022,'SAO SEBASTIAO DO CAI',São Sebastião do Caí,'RS',4319505,14485.0,14485,1207.1,1207.1,1,921.0,921.0,Pequeno II
4968,5018,431960,8361,6724,2016,1704,3720,3004,7982.08,6584.42,1928.83,1934.92,3863.75,2720.67,95785,79013,23146,23219,46365,32648,2022,'SAO SEPE',São Sepé,'RS',4319604,6210.0,6210,517.5,517.5,1,500.0,500.0,Pequeno II
4969,5019,431970,1238,656,149,162,311,345,1106.08,582.75,141.92,135.67,277.58,305.17,13273,6993,1703,1628,3331,3662,2022,'SAO VALENTIM',São Valentim,'RS',4319703,890.0,890,74.2,74.2,1,60.0,60.0,Pequeno I
4970,5020,431971,242,147,36,35,71,76,217.25,125.25,20.0,26.17,46.17,79.08,2607,1503,240,314,554,949,2022,'SAO VALENTIM DO SUL',São Valentim do Sul,'RS',4319711,416.0,416,34.7,34.7,1,29.0,29.0,Pequeno I
4971,5021,431973,1961,1502,153,1048,1201,301,1850.92,1452.25,167.17,1020.58,1187.75,264.5,22211,17427,2006,12247,14253,3174,2022,'SAO VALERIO DO SUL',São Valério do Sul,'RS',4319737,1348.0,1348,168.5,168.5,1,,,Pequeno I
4972,5022,431975,261,101,27,22,49,52,250.33,95.25,22.17,17.33,39.5,55.75,3004,1143,266,208,474,669,2022,'SAO VENDELINO',São Vendelino,'RS',4319752,1669.0,1669,166.9,166.9,1,,,Pequeno I
4973,5023,431980,3333,2831,400,1718,2118,713,3008.08,2604.42,390.33,1557.75,1948.08,656.33,36097,31253,4684,18693,23377,7876,2022,'SAO VICENTE DO SUL',São Vicente do Sul,'RS',4319802,2096.0,2096,190.5,190.5,1,,,Pequeno I
4974,5024,431990,18580,15086,1250,9478,10728,4358,16326.67,13548.58,1345.58,8129.75,9475.33,4073.25,195920,162583,16147,97557,113704,48879,2022,'SAPIRANGA',Sapiranga,'RS',4319901,5751.0,5751,479.2,479.2,2,378.0,378.0,Médio
4975,5025,432000,41109,34065,4738,20717,25455,8610,35688.33,29631.25,4477.0,17288.42,21765.42,7865.83,428260,355575,53724,207461,261185,94390,2022,'SAPUCAIA DO SUL',Sapucaia do Sul,'RS',4320008,12839.0,12839,1069.9,1069.9,4,1820.0,1820.0,Grande
4976,5026,432010,7392,5664,1334,1778,3112,2552,6987.75,5360.0,1193.33,1858.33,3051.67,2308.33,83853,64320,14320,22300,36620,27700,2022,'SARANDI',Sarandi,'RS',4320107,5628.0,5628,469.0,469.0,1,924.0,924.0,Pequeno II
4977,5027,432020,4844,3348,1065,616,1681,1667,4789.08,3334.17,927.83,814.25,1742.08,1592.08,57469,40010,11134,9771,20905,19105,2022,'SEBERI',Seberi,'RS',4320206,1772.0,1772,147.7,147.7,1,105.0,105.0,Pequeno I
4978,5028,432023,1422,806,101,318,419,387,1379.0,794.17,106.17,309.83,416.0,378.17,16548,9530,1274,3718,4992,4538,2022,'SEDE NOVA',Sede Nova,'RS',4320230,4090.0,4090,340.8,340.8,1,166.0,166.0,Pequeno I
4979,5029,432026,3072,2520,749,953,1702,818,2969.25,2453.92,697.33,960.17,1657.5,796.42,35631,29447,8368,11522,19890,9557,2022,'SEGREDO',Segredo,'RS',4320263,2925.0,2925,243.8,243.8,1,214.0,214.0,Pequeno I
4980,5030,432030,1198,816,63,441,504,312,1109.0,743.42,51.75,406.08,457.83,285.58,13308,8921,621,4873,5494,3427,2022,'SELBACH',Selbach,'RS',4320305,1031.0,1031,85.9,85.9,1,87.0,87.0,Pequeno I
4981,5031,432032,983,705,72,324,396,309,921.17,668.75,71.75,328.58,400.33,268.42,11054,8025,861,3943,4804,3221,2022,'SENADOR SALGADO FILHO',Senador Salgado Filho,'RS',4320321,730.0,730,60.8,60.8,1,110.0,110.0,Pequeno I
4982,5032,432035,2217,1966,454,926,1380,586,2060.67,1859.25,444.5,953.0,1397.5,461.75,24728,22311,5334,11436,16770,5541,2022,'SENTINELA DO SUL',Sentinela do Sul,'RS',4320354,2463.0,2463,205.2,205.2,1,127.0,127.0,Pequeno I
4983,5033,432040,2679,1448,178,571,749,699,2804.17,1439.92,186.42,550.25,736.67,703.25,33650,17279,2237,6603,8840,8439,2022,'SERAFINA CORREA',Serafina Corrêa,'RS',4320404,3369.0,3369,280.8,280.8,1,280.0,280.0,Pequeno I
4984,5034,432045,564,382,65,151,216,166,512.5,366.5,61.67,148.92,210.58,155.92,6150,4398,740,1787,2527,1871,2022,'SERIO',Sério,'RS',4320453,294.0,294,24.5,24.5,1,30.0,30.0,Pequeno I
4985,5035,432050,1567,1253,193,615,808,445,1479.75,1191.0,195.0,602.08,797.08,393.92,17757,14292,2340,7225,9565,4727,2022,'SERTAO',Sertão,'RS',4320503,767.0,767,63.9,63.9,1,88.0,88.0,Pequeno I
4986,5036,432055,1994,1488,437,415,852,636,1889.25,1451.67,444.25,413.42,857.67,594.0,22671,17420,5331,4961,10292,7128,2022,'SERTAO SANTANA',Sertão Santana,'RS',4320552,1234.0,1234,102.8,102.8,1,94.0,94.0,Pequeno I
4987,5037,432057,458,391,27,239,266,125,461.58,392.67,19.83,221.0,240.83,151.83,5539,4712,238,2652,2890,1822,2022,'SETE DE SETEMBRO',Sete de Setembro,'RS',4320578,500.0,500,41.7,41.7,1,29.0,29.0,Pequeno I
4988,5038,432060,1191,447,60,112,172,275,1150.25,452.08,65.58,115.42,181.0,271.08,13803,5425,787,1385,2172,3253,2022,'SEVERIANO DE ALMEIDA',Severiano de Almeida,'RS',4320602,2176.0,2176,181.3,181.3,1,97.0,97.0,Pequeno I
4989,5039,432065,690,559,149,248,397,162,649.17,527.67,126.33,223.33,349.67,178.0,7790,6332,1516,2680,4196,2136,2022,'SILVEIRA MARTINS',Silveira Martins,'RS',4320651,178.0,178,14.8,14.8,1,6.0,6.0,Pequeno I
4990,5040,432067,2521,2159,244,1401,1645,514,2377.33,2074.58,220.33,1431.83,1652.17,422.42,28528,24895,2644,17182,19826,5069,2022,'SINIMBU',Sinimbu,'RS',4320677,2053.0,9360,171.1,780.0,1,347.0,347.0,Pequeno I
4991,5041,432070,4704,3737,641,1735,2376,1361,4559.33,3608.67,628.83,1659.5,2288.33,1320.33,54712,43304,7546,19914,27460,15844,2022,'SOBRADINHO',Sobradinho,'RS',4320701,6989.0,6989,582.4,582.4,1,510.0,510.0,Pequeno I
4992,5042,432080,13289,10871,2178,4825,7003,3868,12553.25,10414.42,1825.0,4932.42,6757.42,3657.0,150639,124973,21900,59189,81089,43884,2022,'SOLEDADE',Soledade,'RS',4320800,7260.0,7260,605.0,605.0,2,494.0,494.0,Pequeno II
4993,5043,432085,1230,1057,244,485,729,328,1147.83,983.75,205.58,486.83,692.42,291.33,13774,11805,2467,5842,8309,3496,2022,'TABAI',Tabaí,'RS',4320859,570.0,570,47.5,47.5,1,60.0,60.0,Pequeno I
4994,5044,432090,7924,5388,1157,2028,3185,2203,7213.42,4947.5,968.08,1992.0,2960.08,1987.42,86561,59370,11617,23904,35521,23849,2022,'TAPEJARA',Tapejara,'RS',4320909,2831.0,2831,235.9,235.9,1,202.0,202.0,Pequeno I
4995,5045,432100,2720,1622,277,238,515,1107,2573.0,1574.0,297.5,268.17,565.67,1008.33,30876,18888,3570,3218,6788,12100,2022,'TAPERA',Tapera,'RS',4321006,3704.0,3704,308.7,308.7,1,182.0,182.0,Pequeno I
4996,5046,432110,6442,5163,1276,1234,2510,2653,6035.58,4898.33,1292.75,966.0,2258.75,2639.58,72427,58780,15513,11592,27105,31675,2022,'TAPES',Tapes,'RS',4321105,7454.0,7454,621.2,621.2,1,614.0,614.0,Pequeno I
4997,5047,432120,11169,9731,1866,4487,6353,3378,10266.42,8991.33,1594.5,4399.33,5993.83,2997.5,123197,107896,19134,52792,71926,35970,2022,'TAQUARA',Taquara,'RS',4321204,3939.0,3939,328.2,328.2,1,319.0,319.0,Médio
4998,5048,432130,7796,6916,1232,3500,4732,2184,7294.33,6533.33,1121.92,3658.83,4780.75,1752.58,87532,78400,13463,43906,57369,21031,2022,'TAQUARI',Taquari,'RS',4321303,6372.0,6372,531.0,531.0,1,573.0,573.0,Pequeno II
4999,5049,432132,795,482,83,192,275,207,702.17,436.5,74.5,175.0,249.5,187.0,8426,5238,894,2100,2994,2244,2022,'TAQUARUCU DO SUL',Taquaruçu do Sul,'RS',4321329,331.0,331,27.6,27.6,1,29.0,29.0,Pequeno I
5000,5050,432135,2621,1987,224,1281,1505,482,2527.42,1922.5,200.0,1302.08,1502.08,420.42,30329,23070,2400,15625,18025,5045,2022,'TAVARES',Tavares,'RS',4321352,1868.0,1868,155.7,155.7,1,135.0,135.0,Pequeno I
5001,5051,432140,5897,5009,695,3160,3855,1154,5532.08,4705.83,638.75,2996.67,3635.42,1070.42,66385,56470,7665,35960,43625,12845,2022,'TENENTE PORTELA',Tenente Portela,'RS',4321402,1011.0,1011,84.2,84.2,1,80.0,80.0,Pequeno I
5002,5052,432143,4569,3790,357,2282,2639,1151,4293.0,3633.58,289.75,2249.75,2539.5,1094.08,51516,43603,3477,26997,30474,13129,2022,'TERRA DE AREIA',Terra de Areia,'RS',4321436,1861.0,1861,155.1,155.1,1,130.0,130.0,Pequeno I
5003,5053,432145,5437,3929,714,1020,1734,2195,5118.25,3767.0,623.25,1048.17,1671.42,2095.58,61419,45204,7479,12578,20057,25147,2022,'TEUTONIA',Teutônia,'RS',4321451,2843.0,2843,236.9,236.9,1,205.0,205.0,Pequeno II
5004,5054,432146,424,382,147,95,242,140,352.58,318.5,130.75,86.0,216.75,101.75,4231,3822,1569,1032,2601,1221,2022,'TIO HUGO',Tio Hugo,'RS',4321469,867.0,867,78.8,78.8,1,,,Pequeno I
5005,5055,432147,1743,1054,357,179,536,518,1578.25,1017.17,358.5,190.25,548.75,468.42,18939,12206,4302,2283,6585,5621,2022,'TIRADENTES DO SUL',Tiradentes do Sul,'RS',4321477,1451.0,1451,120.9,120.9,1,74.0,74.0,Pequeno I
5006,5057,432150,11644,9621,2165,4365,6530,3091,10260.5,8532.42,1742.83,3917.42,5660.25,2872.17,123126,102389,20914,47009,67923,34466,2022,'TORRES',Torres,'RS',4321501,8728.0,8728,727.3,727.3,1,822.0,822.0,Pequeno II
5007,5058,432160,18699,15757,4128,5844,9972,5785,16863.25,14215.75,3652.0,5427.5,9079.5,5136.25,202359,170589,43824,65130,108954,61635,2022,'TRAMANDAI',Tramandaí,'RS',4321600,13258.0,13258,1104.8,1104.8,1,848.0,848.0,Pequeno II
5008,5059,432162,503,104,21,14,35,69,519.17,114.92,20.5,19.25,39.75,75.17,6230,1379,246,231,477,902,2022,'TRAVESSEIRO',Travesseiro,'RS',4321626,1143.0,1143,95.2,95.2,1,202.0,202.0,Pequeno I
5009,5060,432163,484,115,6,9,15,100,422.92,96.0,8.0,8.08,16.08,79.92,5075,1152,96,97,193,959,2022,'TRES ARROIOS',Três Arroios,'RS',4321634,329.0,329,27.4,27.4,1,3.0,3.0,Pequeno I
5010,5061,432166,2046,1752,360,562,922,830,1921.25,1660.58,344.08,556.83,900.92,759.67,23055,19927,4129,6682,10811,9116,2022,'TRES CACHOEIRAS',Três Cachoeiras,'RS',4321667,741.0,741,61.8,61.8,1,101.0,101.0,Pequeno I
5011,5062,432170,4814,3706,716,1311,2027,1679,4545.25,3586.17,680.5,1388.67,2069.17,1517.0,54543,43034,8166,16664,24830,18204,2022,'TRES COROAS',Três Coroas,'RS',4321709,4388.0,4388,365.7,365.7,1,299.0,299.0,Pequeno II
5012,5063,432180,7924,4758,802,1854,2656,2102,7770.83,4979.5,840.08,1933.58,2773.67,2205.83,93250,59754,10081,23203,33284,26470,2022,'TRES DE MAIO',Três de Maio,'RS',4321808,5281.0,5281,440.1,440.1,1,379.0,379.0,Pequeno II
5013,5064,432183,1255,1008,246,438,684,324,1183.08,941.25,231.17,367.5,598.67,342.58,14197,11295,2774,4410,7184,4111,2022,'TRES FORQUILHAS',Três Forquilhas,'RS',4321832,357.0,357,29.8,29.8,1,38.0,38.0,Pequeno I
5014,5065,432185,2510,1726,399,723,1122,604,2359.5,1629.58,307.42,694.75,1002.17,627.42,28314,19555,3689,8337,12026,7529,2022,'TRES PALMEIRAS',Três Palmeiras,'RS',4321857,5060.0,6074,421.7,506.2,1,381.0,381.0,Pequeno I
5015,5066,432190,6068,4900,554,3004,3558,1342,5503.33,4463.0,477.25,2709.5,3186.75,1276.25,66040,53556,5727,32514,38241,15315,2022,'TRES PASSOS',Três Passos,'RS',4321907,4074.0,4074,339.5,339.5,1,210.0,210.0,Pequeno II
5016,5067,432195,2952,2062,393,677,1070,992,2705.58,1984.33,372.42,751.75,1124.17,860.17,32467,23812,4469,9021,13490,10322,2022,'TRINDADE DO SUL',Trindade do Sul,'RS',4321956,1900.0,1900,158.3,158.3,1,153.0,153.0,Pequeno I
5017,5068,432200,10364,8727,717,6007,6724,2003,9651.92,8118.42,720.0,5453.58,6173.58,1944.83,115823,97421,8640,65443,74083,23338,2022,'TRIUNFO',Triunfo,'RS',4322004,5531.0,5531,460.9,460.9,1,495.0,495.0,Pequeno II
5018,5069,432210,1218,919,134,452,586,333,1147.42,872.0,139.92,418.08,558.0,314.0,13769,10464,1679,5017,6696,3768,2022,'TUCUNDUVA',Tucunduva,'RS',4322103,1567.0,1567,130.6,130.6,1,65.0,65.0,Pequeno I
5019,5070,432215,1972,1754,189,1032,1221,533,1905.17,1764.83,159.83,1206.0,1365.83,399.0,22862,21178,1918,14472,16390,4788,2022,'TUNAS',Tunas,'RS',4322152,2165.0,2165,270.6,270.6,1,310.0,310.0,Pequeno I
5020,5071,432218,619,319,50,85,135,184,621.33,325.0,49.83,87.83,137.67,187.33,7456,3900,598,1054,1652,2248,2022,'TUPANCI DO SUL',Tupanci do Sul,'RS',4322186,1360.0,1360,113.3,113.3,1,84.0,84.0,Pequeno I
5021,5072,432220,9698,7630,1332,4056,5388,2242,9216.17,7373.17,1308.92,3854.08,5163.0,2210.17,110594,88478,15707,46249,61956,26522,2022,'TUPANCIRETA',Tupanciretã,'RS',4322202,9993.0,9993,832.8,832.8,1,600.0,600.0,Pequeno II
5022,5073,432225,496,379,54,165,219,160,390.92,300.08,40.17,150.5,190.67,109.42,4691,3601,482,1806,2288,1313,2022,'TUPANDI',Tupandi,'RS',4322251,1127.0,1127,93.9,93.9,1,43.0,43.0,Pequeno I
5023,5074,432230,2107,1188,205,371,576,612,2015.25,1221.17,186.0,467.08,653.08,568.08,24183,14654,2232,5605,7837,6817,2022,'TUPARENDI',Tuparendi,'RS',4322301,5001.0,5001,416.8,416.8,1,602.0,602.0,Pequeno I
5024,5075,432232,1391,1006,209,408,617,389,1326.33,995.08,194.17,405.25,599.42,395.67,15916,11941,2330,4863,7193,4748,2022,'TURUCU',Turuçu,'RS',4322327,2772.0,2772,231.0,231.0,1,148.0,148.0,Pequeno I
5025,5077,432235,152,81,18,31,49,32,138.75,70.08,17.17,22.83,40.0,30.08,1665,841,206,274,480,361,2022,'UNIAO DA SERRA',União da Serra,'RS',4322350,117.0,117,9.8,9.8,1,4.0,4.0,Pequeno I
5026,5078,432237,884,800,28,650,678,122,845.17,777.5,28.67,636.58,665.25,112.25,10142,9330,344,7639,7983,1347,2022,'UNISTALDA',Unistalda,'RS',4322376,400.0,400,33.3,33.3,1,20.0,20.0,Pequeno I
5027,5079,432240,47018,39645,3697,26717,30414,9231,44198.92,37518.83,3284.92,25624.0,28908.92,8609.92,530387,450226,39419,307488,346907,103319,2022,'URUGUAIANA',Uruguaiana,'RS',4322400,52004.0,55083,4333.7,4590.2,3,5223.0,5223.0,Grande
5028,5080,432250,21225,17108,3456,8525,11981,5127,18818.25,15322.25,3142.25,7407.42,10549.67,4772.58,225819,183867,37707,88889,126596,57271,2022,'VACARIA',Vacaria,'RS',4322509,5174.0,5174,431.2,431.2,1,288.0,288.0,Médio
5029,5081,432252,1284,902,139,416,555,347,1215.75,864.42,115.25,427.25,542.5,321.92,14589,10373,1383,5127,6510,3863,2022,'VALE VERDE',Vale Verde,'RS',4322525,1063.0,1063,88.6,88.6,1,72.0,72.0,Pequeno I
5030,5082,432253,2994,2154,668,474,1142,1012,2828.5,2069.08,600.42,342.33,942.75,1126.33,33942,24829,7205,4108,11313,13516,2022,'VALE DO SOL',Vale do Sol,'RS',4322533,1368.0,1368,114.0,114.0,1,86.0,86.0,Pequeno I
5031,5083,432254,1687,629,87,90,177,452,1651.5,635.58,79.83,84.08,163.92,471.67,19818,7627,958,1009,1967,5660,2022,'VALE REAL',Vale Real,'RS',4322541,644.0,644,53.7,53.7,1,31.0,31.0,Pequeno I
5032,5084,432255,310,205,30,100,130,75,291.5,190.33,26.67,87.17,113.83,76.5,3498,2284,320,1046,1366,918,2022,'VANINI',Vanini,'RS',4322558,298.0,298,24.8,24.8,1,7.0,7.0,Pequeno I
5033,5085,432260,16690,13430,2906,6100,9006,4424,15174.0,12352.42,2776.17,5296.42,8072.58,4279.83,182088,148229,33314,63557,96871,51358,2022,'VENANCIO AIRES',Venâncio Aires,'RS',4322608,2011.0,2011,167.6,167.6,1,262.0,262.0,Médio
5034,5086,432270,6765,5767,1794,1905,3699,2068,6264.83,5422.83,1637.5,1859.5,3497.0,1925.83,75178,65074,19650,22314,41964,23110,2022,'VERA CRUZ',Vera Cruz,'RS',4322707,3684.0,3684,307.0,307.0,1,226.0,226.0,Pequeno II
5035,5087,432280,3689,2292,425,590,1015,1277,3668.58,2348.67,409.25,657.33,1066.58,1282.08,44023,28184,4911,7888,12799,15385,2022,'VERANOPOLIS',Veranópolis,'RS',4322806,3699.0,3699,308.2,308.2,1,267.0,267.0,Pequeno II
5036,5088,432285,471,86,9,25,34,52,450.92,88.5,7.33,21.25,28.58,59.92,5411,1062,88,255,343,719,2022,'VESPASIANO CORREA',Vespasiano Correa,'RS',4322855,693.0,693,57.8,57.8,1,72.0,72.0,Pequeno I
5037,5089,432290,1061,739,185,196,381,358,1027.75,712.75,201.17,170.0,371.17,341.58,12333,8553,2414,2040,4454,4099,2022,'VIADUTOS',Viadutos,'RS',4322905,744.0,744,62.0,62.0,1,38.0,38.0,Pequeno I
5038,5090,432300,87454,73834,7814,48489,56303,17531,78779.42,66583.25,7670.17,42461.08,50131.25,16452.0,945353,798999,92042,509533,601575,197424,2022,'VIAMAO',Viamão,'RS',4323002,42833.0,42833,3893.9,3893.9,6,,,Grande
5039,5091,432310,2794,2296,259,1769,2028,268,2601.33,2127.83,213.42,1618.33,1831.75,296.08,31216,25534,2561,19420,21981,3553,2022,'VICENTE DUTRA',Vicente Dutra,'RS',4323101,1790.0,1790,149.2,149.2,1,41.0,41.0,Pequeno I
5040,5093,432330,542,250,51,46,97,153,488.92,227.75,38.67,41.17,79.83,147.92,5867,2733,464,494,958,1775,2022,'VILA FLORES',Vila Flores,'RS',4323309,652.0,652,54.3,54.3,1,50.0,50.0,Pequeno I
5041,5094,432335,552,250,27,27,54,196,519.58,240.17,26.17,36.25,62.42,177.75,6235,2882,314,435,749,2133,2022,'VILA LANGARO',Vila Lângaro,'RS',4323358,318.0,318,26.5,26.5,1,15.0,15.0,Pequeno I
5042,5095,432340,926,528,95,191,286,242,900.83,522.58,86.25,159.42,245.67,276.92,10810,6271,1035,1913,2948,3323,2022,'VILA MARIA',Vila Maria,'RS',4323408,965.0,965,80.4,80.4,1,77.0,77.0,Pequeno I
5043,5096,432345,1951,1776,25,1532,1557,219,1806.33,1650.33,32.67,1406.25,1438.92,211.42,21676,19804,392,16875,17267,2537,2022,'VILA NOVA DO SUL',Vila Nova do Sul,'RS',4323457,3641.0,3641,303.4,303.4,1,249.0,249.0,Pequeno I
5044,5097,432350,911,557,126,133,259,298,902.58,562.08,109.92,160.08,270.0,292.08,10831,6745,1319,1921,3240,3505,2022,'VISTA ALEGRE',Vista Alegre,'RS',4323507,515.0,515,42.9,42.9,1,22.0,22.0,Pequeno I
5045,5098,432360,754,180,13,51,64,116,711.58,162.5,12.5,39.0,51.5,111.0,8539,1950,150,468,618,1332,2022,'VISTA ALEGRE DO PRATA',Vista Alegre do Prata,'RS',4323606,6356.0,6356,529.7,529.7,1,582.0,582.0,Pequeno I
5046,5099,432370,962,643,77,330,407,236,879.67,611.67,72.58,337.17,409.75,201.92,10556,7340,871,4046,4917,2423,2022,'VISTA GAUCHA',Vista Gaúcha,'RS',4323705,706.0,706,58.8,58.8,1,74.0,74.0,Pequeno I
5047,5100,432375,1448,1069,342,342,684,385,1358.42,1029.67,279.33,399.5,678.83,350.83,16301,12356,3352,4794,8146,4210,2022,'VITORIA DAS MISSOES',Vitória Das Missões,'RS',4323754,1252.0,1252,104.3,104.3,1,98.0,98.0,Pequeno I
5048,5101,432377,561,155,11,25,36,119,523.33,143.67,4.75,23.0,27.75,115.92,6280,1724,57,276,333,1391,2022,'WESTFALIA',Westfalia,'RS',4323770,411.0,411,34.2,34.2,1,42.0,42.0,Pequeno I
5049,5102,432380,6324,4951,891,2346,3237,1714,5788.33,4614.5,762.92,2300.17,3063.08,1551.42,69460,55374,9155,27602,36757,18617,2022,'XANGRI-LA',Xangri-lá,'RS',4323804,4014.0,4014,334.5,334.5,1,328.0,328.0,Pequeno I
5050,5103,500020,9659,7627,942,4865,5807,1820,8771.08,7044.42,778.0,4480.08,5258.08,1786.33,105253,84533,9336,53761,63097,21436,2022,'AGUA CLARA',Água Clara,'MS',5000203,7204.0,10971,600.3,914.2,1,970.0,970.0,Pequeno I
5051,5104,500025,3223,2304,294,1230,1524,780,3132.5,2263.0,287.17,1162.92,1450.08,812.92,37590,27156,3446,13955,17401,9755,2022,'ALCINOPOLIS',Alcinópolis,'MS',5000252,2766.0,2766,230.5,230.5,1,104.0,104.0,Pequeno I
5052,5105,500060,26135,20076,2746,11317,14063,6013,24925.67,19202.83,2579.08,11116.33,13695.42,5507.42,299108,230434,30949,133396,164345,66089,2022,'AMAMBAI',Amambaí,'MS',5000609,5073.0,7809,422.8,650.8,1,420.0,420.0,Pequeno II
5053,5106,500070,14368,11483,2264,5407,7671,3812,13397.0,10806.33,2110.0,5081.17,7191.17,3615.17,160764,129676,25320,60974,86294,43382,2022,'ANASTACIO',Anastácio,'MS',5000708,1587.0,31450,144.3,2859.1,1,0.0,4566.0,Pequeno II
5054,5107,500080,4385,3061,585,1048,1633,1428,4258.17,3009.33,563.5,1056.83,1620.33,1389.0,51098,36112,6762,12682,19444,16668,2022,'ANAURILANDIA',Anaurilândia,'MS',5000807,3919.0,3919,326.6,326.6,1,222.0,222.0,Pequeno I
5055,5108,500085,5806,4474,1229,1523,2752,1722,5570.58,4375.25,1177.0,1714.5,2891.5,1483.75,66847,52503,14124,20574,34698,17805,2022,'ANGELICA',Angélica,'MS',5000856,4413.0,4413,367.8,367.8,1,252.0,252.0,Pequeno I
5056,5109,500090,6146,4779,819,1513,2332,2447,5942.75,4693.92,848.42,1615.67,2464.08,2229.83,71313,56327,10181,19388,29569,26758,2022,'ANTONIO JOAO',Antônio João,'MS',5000906,7107.0,7107,592.2,592.2,1,135.0,135.0,Pequeno I
5057,5110,500100,11261,9324,1676,3462,5138,4186,10545.67,8885.83,1525.0,3853.25,5378.25,3507.58,126548,106630,18300,46239,64539,42091,2022,'APARECIDA DO TABOADO',Aparecida do Taboado,'MS',5001003,10264.0,10264,933.1,933.1,1,784.0,784.0,Pequeno II
5058,5111,500110,29624,23215,4847,10795,15642,7573,26988.92,21537.83,4502.5,9950.08,14452.58,7085.25,323867,258454,54030,119401,173431,85023,2022,'AQUIDAUANA',Aquidauana,'MS',5001102,24222.0,24222,2018.5,2018.5,2,880.0,880.0,Pequeno II
5059,5112,500124,7012,6174,927,3817,4744,1430,6708.0,5934.25,894.17,3617.67,4511.83,1422.42,80496,71211,10730,43412,54142,17069,2022,'ARAL MOREIRA',Aral Moreira,'MS',5001243,7273.0,7273,661.2,661.2,1,131.0,131.0,Pequeno I
5060,5113,500150,3997,3218,612,1598,2210,1008,3673.0,2962.08,571.58,1470.25,2041.83,920.25,44076,35545,6859,17643,24502,11043,2022,'BANDEIRANTES',Bandeirantes,'MS',5001508,6257.0,6257,568.8,568.8,1,187.0,187.0,Pequeno I
5061,5114,500190,15101,10985,2404,3423,5827,5158,14528.0,10737.08,2271.08,3382.17,5653.25,5083.83,174336,128845,27253,40586,67839,61006,2022,'BATAGUASSU',Bataguassu,'MS',5001904,5323.0,16967,443.6,1413.9,2,760.0,760.0,Pequeno I
5062,5115,500200,7178,5358,500,3147,3647,1711,6910.08,5276.25,495.5,3205.08,3700.58,1575.67,82921,63315,5946,38461,44407,18908,2022,'BATAYPORA',Batayporã,'MS',5002001,5900.0,9244,491.7,770.3,1,333.0,333.0,Pequeno I
5063,5116,500210,13520,11198,3154,5381,8535,2663,12673.25,10543.67,2827.25,5224.0,8051.25,2492.42,152079,126524,33927,62688,96615,29909,2022,'BELA VISTA',Bela Vista,'MS',5002100,10298.0,10298,936.2,936.2,2,648.0,648.0,Pequeno II
5064,5117,500215,4458,3628,435,1963,2398,1230,4281.17,3524.0,371.83,2004.25,2376.08,1147.92,51374,42288,4462,24051,28513,13775,2022,'BODOQUENA',Bodoquena,'MS',5002159,3911.0,3911,325.9,325.9,1,215.0,215.0,Pequeno I
5065,5118,500220,10348,8499,1256,4171,5427,3072,9312.25,7655.5,1277.58,3622.08,4899.67,2755.83,111747,91866,15331,43465,58796,33070,2022,'BONITO',Bonito,'MS',5002209,6947.0,6947,578.9,578.9,1,617.0,617.0,Pequeno I
5066,5119,500230,5619,4757,707,2859,3566,1191,5255.25,4515.25,590.75,2906.67,3497.42,1017.83,63063,54183,7089,34880,41969,12214,2022,'BRASILANDIA',Brasilândia,'MS',5002308,6337.0,9794,528.1,816.2,1,608.0,608.0,Pequeno I
5067,5120,500240,13940,11039,1677,4577,6254,4785,13299.5,10689.17,1713.75,4652.33,6366.08,4323.08,159594,128270,20565,55828,76393,51877,2022,'CAARAPO',Caarapó,'MS',5002407,11286.0,11286,940.5,940.5,2,490.0,490.0,Pequeno II
5068,5121,500260,8093,6086,723,3437,4160,1926,7713.42,5935.25,691.92,3385.0,4076.92,1858.33,92561,71223,8303,40620,48923,22300,2022,'CAMAPUA',Camapuã,'MS',5002605,4508.0,4508,375.7,375.7,1,179.0,179.0,Pequeno I
5069,5122,500270,412495,306664,47520,128993,176513,130151,382532.92,285892.92,44693.08,116677.33,161370.42,124522.5,4590395,3430715,536317,1400128,1936445,1494270,2022,'CAMPO GRANDE',Campo Grande,'MS',5002704,309265.0,362750,25772.1,30229.2,21,22377.0,29431.0,Grande
5070,5123,500280,3964,3080,468,1707,2175,905,3817.92,3014.08,485.33,1604.92,2090.25,923.83,45815,36169,5824,19259,25083,11086,2022,'CARACOL',Caracol,'MS',5002803,5124.0,5124,427.0,427.0,1,233.0,233.0,Pequeno I
5071,5124,500290,10507,7467,1340,2452,3792,3675,9943.33,7162.83,1227.0,2406.67,3633.67,3529.17,119320,85954,14724,28880,43604,42350,2022,'CASSILANDIA',Cassilândia,'MS',5002902,10989.0,10989,915.8,915.8,1,520.0,520.0,Pequeno II
5072,5125,500295,11521,8595,1635,3231,4866,3729,10574.67,7960.08,1537.67,3038.83,4576.5,3383.58,126896,95521,18452,36466,54918,40603,2022,'CHAPADAO DO SUL',Chapadão do Sul,'MS',5002951,10736.0,23247,894.7,1937.2,2,1324.0,1324.0,Pequeno I
5073,5126,500310,2413,1860,194,1059,1253,607,2261.17,1793.83,234.58,1013.92,1248.5,545.33,27134,21526,2815,12167,14982,6544,2022,'CORGUINHO',Corguinho,'MS',5003108,427.0,427,35.6,35.6,1,55.0,55.0,Pequeno I
5074,5127,500315,13092,11680,798,9432,10230,1450,11995.0,10689.83,762.25,8344.42,9106.67,1583.17,143940,128278,9147,100133,109280,18998,2022,'CORONEL SAPUCAIA',Coronel Sapucaia,'MS',5003157,2483.0,14551,225.7,1322.8,1,890.0,890.0,Pequeno I
5075,5128,500320,62710,49959,12203,21016,33219,16740,59602.42,47871.92,11678.42,19711.67,31390.08,16481.83,715229,574463,140141,236540,376681,197782,2022,'CORUMBA',Corumbá,'MS',5003207,80282.0,80282,6690.2,6690.2,5,5951.0,5951.0,Grande
5076,5129,500325,15416,12450,1618,7424,9042,3408,14060.67,11417.5,1379.5,6902.75,8282.25,3135.25,168728,137010,16554,82833,99387,37623,2022,'COSTA RICA',Costa Rica,'MS',5003256,0.0,25179,0.0,2797.7,1,0.0,1976.0,Pequeno I
5077,5130,500330,18115,13940,1429,7867,9296,4644,17081.83,13316.17,1308.08,7476.75,8784.83,4531.33,204982,159794,15697,89721,105418,54376,2022,'COXIM',Coxim,'MS',5003306,23952.0,30577,1996.0,2548.1,2,954.0,954.0,Pequeno II
5078,5131,500345,6299,4834,891,1638,2529,2305,5831.33,4561.92,803.5,1744.0,2547.5,2014.42,69976,54743,9642,20928,30570,24173,2022,'DEODAPOLIS',Deodápolis,'MS',5003454,4987.0,4987,415.6,415.6,1,237.0,237.0,Pequeno I
5079,5132,500348,6806,5649,513,3785,4298,1351,6565.33,5455.58,579.25,3553.67,4132.92,1322.67,78784,65467,6951,42644,49595,15872,2022,'DOIS IRMAOS DO BURITI',Dois Irmãos do Buriti,'MS',5003488,2418.0,2418,201.5,201.5,1,186.0,186.0,Pequeno I
5080,5133,500350,3806,2513,332,797,1129,1384,3709.83,2490.33,317.42,854.17,1171.58,1318.75,44518,29884,3809,10250,14059,15825,2022,'DOURADINA',Douradina,'MS',5003504,2587.0,2587,215.6,215.6,1,84.0,84.0,Pequeno I
5081,5134,500370,85056,69741,10632,32855,43487,26254,78905.0,65140.25,9270.92,33053.33,42324.25,22816.0,946860,781683,111251,396640,507891,273792,2022,'DOURADOS',Dourados,'MS',5003702,35933.0,35933,2994.4,2994.4,7,1934.0,1934.0,Grande
5082,5135,500375,7878,5486,794,1809,2603,2883,7487.42,5449.75,808.33,1919.08,2727.42,2722.33,89849,65397,9700,23029,32729,32668,2022,'ELDORADO',Eldorado,'MS',5003751,7291.0,8388,607.6,699.0,1,585.0,585.0,Pequeno I
5083,5136,500380,10346,8145,2311,1361,3672,4473,9743.67,7731.5,2218.75,1519.83,3738.58,3992.92,116924,92778,26625,18238,44863,47915,2022,'FATIMA DO SUL',Fátima do Sul,'MS',5003801,7679.0,7679,639.9,639.9,1,280.0,280.0,Pequeno I
5084,5137,500390,1640,1245,215,767,982,263,1503.83,1158.75,181.83,672.75,854.58,304.17,18046,13905,2182,8073,10255,3650,2022,'FIGUEIRAO',Figueirão,'MS',5003900,973.0,24579,81.1,2048.2,1,973.0,973.0,Pequeno I
5085,5138,500400,4769,3493,658,1157,1815,1678,4502.83,3330.5,665.17,1112.58,1777.75,1552.75,54034,39966,7982,13351,21333,18633,2022,'GLORIA DE DOURADOS',Glória de Dourados,'MS',5004007,2802.0,2802,254.7,254.7,1,124.0,124.0,Pequeno I
5086,5139,500410,6513,5216,591,2966,3557,1659,6286.75,5079.92,536.42,2977.33,3513.75,1566.17,75441,60959,6437,35728,42165,18794,2022,'GUIA LOPES DA LAGUNA',Guia Lopes da Laguna,'MS',5004106,5726.0,5726,477.2,477.2,1,201.0,201.0,Pequeno I
5087,5140,500430,8093,6405,1026,2725,3751,2654,7595.75,6093.33,926.5,2755.08,3681.58,2411.75,91149,73120,11118,33061,44179,28941,2022,'IGUATEMI',Iguatemi,'MS',5004304,9023.0,10213,751.9,851.1,1,801.0,801.0,Pequeno I
5088,5141,500440,4507,2970,543,1142,1685,1285,4252.17,2843.58,464.5,1114.67,1579.17,1264.42,51026,34123,5574,13376,18950,15173,2022,'INOCENCIA',Inocência,'MS',5004403,2294.0,17350,191.2,1445.8,1,651.0,651.0,Pequeno I
5089,5142,500450,5628,4092,828,961,1789,2303,5021.08,3707.83,727.33,951.58,1678.92,2028.92,60253,44494,8728,11419,20147,24347,2022,'ITAPORA',Itaporã,'MS',5004502,2552.0,2552,212.7,212.7,1,101.0,101.0,Pequeno II
5090,5143,500460,11688,8150,1594,1678,3272,4878,10962.5,7732.17,1533.08,1945.5,3478.58,4253.58,131550,92786,18397,23346,41743,51043,2022,'ITAQUIRAI',Itaquiraí,'MS',5004601,7990.0,7990,665.8,665.8,1,428.0,428.0,Pequeno I
5091,5144,500470,8760,6401,1690,1535,3225,3176,7860.42,5765.83,1551.75,1363.08,2914.83,2851.0,94325,69190,18621,16357,34978,34212,2022,'IVINHEMA',Ivinhema,'MS',5004700,11344.0,11344,945.3,945.3,2,491.0,491.0,Pequeno II
5092,5145,500480,6905,6198,723,4357,5080,1118,6790.75,6165.67,603.92,4551.25,5155.17,1010.5,81489,73988,7247,54615,61862,12126,2022,'JAPORA',Japorã,'MS',5004809,3958.0,3958,329.8,329.8,1,134.0,134.0,Pequeno I
5093,5146,500490,3198,2290,517,580,1097,1193,2974.25,2166.5,486.83,581.17,1068.0,1098.5,35691,25998,5842,6974,12816,13182,2022,'JARAGUARI',Jaraguari,'MS',5004908,2299.0,2299,191.6,191.6,1,85.0,85.0,Pequeno I
5094,5147,500500,12557,9884,3523,1093,4616,5268,12003.67,9506.75,3142.33,1268.83,4411.17,5095.58,144044,114081,37708,15226,52934,61147,2022,'JARDIM',Jardim,'MS',5005004,11524.0,11524,960.3,960.3,1,888.0,888.0,Pequeno II
5095,5148,500510,2101,1560,146,896,1042,518,1968.25,1476.25,120.08,892.33,1012.42,463.83,23619,17715,1441,10708,12149,5566,2022,'JATEI',Jateí,'MS',5005103,869.0,869,72.4,72.4,1,34.0,34.0,Pequeno I
5096,5149,500515,4880,4112,640,2159,2799,1313,4690.0,4015.5,609.58,2209.08,2818.67,1196.83,56280,48186,7315,26509,33824,14362,2022,'JUTI',Juti,'MS',5005152,5531.0,5531,460.9,460.9,1,290.0,290.0,Pequeno I
5097,5150,500520,11199,9444,2076,4701,6777,2667,10721.08,9190.67,1967.92,4767.67,6735.58,2455.08,128653,110288,23615,57212,80827,29461,2022,'LADARIO',Ladário,'MS',5005202,4272.0,4272,388.4,388.4,1,330.0,330.0,Pequeno I
5098,5151,500525,3311,2912,440,1646,2086,826,3096.0,2755.33,395.92,1645.75,2041.67,713.67,37152,33064,4751,19749,24500,8564,2022,'LAGUNA CARAPA',Laguna Carapã,'MS',5005251,5480.0,5480,456.7,456.7,1,271.0,271.0,Pequeno I
5099,5152,500540,16056,11415,3502,1550,5052,6363,14920.17,10806.08,3430.0,1507.17,4937.17,5868.92,179042,129673,41160,18086,59246,70427,2022,'MARACAJU',Maracaju,'MS',5005400,13563.0,18522,1130.2,1543.5,1,0.0,2436.0,Pequeno II
5100,5153,500560,16768,15025,770,12325,13095,1930,15823.33,14282.17,710.5,11917.42,12627.92,1654.25,189880,171386,8526,143009,151535,19851,2022,'MIRANDA',Miranda,'MS',5005608,7697.0,11128,641.4,927.3,1,893.0,893.0,Pequeno II
5101,5154,500568,11908,8618,1827,3344,5171,3447,11058.33,8080.83,1677.67,3154.25,4831.92,3248.92,132700,96970,20132,37851,57983,38987,2022,'MUNDO NOVO',Mundo Novo,'MS',5005681,6451.0,6451,537.6,537.6,2,97.0,97.0,Pequeno I
5102,5155,500570,23773,18267,2846,9377,12223,6044,21648.92,16755.83,2692.17,8125.92,10818.08,5937.75,259787,201070,32306,97511,129817,71253,2022,'NAVIRAI',Naviraí,'MS',5005707,12267.0,12267,1022.2,1022.2,2,921.0,921.0,Pequeno II
5103,5156,500580,9301,7401,1899,3042,4941,2460,8982.25,7280.5,1775.08,3210.92,4986.0,2294.5,107787,87366,21301,38531,59832,27534,2022,'NIOAQUE',Nioaque,'MS',5005806,7283.0,8831,606.9,735.9,1,398.0,398.0,Pequeno I
5104,5157,500600,10787,8706,2135,2405,4540,4166,10150.58,8361.33,1970.83,2787.08,4757.92,3603.42,121807,100336,23650,33445,57095,43241,2022,'NOVA ALVORADA DO SUL',Nova Alvorada do Sul,'MS',5006002,6469.0,6469,539.1,539.1,1,123.0,123.0,Pequeno I
5105,5158,500620,24802,19029,3010,8954,11964,7065,23308.75,18056.5,2939.67,8334.17,11273.83,6782.67,279705,216678,35276,100010,135286,81392,2022,'NOVA ANDRADINA',Nova Andradina,'MS',5006200,24345.0,24345,2028.8,2028.8,2,1101.0,1101.0,Pequeno II
5106,5159,500625,1748,1328,230,523,753,575,1611.92,1230.5,214.25,454.58,668.83,561.67,19343,14766,2571,5455,8026,6740,2022,'NOVO HORIZONTE DO SUL',Novo Horizonte do Sul,'MS',5006259,1474.0,1474,122.8,122.8,1,82.0,82.0,Pequeno I
5107,5160,500627,2468,1802,318,480,798,1004,2351.42,1743.0,307.17,510.92,818.08,924.92,28217,20916,3686,6131,9817,11099,2022,'PARAISO DAS AGUAS',Paraíso das Águas,'MS',5006275,3293.0,3293,274.4,274.4,1,108.0,108.0,Pequeno I
5108,5161,500630,20416,14210,3250,4202,7452,6758,19007.25,13220.58,2855.83,4091.42,6947.25,6273.33,228087,158647,34270,49097,83367,75280,2022,'PARANAIBA',Paranaíba,'MS',5006309,8351.0,8351,695.9,695.9,2,714.0,714.0,Pequeno II
5109,5162,500635,9801,8573,926,6109,7035,1538,9639.83,8582.42,825.58,6401.25,7226.83,1355.58,115678,102989,9907,76815,86722,16267,2022,'PARANHOS',Paranhos,'MS',5006358,2922.0,2922,243.5,243.5,1,120.0,120.0,Pequeno I
5110,5163,500640,4423,3463,169,2290,2459,1004,4274.83,3366.5,189.75,2172.58,2362.33,1004.17,51298,40398,2277,26071,28348,12050,2022,'PEDRO GOMES',Pedro Gomes,'MS',5006408,713.0,713,59.4,59.4,1,81.0,81.0,Pequeno I
5111,5164,500660,60059,48226,14787,16486,31273,16953,55592.83,45221.33,13947.25,15186.75,29134.0,16087.33,667114,542656,167367,182241,349608,193048,2022,'PONTA PORA',Ponta Porã,'MS',5006606,67931.0,70755,5660.9,5896.2,4,3770.0,3770.0,Médio
5112,5165,500690,8006,6301,2167,2116,4283,2018,7574.5,6014.92,1698.5,2387.5,4086.0,1928.92,90894,72179,20382,28650,49032,23147,2022,'PORTO MURTINHO',Porto Murtinho,'MS',5006903,7442.0,7442,620.2,620.2,1,509.0,509.0,Pequeno I
5113,5166,500710,10200,8111,2116,2223,4339,3772,9403.58,7712.33,2043.75,2352.0,4395.75,3316.58,112843,92548,24525,28224,52749,39799,2022,'RIBAS DO RIO PARDO',Ribas do Rio Pardo,'MS',5007109,9049.0,9049,822.6,822.6,1,,,Pequeno II
5114,5167,500720,15187,11614,2472,3551,6023,5591,14544.25,11300.92,2456.75,3762.0,6218.75,5082.17,174531,135611,29481,45144,74625,60986,2022,'RIO BRILHANTE',Rio Brilhante,'MS',5007208,20281.0,20281,1690.1,1690.1,3,826.0,826.0,Pequeno II
5115,5168,500730,2961,1940,371,603,974,966,2921.33,1944.17,371.0,585.33,956.33,987.83,35056,23330,4452,7024,11476,11854,2022,'RIO NEGRO',Rio Negro,'MS',5007307,1357.0,1357,123.4,123.4,1,53.0,53.0,Pequeno I
5116,5169,500740,12949,9738,2276,3681,5957,3781,12469.75,9528.0,1790.5,4113.83,5904.33,3623.67,149637,114336,21486,49366,70852,43484,2022,'RIO VERDE DE MATO GROSSO',Rio Verde de Mato Grosso,'MS',5007406,1850.0,15843,154.2,1320.2,1,0.0,1420.0,Pequeno I
5117,5170,500750,3260,2564,388,1045,1433,1131,3004.33,2389.25,365.0,947.75,1312.75,1076.5,36052,28671,4380,11373,15753,12918,2022,'ROCHEDO',Rochedo,'MS',5007505,3703.0,3703,370.3,370.3,1,,,Pequeno I
5118,5171,500755,3390,2412,454,605,1059,1353,3120.08,2258.58,429.83,587.17,1017.0,1241.58,37441,27103,5158,7046,12204,14899,2022,'SANTA RITA DO PARDO',Santa Rita do Pardo,'MS',5007554,6608.0,7863,550.7,655.2,1,448.0,448.0,Pequeno I
5119,5172,500769,15043,9863,2544,1161,3705,6158,14335.33,9555.33,2232.58,1301.58,3534.17,6021.17,172024,114664,26791,15619,42410,72254,2022,'SAO GABRIEL DO OESTE',São Gabriel do Oeste,'MS',5007695,13217.0,13217,1101.4,1101.4,1,464.0,464.0,Pequeno II
5120,5173,500770,4354,3466,704,1127,1831,1635,4180.5,3362.92,670.08,1117.92,1788.0,1574.92,50166,40355,8041,13415,21456,18899,2022,'SETE QUEDAS',Sete Quedas,'MS',5007703,2781.0,2781,231.8,231.8,1,93.0,93.0,Pequeno I
5121,5174,500780,3707,2698,537,543,1080,1618,3408.25,2561.92,552.0,600.75,1152.75,1409.17,40899,30743,6624,7209,13833,16910,2022,'SELVIRIA',Selvíria,'MS',5007802,4087.0,4087,340.6,340.6,1,52.0,52.0,Pequeno I
5122,5175,500790,23226,18459,4003,6426,10429,8030,21580.42,17600.58,3736.58,6889.0,10625.58,6975.0,258965,211207,44839,82668,127507,83700,2022,'SIDROLANDIA',Sidrolândia,'MS',5007901,22901.0,22901,1908.4,1908.4,3,807.0,807.0,Pequeno II
5123,5176,500793,6188,4893,1033,1772,2805,2088,5806.92,4693.08,992.25,1782.33,2774.58,1918.5,69683,56317,11907,21388,33295,23022,2022,'SONORA',Sonora,'MS',5007935,5883.0,5883,490.2,490.2,1,420.0,420.0,Pequeno I
5124,5177,500795,7948,7013,415,5822,6237,776,7473.83,6579.92,383.33,5414.0,5797.33,782.58,89686,78959,4600,64968,69568,9391,2022,'TACURU',Tacuru,'MS',5007950,7396.0,8441,616.3,703.4,1,387.0,387.0,Pequeno I
5125,5178,500797,2347,1746,588,487,1075,671,2254.0,1695.75,537.83,506.33,1044.17,651.58,27048,20349,6454,6076,12530,7819,2022,'TAQUARUSSU',Taquarussu,'MS',5007976,2476.0,2476,206.3,206.3,1,148.0,148.0,Pequeno I
5126,5179,500800,9373,6922,1994,1653,3647,3275,8896.92,6654.67,2041.92,1435.42,3477.33,3177.33,106763,79856,24503,17225,41728,38128,2022,'TERENOS',Terenos,'MS',5008008,2957.0,2957,246.4,246.4,1,150.0,150.0,Pequeno I
5127,5180,500830,60464,44715,10159,14994,25153,19562,53989.5,41289.58,9277.33,14284.25,23561.58,17728.0,647874,495475,111328,171411,282739,212736,2022,'TRES LAGOAS',Três Lagoas,'MS',5008305,99888.0,106868,8324.0,8905.7,6,7191.0,10922.0,Grande
5128,5181,500840,4028,2777,336,1240,1576,1201,3877.17,2704.5,326.83,1193.42,1520.25,1184.25,46526,32454,3922,14321,18243,14211,2022,'VICENTINA',Vicentina,'MS',5008404,2408.0,2408,200.7,200.7,1,153.0,153.0,Pequeno I
5129,5182,510010,4486,3680,451,2461,2912,768,4419.75,3639.5,426.83,2446.25,2873.08,766.42,53037,43674,5122,29355,34477,9197,2022,'ACORIZAL',Acorizal,'MT',5100102,1136.0,1136,94.7,94.7,1,49.0,49.0,Pequeno I
5130,5183,510020,12275,7799,1397,1838,3235,4564,11599.42,7471.75,1425.25,1914.08,3339.33,4132.42,139193,89661,17103,22969,40072,49589,2022,'AGUA BOA',Água Boa,'MT',5100201,5552.0,5552,462.7,462.7,1,410.0,410.0,Pequeno II
5131,5184,510025,21143,16010,1898,8433,10331,5679,19305.67,14770.58,1911.0,7487.25,9398.25,5372.33,231668,177247,22932,89847,112779,64468,2022,'ALTA FLORESTA',Alta Floresta,'MT',5100250,9839.0,9839,819.9,819.9,2,1055.0,1055.0,Pequeno II
5132,5185,510030,7950,5888,651,2901,3552,2336,7591.33,5799.92,631.75,3044.42,3676.17,2123.75,91096,69599,7581,36533,44114,25485,2022,'ALTO ARAGUAIA',Alto Araguaia,'MT',5100300,6956.0,8344,579.7,695.3,1,750.0,750.0,Pequeno I
5133,5186,510035,3442,2640,744,994,1738,902,3374.83,2629.58,661.0,1177.83,1838.83,790.75,40498,31555,7932,14134,22066,9489,2022,'ALTO BOA VISTA',Alto Boa Vista,'MT',5100359,2123.0,2123,176.9,176.9,1,63.0,63.0,Pequeno I
5134,5187,510040,6186,5273,603,3400,4003,1270,5884.5,5020.17,522.17,3322.75,3844.92,1175.25,70614,60242,6266,39873,46139,14103,2022,'ALTO GARCAS',Alto Garças,'MT',5100409,2514.0,2514,279.3,279.3,1,379.0,379.0,Pequeno I
5135,5188,510050,5335,4276,565,2929,3494,782,5053.75,4047.42,566.83,2703.08,3269.92,777.5,60645,48569,6802,32437,39239,9330,2022,'ALTO PARAGUAI',Alto Paraguai,'MT',5100508,4736.0,5796,394.7,483.0,1,0.0,1060.0,Pequeno I
5136,5189,510060,4608,3490,869,582,1451,2039,4128.83,3123.42,706.75,641.0,1347.75,1775.67,49546,37481,8481,7692,16173,21308,2022,'ALTO TAQUARI',Alto Taquari,'MT',5100607,6562.0,6562,546.8,546.8,1,756.0,756.0,Pequeno I
5137,5190,510080,4643,3566,665,1362,2027,1539,4329.0,3426.58,668.58,1474.75,2143.33,1283.25,51948,41119,8023,17697,25720,15399,2022,'APIACAS',Apiacás,'MT',5100805,2399.0,2399,239.9,239.9,1,308.0,308.0,Pequeno I
5138,5191,510100,1825,1471,193,827,1020,451,1733.67,1408.42,181.5,791.33,972.83,435.58,20804,16901,2178,9496,11674,5227,2022,'ARAGUAIANA',Araguaiana,'MT',5101001,2035.0,2035,169.6,169.6,1,225.0,225.0,Pequeno I
5139,5192,510120,564,407,19,310,329,78,545.83,389.25,20.42,299.17,319.58,69.67,6550,4671,245,3590,3835,836,2022,'ARAGUAINHA',Araguainha,'MT',5101209,1149.0,1149,95.8,95.8,1,87.0,87.0,Pequeno I
5140,5193,510125,6126,5132,753,2213,2966,2166,5796.58,5008.17,706.0,2442.08,3148.08,1860.08,69559,60098,8472,29305,37777,22321,2022,'ARAPUTANGA',Araputanga,'MT',5101258,6550.0,6550,545.8,545.8,1,348.0,348.0,Pequeno I
5141,5194,510130,4696,3761,861,1716,2577,1184,4407.67,3558.83,814.08,1570.25,2384.33,1174.5,52892,42706,9769,18843,28612,14094,2022,'ARENAPOLIS',Arenápolis,'MT',5101308,4756.0,4756,396.3,396.3,1,328.0,328.0,Pequeno I
5142,5195,510140,9287,7700,3260,2318,5578,2122,8745.0,7325.42,2842.75,2609.42,5452.17,1873.25,104940,87905,34113,31313,65426,22479,2022,'ARIPUANA',Aripuanã,'MT',5101407,881.0,881,73.4,73.4,1,108.0,108.0,Pequeno I
5143,5196,510160,5186,4514,132,4049,4181,333,4892.5,4262.25,172.0,3725.75,3897.75,364.5,58710,51147,2064,44709,46773,4374,2022,'BARAO DE MELGACO',Barão de Melgaço,'MT',5101605,3986.0,3986,332.2,332.2,1,266.0,266.0,Pequeno I
5144,5197,510170,15011,12590,2587,5760,8347,4243,14186.33,12008.5,2495.83,5547.67,8043.5,3965.0,170236,144102,29950,66572,96522,47580,2022,'BARRA DO BUGRES',Barra do Bugres,'MT',5101704,12964.0,12964,1080.3,1080.3,2,1185.0,1185.0,Pequeno II
5145,5198,510180,38668,30305,5162,15544,20706,9599,36681.67,28911.67,5326.83,14221.33,19548.17,9363.5,440180,346940,63922,170656,234578,112362,2022,'BARRA DO GARCAS',Barra do Garças,'MT',5101803,23664.0,23664,1972.0,1972.0,2,1313.0,1313.0,Médio
5146,5199,510185,5309,4218,1669,1327,2996,1222,5063.5,4039.0,1655.0,1205.5,2860.5,1178.5,60762,48468,19860,14466,34326,14142,2022,'BOM JESUS DO ARAGUAIA',Bom Jesus do Araguaia,'MT',5101852,1393.0,1393,116.1,116.1,1,230.0,230.0,Pequeno I
5147,5200,510190,7764,5891,1622,1267,2889,3002,7161.08,5558.17,1531.17,1299.92,2831.08,2727.08,85933,66698,18374,15599,33973,32725,2022,'BRASNORTE',Brasnorte,'MT',5101902,3123.0,3123,260.2,260.2,1,152.0,152.0,Pequeno I
5148,5201,510250,50594,42187,6883,23612,30495,11692,48099.75,40493.17,6651.08,22976.08,29627.17,10866.0,577197,485918,79813,275713,355526,130392,2022,'CACERES',Cáceres,'MT',5102504,4680.0,4680,390.0,390.0,2,169.0,169.0,Médio
5149,5202,510260,9025,8374,1213,5591,6804,1570,8473.33,7917.83,1194.08,5410.42,6604.5,1313.33,101680,95014,14329,64925,79254,15760,2022,'CAMPINAPOLIS',Campinápolis,'MT',5102603,1206.0,1206,100.5,100.5,1,149.0,149.0,Pequeno I
5150,5203,510263,12496,9304,1794,1875,3669,5635,11108.67,8311.83,1717.33,1636.25,3353.58,4958.25,133304,99742,20608,19635,40243,59499,2022,'CAMPO NOVO DO PARECIS',Campo Novo do Parecis,'MT',5102637,9686.0,11703,807.2,975.2,1,1144.0,1144.0,Pequeno II
5151,5204,510267,19090,12510,2277,2058,4335,8175,17832.25,11950.42,2343.67,1886.83,4230.5,7719.92,213987,143405,28124,22642,50766,92639,2022,'CAMPO VERDE',Campo Verde,'MT',5102678,6775.0,6775,564.6,564.6,1,335.0,335.0,Pequeno II
5152,5205,510268,3927,3075,932,547,1479,1596,3754.58,3013.58,768.58,824.92,1593.5,1420.08,45055,36163,9223,9899,19122,17041,2022,'CAMPOS DE JULIO',Campos de Júlio,'MT',5102686,5098.0,5098,424.8,424.8,1,350.0,350.0,Pequeno I
5153,5206,510269,3144,2345,485,901,1386,959,3029.83,2295.25,493.5,886.58,1380.08,915.17,36358,27543,5922,10639,16561,10982,2022,'CANABRAVA DO NORTE',Canabrava do Norte,'MT',5102694,2402.0,2402,200.2,200.2,1,114.0,114.0,Pequeno I
5154,5207,510270,9824,7855,1340,3166,4506,3349,9382.33,7599.08,1298.08,3228.42,4526.5,3072.58,112588,91189,15577,38741,54318,36871,2022,'CANARANA',Canarana,'MT',5102702,7789.0,7789,649.1,649.1,1,577.0,577.0,Pequeno I
5155,5208,510279,5457,3739,597,994,1591,2148,5213.58,3659.33,578.58,1060.58,1639.17,2020.17,62563,43912,6943,12727,19670,24242,2022,'CARLINDA',Carlinda,'MT',5102793,1999.0,1999,166.6,166.6,1,128.0,128.0,Pequeno I
5156,5209,510285,3193,2363,691,652,1343,1020,3148.42,2409.83,658.42,714.08,1372.5,1037.33,37781,28918,7901,8569,16470,12448,2022,'CASTANHEIRA',Castanheira,'MT',5102850,2058.0,2058,171.5,171.5,1,122.0,122.0,Pequeno I
5157,5210,510300,11401,9756,709,7173,7882,1874,10603.75,9174.42,842.33,6602.5,7444.83,1729.58,127245,110093,10108,79230,89338,20755,2022,'CHAPADA DOS GUIMARAES',Chapada Dos Guimarães,'MT',5103007,2562.0,15993,213.5,1332.8,1,910.0,910.0,Pequeno I
5158,5211,510305,4710,3598,789,1105,1894,1704,4412.33,3345.92,700.5,983.33,1683.83,1662.08,52948,40151,8406,11800,20206,19945,2022,'CLAUDIA',Cláudia,'MT',5103056,5066.0,11862,422.2,988.5,1,579.0,579.0,Pequeno I
5159,5212,510310,3015,2416,609,945,1554,862,2752.0,2206.42,536.92,858.75,1395.67,810.75,33024,26477,6443,10305,16748,9729,2022,'COCALINHO',Cocalinho,'MT',5103106,2063.0,2063,187.5,187.5,1,88.0,88.0,Pequeno I
5160,5213,510320,11501,8871,2220,2390,4610,4261,10597.33,8390.0,1962.75,2424.5,4387.25,4002.75,127168,100680,23553,29094,52647,48033,2022,'COLIDER',Colíder,'MT',5103205,6628.0,6628,552.3,552.3,1,264.0,264.0,Pequeno II
5161,5214,510325,15116,11589,2843,2489,5332,6257,14055.25,11156.92,2840.83,3014.25,5855.08,5301.83,168663,133883,34090,36171,70261,63622,2022,'COLNIZA',Colniza,'MT',5103254,6879.0,6879,625.4,625.4,1,,,Pequeno II
5162,5215,510330,8554,6707,1807,2541,4348,2359,8382.58,6713.42,1591.75,2747.5,4339.25,2374.17,100591,80561,19101,32970,52071,28490,2022,'COMODORO',Comodoro,'MT',5103304,1957.0,1957,163.1,163.1,1,98.0,98.0,Pequeno I
5163,5216,510335,16127,13713,2772,6978,9750,3963,15525.67,13329.5,2500.5,6874.42,9374.92,3954.58,186308,159954,30006,82493,112499,47455,2022,'CONFRESA',Confresa,'MT',5103353,8706.0,8706,725.5,725.5,1,1263.0,1263.0,Pequeno II
5164,5217,510336,1661,1390,198,805,1003,387,1488.08,1261.33,168.5,755.58,924.08,337.25,17857,15136,2022,9067,11089,4047,2022,'CONQUISTA DOESTE',Conquista D´oeste,'MT',5103361,973.0,973,194.6,194.6,1,,,Pequeno I
5165,5218,510337,4953,3800,1460,879,2339,1461,4649.17,3648.08,1370.75,1010.08,2380.83,1267.25,55790,43777,16449,12121,28570,15207,2022,'COTRIGUACU',Cotriguaçu,'MT',5103379,1306.0,1306,118.7,118.7,1,135.0,135.0,Pequeno I
5166,5219,510340,260691,206411,47614,82615,130229,76182,240583.92,191360.08,44094.33,75374.83,119469.17,71890.92,2887007,2296321,529132,904498,1433630,862691,2022,'CUIABA',Cuiabá,'MT',5103403,125973.0,125973,10497.8,10497.8,14,9556.0,9556.0,Grande
5167,5220,510343,3454,2629,397,1332,1729,900,3252.58,2483.42,369.92,1248.58,1618.5,864.92,39031,29801,4439,14983,19422,10379,2022,'CURVELANDIA',Curvelândia,'MT',5103437,4299.0,4299,358.2,358.2,1,448.0,448.0,Pequeno I
5168,5221,510345,4072,3336,663,1546,2209,1127,3879.25,3219.67,549.5,1536.08,2085.58,1134.08,46551,38636,6594,18433,25027,13609,2022,'DENISE',Denise,'MT',5103452,2026.0,2026,168.8,168.8,1,68.0,68.0,Pequeno I
5169,5222,510350,9377,7291,2163,1694,3857,3434,8703.17,6832.5,1952.0,2021.75,3973.75,2858.75,104438,81990,23424,24261,47685,34305,2022,'DIAMANTINO',Diamantino,'MT',5103502,8628.0,8628,719.0,719.0,1,1741.0,1741.0,Pequeno II
5170,5223,510360,4533,3403,120,2588,2708,695,4416.92,3404.5,114.33,2603.58,2717.92,686.58,53003,40854,1372,31243,32615,8239,2022,'DOM AQUINO',Dom Aquino,'MT',5103601,3075.0,3075,256.2,256.2,1,153.0,153.0,Pequeno I
5171,5224,510370,5774,4935,803,3006,3809,1126,5447.0,4663.83,694.58,2915.83,3610.42,1053.42,65364,55966,8335,34990,43325,12641,2022,'FELIZ NATAL',Feliz Natal,'MT',5103700,4402.0,4402,366.8,366.8,1,369.0,369.0,Pequeno I
5172,5225,510380,1535,1062,165,420,585,477,1531.92,1078.67,174.83,450.58,625.42,453.25,18383,12944,2098,5407,7505,5439,2022,'FIGUEIROPOLIS DOESTE',Figueirópolis D´oeste,'MT',5103809,621.0,621,51.8,51.8,1,37.0,37.0,Pequeno I
5173,5226,510385,4679,3986,444,2774,3218,768,4430.33,3796.25,412.67,2650.58,3063.25,733.0,53164,45555,4952,31807,36759,8796,2022,'GAUCHA DO NORTE',Gaúcha do Norte,'MT',5103858,3352.0,3352,279.3,279.3,1,377.0,377.0,Pequeno I
5174,5227,510390,3976,3337,685,1994,2679,658,3741.67,3163.75,821.08,1644.83,2465.92,697.83,44900,37965,9853,19738,29591,8374,2022,'GENERAL CARNEIRO',General Carneiro,'MT',5103908,867.0,867,86.7,86.7,1,,,Pequeno I
5175,5228,510395,1749,1346,70,989,1059,287,1683.92,1308.25,75.58,934.92,1010.5,297.75,20207,15699,907,11219,12126,3573,2022,'GLORIA DOESTE',Glória D´oeste,'MT',5103957,1177.0,1177,98.1,98.1,1,190.0,190.0,Pequeno I
5176,5229,510410,16092,13329,1975,8389,10364,2965,14942.67,12371.25,2093.67,7330.5,9424.17,2947.08,179312,148455,25124,87966,113090,35365,2022,'GUARANTA DO NORTE',Guarantã do Norte,'MT',5104104,5579.0,5579,464.9,464.9,1,429.0,429.0,Pequeno II
5177,5230,510420,5948,4674,159,3631,3790,884,5650.58,4467.83,182.33,3355.08,3537.42,930.42,67807,53614,2188,40261,42449,11165,2022,'GUIRATINGA',Guiratinga,'MT',5104203,3569.0,3569,297.4,297.4,1,500.0,500.0,Pequeno I
5178,5231,510450,1493,1038,228,330,558,480,1464.08,1025.67,226.75,296.17,522.92,502.75,17569,12308,2721,3554,6275,6033,2022,'INDIAVAI',Indiavaí,'MT',5104500,749.0,749,62.4,62.4,1,24.0,24.0,Pequeno I
5179,5232,510452,2948,2379,377,1276,1653,726,2703.33,2217.17,343.08,1251.17,1594.25,622.92,32440,26606,4117,15014,19131,7475,2022,'IPIRANGA DO NORTE',Ipiranga do Norte,'MT',5104526,2699.0,2699,224.9,224.9,1,176.0,176.0,Pequeno I
5180,5233,510454,3637,2857,467,1737,2204,653,3165.75,2637.75,332.58,1711.25,2043.83,593.92,37989,31653,3991,20535,24526,7127,2022,'ITANHANGA',Itanhangá,'MT',5104542,2623.0,2623,218.6,218.6,1,64.0,64.0,Pequeno I
5181,5234,510455,2853,2102,475,721,1196,906,2774.25,2094.33,454.33,747.33,1201.67,892.67,33291,25132,5452,8968,14420,10712,2022,'ITAUBA',Itaúba,'MT',5104559,1734.0,1734,173.4,173.4,1,60.0,60.0,Pequeno I
5182,5235,510460,5780,4678,1945,962,2907,1771,5461.08,4529.83,1209.08,1789.25,2998.33,1531.5,65533,54358,14509,21471,35980,18378,2022,'ITIQUIRA',Itiquira,'MT',5104609,2079.0,2079,173.2,173.2,1,154.0,154.0,Pequeno I
5183,5236,510480,13787,9934,1971,3880,5851,4083,13170.08,9805.92,1892.33,3913.75,5806.08,3999.83,158041,117671,22708,46965,69673,47998,2022,'JACIARA',Jaciara,'MT',5104807,14233.0,14233,1186.1,1186.1,2,816.0,816.0,Pequeno II
5184,5237,510490,4894,4215,699,2645,3344,871,4769.5,4146.25,647.58,2704.5,3352.08,794.17,57234,49755,7771,32454,40225,9530,2022,'JANGADA',Jangada,'MT',5104906,320.0,320,26.7,26.7,1,25.0,25.0,Pequeno I
5185,5238,510500,4206,3063,803,737,1540,1523,4070.42,3017.0,719.33,832.17,1551.5,1465.5,48845,36204,8632,9986,18618,17586,2022,'JAURU',Jauru,'MT',5105002,5947.0,5947,495.6,495.6,1,577.0,577.0,Pequeno I
5186,5239,510510,12745,10231,3338,2947,6285,3946,11971.75,9796.25,2948.92,3163.58,6112.5,3683.75,143661,117555,35387,37963,73350,44205,2022,'JUARA',Juara,'MT',5105101,3100.0,3100,258.3,258.3,1,213.0,213.0,Pequeno II
5187,5240,510515,16519,12837,2641,4496,7137,5700,15052.58,11695.5,2597.67,3831.33,6429.0,5266.5,180631,140346,31172,45976,77148,63198,2022,'JUINA',Juína,'MT',5105150,4682.0,4682,390.2,390.2,1,583.0,583.0,Pequeno II
5188,5241,510517,4677,3806,1592,849,2441,1365,4281.17,3471.33,1333.92,779.42,2113.33,1358.0,51374,41656,16007,9353,25360,16296,2022,'JURUENA',Juruena,'MT',5105176,4196.0,10506,349.7,875.5,1,485.0,485.0,Pequeno I
5189,5242,510520,5484,3813,436,1725,2161,1652,5195.0,3680.08,366.5,1779.25,2145.75,1534.33,62340,44161,4398,21351,25749,18412,2022,'JUSCIMEIRA',Juscimeira,'MT',5105200,5083.0,13190,423.6,1099.2,1,480.0,480.0,Pequeno I
5190,5243,510523,3196,2542,383,1456,1839,703,3156.17,2553.0,345.25,1600.83,1946.08,606.92,37874,30636,4143,19210,23353,7283,2022,'LAMBARI DOESTE',Lambari D´oeste,'MT',5105234,2813.0,2813,234.4,234.4,1,160.0,160.0,Pequeno I
5191,5244,510525,26472,20994,4242,7271,11513,9481,24073.17,19589.58,3479.58,8185.33,11664.92,7924.67,288878,235075,41755,98224,139979,95096,2022,'LUCAS DO RIO VERDE',Lucas do Rio Verde,'MT',5105259,8022.0,8022,668.5,668.5,1,1080.0,1080.0,Pequeno II
5192,5245,510530,1632,1397,129,956,1085,312,1501.33,1281.92,120.42,848.67,969.08,312.83,18016,15383,1445,10184,11629,3754,2022,'LUCIARA',Luciára,'MT',5105309,2604.0,2604,217.0,217.0,1,83.0,83.0,Pequeno I
5193,5246,510550,8535,7187,1564,3434,4998,2189,8038.25,6849.17,1377.08,3546.17,4923.25,1925.92,96459,82190,16525,42554,59079,23111,2022,'VILA BELA DA SANTISSIMA TR,Vila Bela da Santíssima Trindade,'MT',5105507,1175.0,1175,97.9,97.9,1,81.0,81.0,Pequeno I
5194,5247,510558,7007,5841,734,3212,3946,1895,6806.92,5782.25,677.25,3234.33,3911.58,1870.67,81683,69387,8127,38812,46939,22448,2022,'MARCELANDIA',Marcelândia,'MT',5105580,4653.0,11608,387.8,967.3,1,0.0,5882.0,Pequeno I
5195,5248,510560,6183,4532,1159,943,2102,2430,5553.92,4088.75,1006.5,960.83,1967.33,2121.42,66647,49065,12078,11530,23608,25457,2022,'MATUPA',Matupá,'MT',5105606,2199.0,2199,183.2,183.2,1,178.0,178.0,Pequeno I
5196,5249,510562,16541,13337,2183,6614,8797,4540,15802.08,12842.33,2093.92,6410.33,8504.25,4338.08,189625,154108,25127,76924,102051,52057,2022,'MIRASSOL DOESTE',Mirassol D´oeste,'MT',5105622,12766.0,12766,1063.8,1063.8,1,1018.0,1018.0,Pequeno II
5197,5250,510590,9020,7655,767,5451,6218,1437,8452.08,7229.08,657.25,5242.5,5899.75,1329.33,101425,86749,7887,62910,70797,15952,2022,'NOBRES',Nobres,'MT',5105903,4201.0,4201,350.1,350.1,1,550.0,550.0,Pequeno I
5198,5251,510600,3013,2440,340,1425,1765,675,3027.58,2398.83,305.83,1334.58,1640.42,758.42,36331,28786,3670,16015,19685,9101,2022,'NORTELANDIA',Nortelândia,'MT',5106000,2665.0,2665,222.1,222.1,1,226.0,226.0,Pequeno I
5199,5252,510610,7570,6170,1006,3522,4528,1642,7125.42,5847.08,995.83,3273.33,4269.17,1577.92,85505,70165,11950,39280,51230,18935,2022,'NOSSA SENHORA DO LIVRAMENT,Nossa Senhora do Livramento,'MT',5106109,2100.0,2100,175.0,175.0,1,177.0,177.0,Pequeno I
5200,5253,510615,8211,6516,1007,3758,4765,1751,7727.83,6206.5,902.92,3781.83,4684.75,1521.75,92734,74478,10835,45382,56217,18261,2022,'NOVA BANDEIRANTES',Nova Bandeirantes,'MT',5106158,7517.0,7517,626.4,626.4,1,495.0,495.0,Pequeno I
5201,5254,510617,3540,3152,433,2287,2720,432,3366.25,3010.5,368.0,2229.08,2597.08,413.42,40395,36126,4416,26749,31165,4961,2022,'NOVA NAZARE',Nova Nazaré,'MT',5106174,2278.0,2278,189.8,189.8,1,60.0,60.0,Pequeno I
5202,5255,510618,3889,3168,692,1555,2247,921,3621.0,2990.0,657.33,1458.25,2115.58,874.42,43452,35880,7888,17499,25387,10493,2022,'NOVA LACERDA',Nova Lacerda,'MT',5106182,5021.0,11985,418.4,998.8,1,800.0,800.0,Pequeno I
5203,5256,510619,2207,1479,317,235,552,927,2135.0,1455.58,263.83,240.75,504.58,951.0,25620,17467,3166,2889,6055,11412,2022,'NOVA SANTA HELENA',Nova Santa Helena,'MT',5106190,1563.0,1563,130.2,130.2,1,21.0,21.0,Pequeno I
5204,5257,510620,3505,2190,940,130,1070,1120,3429.25,2183.42,861.42,139.33,1000.75,1182.67,41151,26201,10337,1672,12009,14192,2022,'NOVA BRASILANDIA',Nova Brasilândia,'MT',5106208,3885.0,3885,323.8,323.8,1,200.0,200.0,Pequeno I
5205,5258,510621,4904,3437,800,812,1612,1825,4622.75,3280.08,796.83,796.42,1593.25,1686.83,55473,39361,9562,9557,19119,20242,2022,'NOVA CANAA DO NORTE',Nova Canaã do Norte,'MT',5106216,5224.0,5224,435.3,435.3,1,496.0,496.0,Pequeno I
5206,5259,510622,17791,12536,3961,1497,5458,7078,16164.33,11933.83,4048.17,1681.67,5729.83,6204.0,193972,143206,48578,20180,68758,74448,2022,'NOVA MUTUM',Nova Mutum,'MT',5106224,16949.0,16949,1412.4,1412.4,1,1161.0,1161.0,Pequeno II
5207,5260,510623,7887,6370,1460,2425,3885,2485,7569.5,6195.0,1484.25,2341.75,3826.0,2369.0,90834,74340,17811,28101,45912,28428,2022,'NOVA OLIMPIA',Nova Olímpia,'MT',5106232,1026.0,14553,85.5,1212.8,1,0.0,1489.0,Pequeno I
5208,5261,510624,5055,3266,398,576,974,2292,4688.92,3091.67,414.17,591.42,1005.58,2086.08,56267,37100,4970,7097,12067,25033,2022,'NOVA UBIRATA',Nova Ubiratã,'MT',5106240,4656.0,4656,388.0,388.0,2,199.0,199.0,Pequeno I
5209,5262,510625,10021,7071,1450,2348,3798,3273,9060.75,6407.58,1287.92,2091.5,3379.42,3028.17,108729,76891,15455,25098,40553,36338,2022,'NOVA XAVANTINA',Nova Xavantina,'MT',5106257,3867.0,3867,322.2,322.2,1,150.0,150.0,Pequeno I
5210,5263,510626,4058,3170,856,773,1629,1541,3916.75,3051.83,838.67,824.92,1663.58,1388.25,47001,36622,10064,9899,19963,16659,2022,'NOVO MUNDO',Novo Mundo,'MT',5106265,2843.0,2843,236.9,236.9,1,239.0,239.0,Pequeno I
5211,5264,510627,1889,1246,337,354,691,555,1794.67,1184.83,304.58,352.5,657.08,527.75,21536,14218,3655,4230,7885,6333,2022,'NOVO HORIZONTE DO NORTE',Novo Horizonte do Norte,'MT',5106273,2392.0,2392,239.2,239.2,1,238.0,238.0,Pequeno I
5212,5265,510628,3811,2964,1069,979,2048,916,3677.33,2917.5,912.42,1125.08,2037.5,880.0,44128,35010,10949,13501,24450,10560,2022,'NOVO SAO JOAQUIM',Novo São Joaquim,'MT',5106281,4026.0,4026,335.5,335.5,1,280.0,280.0,Pequeno I
5213,5266,510629,5596,4156,1022,1010,2032,2124,5226.58,4096.08,922.58,1191.08,2113.67,1982.42,62719,49153,11071,14293,25364,23789,2022,'PARANAITA',Paranaíta,'MT',5106299,4892.0,4892,407.7,407.7,1,615.0,615.0,Pequeno I
5214,5267,510630,10803,8032,1919,2112,4031,4001,10301.42,7717.08,1870.42,1997.0,3867.42,3849.67,123617,92605,22445,23964,46409,46196,2022,'PARANATINGA',Paranatinga,'MT',5106307,2548.0,2548,212.3,212.3,1,234.0,234.0,Pequeno I
5215,5268,510631,1577,1330,40,1052,1092,238,1521.08,1277.33,40.33,1016.92,1057.25,220.08,18253,15328,484,12203,12687,2641,2022,'NOVO SANTO ANTONIO',Novo Santo Antônio,'MT',5106315,7578.0,8726,631.5,727.2,1,648.0,648.0,Pequeno I
5216,5269,510637,9838,7955,2279,2685,4964,2991,9427.0,7729.33,1914.75,2855.83,4770.58,2958.75,113124,92752,22977,34270,57247,35505,2022,'PEDRA PRETA',Pedra Preta,'MT',5106372,4548.0,4548,379.0,379.0,1,284.0,284.0,Pequeno I
5217,5270,510642,18533,16113,3216,9086,12302,3811,17505.0,15315.0,3066.42,8842.92,11909.33,3405.67,210060,183780,36797,106115,142912,40868,2022,'PEIXOTO DE AZEVEDO',Peixoto de Azevedo,'MT',5106422,14992.0,19422,1249.3,1618.5,1,764.0,764.0,Pequeno II
5218,5271,510645,2302,1685,388,767,1155,530,2225.08,1664.58,364.75,810.67,1175.42,489.17,26701,19975,4377,9728,14105,5870,2022,'PLANALTO DA SERRA',Planalto da Serra,'MT',5106455,2192.0,2192,182.7,182.7,1,177.0,177.0,Pequeno I
5219,5272,510650,20475,18335,1576,14589,16165,2170,19300.92,17401.92,1546.67,13848.42,15395.08,2006.83,231611,208823,18560,166181,184741,24082,2022,'POCONE',Poconé,'MT',5106505,3795.0,27495,316.2,2291.2,1,0.0,2590.0,Pequeno II
5220,5273,510665,4308,3128,612,1357,1969,1159,4233.58,3108.17,598.58,1355.92,1954.5,1153.67,50803,37298,7183,16271,23454,13844,2022,'PONTAL DO ARAGUAIA',Pontal do Araguaia,'MT',5106653,1996.0,1996,166.3,166.3,1,290.0,290.0,Pequeno I
5221,5274,510670,1066,789,80,413,493,296,1023.58,755.58,89.92,404.25,494.17,261.42,12283,9067,1079,4851,5930,3137,2022,'PONTE BRANCA',Ponte Branca,'MT',5106703,1723.0,1723,143.6,143.6,1,62.0,62.0,Pequeno I
5222,5275,510675,21098,16096,4431,2812,7243,8853,19569.58,15167.92,4329.92,2717.42,7047.33,8120.58,234835,182015,51959,32609,84568,97447,2022,'PONTES E LACERDA',Pontes e Lacerda,'MT',5106752,2947.0,2947,245.6,245.6,1,393.0,393.0,Pequeno II
5223,5276,510677,6635,5443,1073,2909,3982,1461,6376.5,5279.42,963.0,2924.08,3887.08,1392.33,76518,63353,11556,35089,46645,16708,2022,'PORTO ALEGRE DO NORTE',Porto Alegre do Norte,'MT',5106778,6111.0,7165,509.2,597.1,1,707.0,707.0,Pequeno I
5224,5277,510680,2091,1418,280,327,607,811,1988.83,1386.08,306.67,313.42,620.08,766.0,23866,16633,3680,3761,7441,9192,2022,'PORTO DOS GAUCHOS',Porto Dos Gaúchos,'MT',5106802,2710.0,2710,225.8,225.8,1,176.0,176.0,Pequeno I
5225,5278,510682,5662,4779,1737,1512,3249,1530,5178.25,4394.5,1564.17,1430.92,2995.08,1399.42,62139,52734,18770,17171,35941,16793,2022,'PORTO ESPERIDIAO',Porto Esperidião,'MT',5106828,2683.0,2683,223.6,223.6,1,134.0,134.0,Pequeno I
5226,5279,510685,1721,1385,135,810,945,440,1599.42,1282.67,132.25,759.75,892.0,390.67,19193,15392,1587,9117,10704,4688,2022,'PORTO ESTRELA',Porto Estrela,'MT',5106851,1143.0,1143,190.5,190.5,1,,,Pequeno I
5227,5280,510700,11758,9441,1061,6251,7312,2129,11021.17,8962.75,909.0,6318.33,7227.33,1735.42,132254,107553,10908,75820,86728,20825,2022,'POXOREO',Poxoréo,'MT',5107008,4172.0,4172,379.3,379.3,1,210.0,210.0,Pequeno I
5228,5281,510704,31367,23763,6049,6548,12597,11166,29297.0,22488.08,5758.58,6091.17,11849.75,10638.33,351564,269857,69103,73094,142197,127660,2022,'PRIMAVERA DO LESTE',Primavera do Leste,'MT',5107040,33819.0,33819,2818.2,2818.2,3,1750.0,1750.0,Médio
5229,5282,510706,8232,6622,1258,2830,4088,2534,7512.33,6134.67,1192.08,2825.75,4017.83,2116.83,90148,73616,14305,33909,48214,25402,2022,'QUERENCIA',Querência,'MT',5107065,4032.0,4032,336.0,336.0,1,222.0,222.0,Pequeno I
5230,5283,510710,8493,5957,1508,1449,2957,3000,8061.67,5765.83,1374.92,1648.42,3023.33,2742.5,96740,69190,16499,19781,36280,32910,2022,'SAO JOSE DOS QUATRO MARCOS,São José Dos Quatro Marcos,'MT',5107107,3167.0,3167,263.9,263.9,1,154.0,154.0,Pequeno I
5231,5284,510715,1543,1183,155,666,821,362,1474.92,1170.67,114.58,692.92,807.5,363.17,17699,14048,1375,8315,9690,4358,2022,'RESERVA DO CABACAL',Reserva do Cabaçal,'MT',5107156,521.0,521,43.4,43.4,1,45.0,45.0,Pequeno I
5232,5285,510718,6157,4670,1010,2364,3374,1296,5859.83,4470.75,938.67,2332.17,3270.83,1199.92,70318,53649,11264,27986,39250,14399,2022,'RIBEIRAO CASCALHEIRA',Ribeirão Cascalheira,'MT',5107180,3912.0,3912,326.0,326.0,1,480.0,480.0,Pequeno I
5233,5286,510719,1172,816,111,351,462,354,1099.58,792.67,101.83,389.58,491.42,301.25,13195,9512,1222,4675,5897,3615,2022,'RIBEIRAOZINHO',Ribeirãozinho,'MT',5107198,2566.0,2566,213.8,213.8,1,362.0,362.0,Pequeno I
5234,5287,510720,2417,1879,474,709,1183,696,2310.0,1810.92,451.25,723.33,1174.58,636.33,27720,21731,5415,8680,14095,7636,2022,'RIO BRANCO',Rio Branco,'MT',5107206,1257.0,1257,104.8,104.8,1,42.0,42.0,Pequeno I
5235,5288,510724,2915,2202,365,887,1252,950,2715.0,2104.33,345.33,940.33,1285.67,818.67,32580,25252,4144,11284,15428,9824,2022,'SANTA CARMEM',Santa Carmem,'MT',5107248,3808.0,3808,317.3,317.3,1,220.0,220.0,Pequeno I
5236,5289,510726,2003,1455,158,795,953,502,1970.67,1422.33,155.67,772.5,928.17,494.17,23648,17068,1868,9270,11138,5930,2022,'SANTO AFONSO',Santo Afonso,'MT',5107263,2888.0,2888,240.7,240.7,1,157.0,157.0,Pequeno I
5237,5290,510729,1590,863,112,269,381,482,1543.17,875.42,121.42,261.17,382.58,492.83,18518,10505,1457,3134,4591,5914,2022,'SAO JOSE DO POVO',São José do Povo,'MT',5107297,477.0,477,39.8,39.8,1,28.0,28.0,Pequeno I
5238,5291,510730,8267,6526,1084,3218,4302,2224,7936.25,6316.5,962.83,3211.75,4174.58,2141.92,95235,75798,11554,38541,50095,25703,2022,'SAO JOSE DO RIO CLARO',São José do Rio Claro,'MT',5107305,4260.0,8764,355.0,730.3,1,198.0,198.0,Pequeno I
5239,5292,510735,4059,3613,273,2923,3196,417,3670.75,3284.58,277.83,2618.17,2896.0,388.58,44049,39415,3334,31418,34752,4663,2022,'SAO JOSE DO XINGU',São José do Xingu,'MT',5107354,1276.0,1276,106.3,106.3,1,90.0,90.0,Pequeno I
5240,5293,510740,2700,2050,250,1136,1386,664,2640.92,2000.17,239.75,1129.33,1369.08,631.08,31691,24002,2877,13552,16429,7573,2022,'SAO PEDRO DA CIPA',São Pedro da Cipa,'MT',5107404,3020.0,3020,251.7,251.7,1,206.0,206.0,Pequeno I
5241,5294,510757,1939,1707,524,655,1179,528,1756.75,1560.33,564.67,536.25,1100.92,459.42,21081,18724,6776,6435,13211,5513,2022,'RONDOLANDIA',Rondolândia,'MT',5107578,1543.0,1543,128.6,128.6,1,96.0,96.0,Pequeno I
5242,5295,510760,117561,85836,19376,29299,48675,37161,110656.5,81751.42,18039.42,27550.17,45589.58,36161.83,1327878,981017,216473,330602,547075,433942,2022,'RONDONOPOLIS',Rondonópolis,'MT',5107602,97544.0,100637,8128.7,8386.4,8,9007.0,9007.0,Grande
5243,5296,510770,10556,8623,552,6150,6702,1921,10196.92,8389.83,549.0,6073.58,6622.58,1767.25,122363,100678,6588,72883,79471,21207,2022,'ROSARIO OESTE',Rosário Oeste,'MT',5107701,1112.0,1112,92.7,92.7,1,90.0,90.0,Pequeno I
5244,5297,510774,1197,966,181,546,727,239,1101.42,904.25,155.25,524.58,679.83,224.42,13217,10851,1863,6295,8158,2693,2022,'SANTA CRUZ DO XINGU',Santa Cruz do Xingu,'MT',5107743,514.0,514,46.7,46.7,1,19.0,19.0,Pequeno I
5245,5298,510775,1975,1450,356,370,726,724,1887.17,1417.25,348.83,354.5,703.33,713.92,22646,17007,4186,4254,8440,8567,2022,'SALTO DO CEU',Salto do Céu,'MT',5107750,1005.0,1005,83.8,83.8,1,33.0,33.0,Pequeno I
5246,5299,510776,2112,1569,322,716,1038,531,1896.58,1442.25,299.25,658.17,957.42,484.83,22759,17307,3591,7898,11489,5818,2022,'SANTA RITA DO TRIVELATO',Santa Rita do Trivelato,'MT',5107768,5570.0,8020,464.2,668.3,1,883.0,883.0,Pequeno I
5247,5300,510777,4382,3756,845,2081,2926,830,4386.92,3773.0,679.83,2368.83,3048.67,724.33,52643,45276,8158,28426,36584,8692,2022,'SANTA TEREZINHA',Santa Terezinha,'MT',5107776,2192.0,2192,182.7,182.7,1,179.0,179.0,Pequeno I
5248,5301,510779,2482,2041,209,1359,1568,473,2316.42,1940.33,185.0,1287.0,1472.0,468.33,27797,23284,2220,15444,17664,5620,2022,'SANTO ANTONIO DO LESTE',Santo Antônio do Leste,'MT',5107792,3008.0,3008,250.7,250.7,1,73.0,73.0,Pequeno I
5249,5302,510780,12262,10034,1779,5436,7215,2819,11325.08,9516.08,1785.58,5226.42,7012.0,2504.08,135901,114193,21427,62717,84144,30049,2022,'SANTO ANTONIO DO LEVERGER',Santo Antônio do Leverger,'MT',5107800,4239.0,5439,353.2,453.2,1,191.0,191.0,Pequeno I
5250,5303,510785,6215,4288,1029,1183,2212,2076,5951.58,4194.75,1062.83,1120.08,2182.92,2011.83,71419,50337,12754,13441,26195,24142,2022,'SAO FELIX DO ARAGUAIA',São Félix do Araguaia,'MT',5107859,6040.0,6040,503.3,503.3,1,317.0,317.0,Pequeno I
5251,5304,510787,11163,8424,3154,760,3914,4510,10055.08,7605.08,2700.42,716.17,3416.58,4188.5,120661,91261,32405,8594,40999,50262,2022,'SAPEZAL',Sapezal,'MT',5107875,917.0,14475,76.4,1206.2,1,0.0,1064.0,Pequeno I
5252,5305,510788,1435,1106,162,554,716,390,1423.5,1114.67,154.92,592.5,747.42,367.25,17082,13376,1859,7110,8969,4407,2022,'SERRA NOVA DOURADA',Serra Nova Dourada,'MT',5107883,739.0,739,61.6,61.6,1,52.0,52.0,Pequeno I
5253,5306,510790,59919,43512,9818,3835,13653,29859,55430.83,41577.92,10652.0,5412.5,16064.5,25513.42,665170,498935,127824,64950,192774,306161,2022,'SINOP',Sinop,'MT',5107909,18949.0,18949,1579.1,1579.1,4,1142.0,1142.0,Grande
5254,5307,510792,34483,25311,6516,4594,11110,14201,31133.42,23109.33,5777.5,4318.75,10096.25,13013.08,373601,277312,69330,51825,121155,156157,2022,'SORRISO',Sorriso,'MT',5107925,25282.0,25282,2106.8,2106.8,3,1055.0,1055.0,Médio
5255,5308,510794,4116,3351,1160,496,1656,1695,3775.75,3130.42,1120.75,588.17,1708.92,1421.5,45309,37565,13449,7058,20507,17058,2022,'TABAPORA',Tabaporã,'MT',5107941,3607.0,3607,300.6,300.6,1,127.0,127.0,Pequeno I
5256,5309,510795,31926,25089,6182,7807,13989,11100,28441.92,22515.33,5503.5,7088.5,12592.0,9923.33,341303,270184,66042,85062,151104,119080,2022,'TANGARA DA SERRA',Tangará da Serra,'MT',5107958,32925.0,32925,2743.8,2743.8,3,2248.0,2248.0,Médio
5257,5310,510800,4618,3639,1118,337,1455,2184,4440.42,3578.67,1161.42,409.58,1571.0,2007.67,53285,42944,13937,4915,18852,24092,2022,'TAPURAH',Tapurah,'MT',5108006,7293.0,9418,607.8,784.8,1,426.0,426.0,Pequeno I
5258,5311,510805,4826,3548,764,1238,2002,1546,4654.67,3582.33,814.17,1315.0,2129.17,1453.17,55856,42988,9770,15780,25550,17438,2022,'TERRA NOVA DO NORTE',Terra Nova do Norte,'MT',5108055,2598.0,2598,236.2,236.2,1,107.0,107.0,Pequeno I
5259,5312,510810,1598,1213,331,623,954,259,1523.5,1176.75,315.33,591.0,906.33,270.42,18282,14121,3784,7092,10876,3245,2022,'TESOURO',Tesouro,'MT',5108105,3684.0,3684,307.0,307.0,1,75.0,75.0,Pequeno I
5260,5313,510820,1746,1245,64,800,864,381,1670.5,1204.42,64.83,751.58,816.42,388.0,20046,14453,778,9019,9797,4656,2022,'TORIXOREU',Torixoréu,'MT',5108204,3979.0,7827,331.6,652.2,1,244.0,244.0,Pequeno I
5261,5314,510830,2382,2044,212,1401,1613,431,2353.17,2038.92,166.92,1544.17,1711.08,327.83,28238,24467,2003,18530,20533,3934,2022,'UNIAO DO SUL',União do Sul,'MT',5108303,1210.0,1210,100.8,100.8,1,46.0,46.0,Pequeno I
5262,5315,510835,1644,1260,171,735,906,354,1565.75,1227.25,167.92,727.58,895.5,331.75,18789,14727,2015,8731,10746,3981,2022,'VALE DE SAO DOMINGOS',Vale de São Domingos,'MT',5108352,844.0,844,70.3,70.3,1,29.0,29.0,Pequeno I
5263,5316,510840,152602,126351,19669,76758,96427,29924,141561.0,117274.83,18146.33,70828.5,88974.83,28300.0,1698732,1407298,217756,849942,1067698,339600,2022,'VARZEA GRANDE',Várzea Grande,'MT',5108402,57100.0,70383,4758.3,5865.2,4,5573.0,5573.0,Grande
5264,5317,510850,5305,4106,1636,124,1760,2346,5145.58,3979.0,1764.83,194.67,1959.5,2019.5,61747,47748,21178,2336,23514,24234,2022,'VERA',Vera,'MT',5108501,1610.0,1610,134.2,134.2,1,53.0,53.0,Pequeno I
5265,5318,510860,7999,6236,2343,1174,3517,2719,7459.33,5822.0,2050.17,1169.5,3219.67,2602.33,89512,69864,24602,14034,38636,31228,2022,'VILA RICA',Vila Rica,'MT',5108600,4632.0,4632,386.0,386.0,1,347.0,347.0,Pequeno II
5266,5319,510880,2400,1948,512,484,996,952,2339.67,1926.0,476.5,565.67,1042.17,883.83,28076,23112,5718,6788,12506,10606,2022,'NOVA GUARITA',Nova Guarita,'MT',5108808,2563.0,2563,213.6,213.6,1,67.0,67.0,Pequeno I
5267,5320,510885,1781,1341,235,321,556,785,1691.33,1316.5,251.67,337.42,589.08,727.42,20296,15798,3020,4049,7069,8729,2022,'NOVA MARILANDIA',Nova Marilândia,'MT',5108857,1923.0,1923,160.2,160.2,1,46.0,46.0,Pequeno I
5268,5321,510890,2702,2131,711,547,1258,873,2500.83,2063.5,565.58,795.75,1361.33,702.17,30010,24762,6787,9549,16336,8426,2022,'NOVA MARINGA',Nova Maringá,'MT',5108907,1588.0,1588,132.3,132.3,1,85.0,85.0,Pequeno I
5269,5322,510895,4358,3310,658,1379,2037,1273,3967.17,3056.67,540.08,1343.0,1883.08,1173.58,47606,36680,6481,16116,22597,14083,2022,'NOVA MONTE VERDE',Nova Monte Verde,'MT',5108956,5185.0,5185,432.1,432.1,1,409.0,409.0,Pequeno I
5270,5323,520005,10985,9782,2554,4725,7279,2503,9639.75,8588.0,2189.25,4353.58,6542.83,2045.17,115677,103056,26271,52243,78514,24542,2022,'ABADIA DE GOIAS',Abadia de Goiás,'GO',5200050,6860.0,10393,623.6,944.8,1,,,Pequeno I
5271,5324,520010,8766,7082,1669,2437,4106,2976,8176.25,6621.83,1544.42,2303.08,3847.5,2774.33,98115,79462,18533,27637,46170,33292,2022,'ABADIANIA',Abadiânia,'GO',5200100,1869.0,1869,155.8,155.8,1,77.0,77.0,Pequeno I
5272,5325,520013,10273,7469,1920,2149,4069,3400,9604.25,7182.42,1725.33,2290.33,4015.67,3166.75,115251,86189,20704,27484,48188,38001,2022,'ACREUNA',Acreúna,'GO',5200134,9333.0,9333,777.8,777.8,1,834.0,834.0,Pequeno II
5273,5326,520015,1491,1226,275,451,726,500,1426.75,1188.67,265.42,495.42,760.83,427.83,17121,14264,3185,5945,9130,5134,2022,'ADELANDIA',Adelândia,'GO',5200159,555.0,555,185.0,185.0,1,,,Pequeno I
5274,5327,520017,3482,2738,565,1033,1598,1140,3364.25,2727.75,583.0,1090.17,1673.17,1054.58,40371,32733,6996,13082,20078,12655,2022,'AGUA FRIA DE GOIAS',Água Fria de Goiás,'GO',5200175,2421.0,2421,201.8,201.8,1,211.0,211.0,Pequeno I
5275,5328,520020,1247,1065,109,788,897,168,1147.33,992.5,76.92,783.92,860.83,131.67,13768,11910,923,9407,10330,1580,2022,'AGUA LIMPA',Água Limpa,'GO',5200209,2385.0,2385,198.8,198.8,1,63.0,63.0,Pequeno I
5276,5329,520025,119499,109191,16630,68464,85094,24097,109998.92,101194.0,14249.67,66520.17,80769.83,20424.17,1319987,1214328,170996,798242,969238,245090,2022,'AGUAS LINDAS DE GOIAS',Águas Lindas de Goiás,'GO',5200258,38350.0,38350,3195.8,3195.8,3,1429.0,1429.0,Grande
5277,5330,520030,18750,16729,1298,12524,13822,2907,17214.92,15450.33,1049.75,11796.67,12846.42,2603.92,206579,185404,12597,141560,154157,31247,2022,'ALEXANIA',Alexânia,'GO',5200308,3651.0,3651,304.2,304.2,1,600.0,600.0,Pequeno II
5278,5331,520050,1131,720,129,309,438,282,1088.5,748.5,104.75,394.0,498.75,249.75,13062,8982,1257,4728,5985,2997,2022,'ALOANDIA',Aloândia,'GO',5200506,583.0,583,48.6,48.6,1,36.0,36.0,Pequeno I
5279,5332,520055,4887,3230,481,1334,1815,1415,4836.92,3324.17,515.25,1427.08,1942.33,1381.83,58043,39890,6183,17125,23308,16582,2022,'ALTO HORIZONTE',Alto Horizonte,'GO',5200555,103.0,103,8.6,8.6,1,6.0,6.0,Pequeno I
5280,5333,520060,5620,4243,862,1047,1909,2334,5181.08,4053.92,938.5,1040.58,1979.08,2074.83,62173,48647,11262,12487,23749,24898,2022,'ALTO PARAISO DE GOIAS',Alto Paraíso de Goiás,'GO',5200605,3389.0,3389,282.4,282.4,1,302.0,302.0,Pequeno I
5281,5334,520080,5417,4684,900,2406,3306,1378,5242.5,4571.17,783.67,2460.92,3244.58,1326.58,62910,54854,9404,29531,38935,15919,2022,'ALVORADA DO NORTE',Alvorada do Norte,'GO',5200803,1354.0,1354,112.8,112.8,1,133.0,133.0,Pequeno I
5282,5335,520082,2392,1882,347,845,1192,690,2435.42,1953.42,324.58,941.67,1266.25,687.17,29225,23441,3895,11300,15195,8246,2022,'AMARALINA',Amaralina,'GO',5200829,766.0,766,63.8,63.8,1,42.0,42.0,Pequeno I
5283,5336,520085,2900,2532,605,1158,1763,769,2788.33,2449.83,512.92,1211.42,1724.33,725.5,33460,29398,6155,14537,20692,8706,2022,'AMERICANO DO BRASIL',Americano do Brasil,'GO',5200852,1095.0,1095,99.5,99.5,1,,,Pequeno I
5284,5337,520090,2014,1690,140,1377,1517,173,1895.75,1589.58,94.17,1315.33,1409.5,180.08,22749,19075,1130,15784,16914,2161,2022,'AMORINOPOLIS',Amorinópolis,'GO',5200902,1246.0,1246,113.3,113.3,1,178.0,178.0,Pequeno I
5285,5338,520110,136270,106130,30491,7946,38437,67693,121902.42,97509.75,30313.83,10417.67,40731.5,56778.25,1462829,1170117,363766,125012,488778,681339,2022,'ANAPOLIS',Anápolis,'GO',5201108,59709.0,199954,4975.8,16662.8,4,2450.0,12950.0,Grande
5286,5339,520120,685,428,79,163,242,186,635.25,406.08,62.08,154.42,216.5,189.58,7623,4873,745,1853,2598,2275,2022,'ANHANGUERA',Anhanguera,'GO',5201207,1719.0,1719,143.2,143.2,1,44.0,44.0,Pequeno I
5287,5340,520130,10699,8984,1802,3570,5372,3612,10307.67,8720.75,1745.67,3685.83,5431.5,3289.25,123692,104649,20948,44230,65178,39471,2022,'ANICUNS',Anicuns,'GO',5201306,1226.0,1226,102.2,102.2,1,60.0,60.0,Pequeno II
5288,5341,520140,156043,122331,42966,15779,58745,63586,141068.33,112765.67,39753.75,16891.08,56644.83,56120.83,1692820,1353188,477045,202693,679738,673450,2022,'APARECIDA DE GOIANIA',Aparecida de Goiânia,'GO',5201405,74827.0,78392,6235.6,6532.7,8,3723.0,3723.0,Grande
5289,5342,520145,1561,1171,271,379,650,521,1515.58,1167.08,259.75,453.33,713.08,454.0,18187,14005,3117,5440,8557,5448,2022,'APARECIDA DO RIO DOCE',Aparecida do Rio Doce,'GO',5201454,1065.0,1065,88.8,88.8,1,98.0,98.0,Pequeno I
5290,5343,520150,1901,1623,198,874,1072,551,1743.58,1492.0,193.5,777.5,971.0,521.0,20923,17904,2322,9330,11652,6252,2022,'APORE',Aporé,'GO',5201504,683.0,683,56.9,56.9,1,40.0,40.0,Pequeno I
5291,5344,520160,2423,1802,319,740,1059,743,2314.67,1759.5,296.0,712.5,1008.5,751.0,27776,21114,3552,8550,12102,9012,2022,'ARACU',Araçu,'GO',5201603,2201.0,2201,183.4,183.4,1,172.0,172.0,Pequeno I
5292,5345,520170,11436,9000,1032,5882,6914,2086,10766.75,8644.58,741.08,6185.42,6926.5,1718.08,129201,103735,8893,74225,83118,20617,2022,'ARAGARCAS',Aragarças,'GO',5201702,5819.0,5819,484.9,484.9,1,215.0,215.0,Pequeno I
5293,5346,520180,7979,7046,1074,4357,5431,1615,7528.33,6691.5,1017.5,4090.92,5108.42,1583.08,90340,80298,12210,49091,61301,18997,2022,'ARAGOIANIA',Aragoiânia,'GO',5201801,2615.0,2615,290.6,290.6,1,840.0,840.0,Pequeno I
5294,5347,520215,4918,4055,581,2288,2869,1186,4673.83,3859.58,656.5,2039.0,2695.5,1164.08,56086,46315,7878,24468,32346,13969,2022,'ARAGUAPAZ',Araguapaz,'GO',5202155,2202.0,2202,183.5,183.5,1,202.0,202.0,Pequeno I
5295,5348,520235,1873,1446,255,806,1061,385,1828.33,1432.0,247.92,777.25,1025.17,406.83,21940,17184,2975,9327,12302,4882,2022,'ARENOPOLIS',Arenópolis,'GO',5202353,1689.0,1689,140.8,140.8,1,138.0,138.0,Pequeno I
5296,5349,520250,4963,4088,1656,802,2458,1630,4538.0,3736.0,1378.75,981.42,2360.17,1375.83,54456,44832,16545,11777,28322,16510,2022,'ARUANA',Aruanã,'GO',5202502,4933.0,4933,411.1,411.1,1,235.0,235.0,Pequeno I
5297,5350,520260,2023,1433,264,503,767,666,1998.5,1460.25,263.92,561.33,825.25,635.0,23982,17523,3167,6736,9903,7620,2022,'AURILANDIA',Aurilândia,'GO',5202601,2675.0,2675,222.9,222.9,1,240.0,240.0,Pequeno I
5298,5351,520280,2182,1842,368,944,1312,530,2111.5,1795.08,347.33,960.08,1307.42,487.67,25338,21541,4168,11521,15689,5852,2022,'AVELINOPOLIS',Avelinópolis,'GO',5202809,1595.0,1595,132.9,132.9,1,41.0,41.0,Pequeno I
5299,5352,520310,2516,1886,505,835,1340,546,2414.58,1810.17,485.75,738.75,1224.5,585.67,28975,21722,5829,8865,14694,7028,2022,'BALIZA',Baliza,'GO',5203104,2983.0,2983,248.6,248.6,1,690.0,690.0,Pequeno I
5300,5353,520320,5856,4957,632,2665,3297,1660,5439.42,4671.33,550.17,2714.5,3264.67,1406.67,65273,56056,6602,32574,39176,16880,2022,'BARRO ALTO',Barro Alto,'GO',5203203,2368.0,2368,197.3,197.3,1,201.0,201.0,Pequeno I
5301,5354,520330,14803,12398,2146,6655,8801,3597,13844.0,11651.08,2038.5,6064.67,8103.17,3547.92,166128,139813,24462,72776,97238,42575,2022,'BELA VISTA DE GOIAS',Bela Vista de Goiás,'GO',5203302,5088.0,5088,424.0,424.0,1,392.0,392.0,Pequeno II
5302,5355,520340,5709,4071,379,2166,2545,1526,5673.42,4186.83,379.25,2411.67,2790.92,1395.92,68081,50242,4551,28940,33491,16751,2022,'BOM JARDIM DE GOIAS',Bom Jardim de Goiás,'GO',5203401,1819.0,1819,165.4,165.4,1,86.0,86.0,Pequeno I
5303,5356,520350,8703,6991,2355,2150,4505,2486,8111.33,6554.83,1884.0,2480.08,4364.08,2190.75,97336,78658,22608,29761,52369,26289,2022,'BOM JESUS DE GOIAS',Bom Jesus de Goiás,'GO',5203500,2473.0,2473,206.1,206.1,1,62.0,62.0,Pequeno II
5304,5357,520355,5995,4752,1483,669,2152,2600,5685.75,4539.08,1420.08,693.67,2113.75,2425.33,68229,54469,17041,8324,25365,29104,2022,'BONFINOPOLIS',Bonfinópolis,'GO',5203559,1483.0,1483,123.6,123.6,1,135.0,135.0,Pequeno I
5305,5358,520357,2304,1887,76,1491,1567,320,2165.83,1780.83,79.08,1410.58,1489.67,291.17,25990,21370,949,16927,17876,3494,2022,'BONOPOLIS',Bonópolis,'GO',5203575,465.0,465,42.3,42.3,1,,,Pequeno I
5306,5359,520360,2327,1960,380,852,1232,728,2177.33,1864.75,358.42,780.17,1138.58,726.17,26128,22377,4301,9362,13663,8714,2022,'BRAZABRANTES',Brazabrantes,'GO',5203609,3856.0,3856,350.5,350.5,1,381.0,381.0,Pequeno I
5307,5360,520380,4054,2807,494,752,1246,1561,3880.75,2740.25,466.25,897.67,1363.92,1376.33,46569,32883,5595,10772,16367,16516,2022,'BRITANIA',Britânia,'GO',5203807,2252.0,2252,187.7,187.7,1,91.0,91.0,Pequeno I
5308,5361,520390,3232,2492,724,575,1299,1193,2951.92,2303.25,661.25,642.58,1303.83,999.42,35423,27639,7935,7711,15646,11993,2022,'BURITI ALEGRE',Buriti Alegre,'GO',5203906,1988.0,1988,165.7,165.7,1,65.0,65.0,Pequeno I
5309,5362,520393,1832,1408,211,579,790,618,1709.08,1318.17,189.83,527.75,717.58,600.58,20509,15818,2278,6333,8611,7207,2022,'BURITI DE GOIAS',Buriti de Goiás,'GO',5203939,318.0,318,26.5,26.5,1,20.0,20.0,Pequeno I
5310,5363,520396,2518,2238,146,1485,1631,607,2427.42,2185.0,128.75,1499.08,1627.83,557.17,29129,26220,1545,17989,19534,6686,2022,'BURITINOPOLIS',Buritinópolis,'GO',5203962,312.0,312,28.4,28.4,1,,,Pequeno I
5311,5364,520400,4389,3804,266,2777,3043,761,4192.5,3647.33,281.33,2702.42,2983.75,663.58,50310,43768,3376,32429,35805,7963,2022,'CABECEIRAS',Cabeceiras,'GO',5204003,2158.0,2158,179.8,179.8,1,70.0,70.0,Pequeno I
5312,5365,520410,5600,4334,719,2279,2998,1336,5248.25,4070.08,672.67,2136.33,2809.0,1261.08,62979,48841,8072,25636,33708,15133,2022,'CACHOEIRA ALTA',Cachoeira Alta,'GO',5204102,1833.0,1833,152.8,152.8,1,161.0,161.0,Pequeno I
5313,5366,520420,977,821,60,584,644,177,944.42,799.33,52.5,582.0,634.5,164.83,11333,9592,630,6984,7614,1978,2022,'CACHOEIRA DE GOIAS',Cachoeira de Goiás,'GO',5204201,1867.0,1867,155.6,155.6,1,177.0,177.0,Pequeno I
5314,5367,520425,4307,2727,796,470,1266,1461,4179.83,2722.75,805.58,464.92,1270.5,1452.25,50158,32673,9667,5579,15246,17427,2022,'CACHOEIRA DOURADA',Cachoeira Dourada,'GO',5204250,1213.0,1213,101.1,101.1,1,27.0,27.0,Pequeno I
5315,5368,520430,6662,4654,1035,788,1823,2831,6186.42,4442.75,1133.5,628.17,1761.67,2681.08,74237,53313,13602,7538,21140,32173,2022,'CACU',Caçu,'GO',5204300,1803.0,1803,150.2,150.2,1,104.0,104.0,Pequeno I
5316,5369,520440,8489,5644,1298,1136,2434,3210,7982.42,5363.83,1257.08,1184.33,2441.42,2922.42,95789,64366,15085,14212,29297,35069,2022,'CAIAPONIA',Caiapônia,'GO',5204409,3026.0,3026,252.2,252.2,1,190.0,190.0,Pequeno I
5317,5370,520450,39752,30940,8391,8545,16936,14004,35887.75,28532.92,8255.5,8212.08,16467.58,12065.33,430653,342395,99066,98545,197611,144784,2022,'CALDAS NOVAS',Caldas Novas,'GO',5204508,9693.0,9693,807.8,807.8,2,614.0,614.0,Médio
5318,5371,520455,2408,1948,578,592,1170,778,2243.33,1851.08,533.42,558.0,1091.42,759.67,26920,22213,6401,6696,13097,9116,2022,'CALDAZINHA',Caldazinha,'GO',5204557,667.0,667,55.6,55.6,1,59.0,59.0,Pequeno I
5319,5372,520460,2862,2455,438,1531,1969,486,2710.5,2355.92,319.42,1686.75,2006.17,349.75,32526,28271,3833,20241,24074,4197,2022,'CAMPESTRE DE GOIAS',Campestre de Goiás,'GO',5204607,2089.0,2089,174.1,174.1,1,110.0,110.0,Pequeno I
5320,5373,520465,2437,2161,168,1627,1795,366,2358.5,2114.08,190.33,1599.58,1789.92,324.17,28302,25369,2284,19195,21479,3890,2022,'CAMPINACU',Campinaçu,'GO',5204656,1830.0,1830,152.5,152.5,1,180.0,180.0,Pequeno I
5321,5374,520470,6467,5623,1554,2517,4071,1552,6092.33,5324.17,1388.17,2640.92,4029.08,1295.08,73108,63890,16658,31691,48349,15541,2022,'CAMPINORTE',Campinorte,'GO',5204706,3132.0,3132,261.0,261.0,1,90.0,90.0,Pequeno I
5322,5375,520480,3035,2495,590,981,1571,924,2781.0,2275.17,551.42,847.67,1399.08,876.08,33372,27302,6617,10172,16789,10513,2022,'CAMPO ALEGRE DE GOIAS',Campo Alegre de Goiás,'GO',5204805,7399.0,7399,616.6,616.6,1,381.0,381.0,Pequeno I
5323,5376,520485,5053,4391,884,1820,2704,1687,4903.0,4343.67,781.67,2110.25,2891.92,1451.75,58836,52124,9380,25323,34703,17421,2022,'CAMPO LIMPO DE GOIAS',Campo Limpo de Goiás,'GO',5204854,2554.0,2554,232.2,232.2,1,295.0,295.0,Pequeno I
5324,5377,520490,12777,10825,1813,6255,8068,2757,12292.33,10503.42,1973.58,5887.5,7861.08,2642.33,147508,126041,23683,70650,94333,31708,2022,'CAMPOS BELOS',Campos Belos,'GO',5204904,813.0,24559,67.8,2046.6,1,728.0,728.0,Pequeno I
5325,5378,520495,3928,3261,235,2393,2628,633,3767.08,3169.42,221.17,2395.17,2616.33,553.08,45205,38033,2654,28742,31396,6637,2022,'CAMPOS VERDES',Campos Verdes,'GO',5204953,659.0,659,54.9,54.9,1,62.0,62.0,Pequeno I
5326,5379,520500,4915,3970,555,2140,2695,1275,4563.25,3719.08,566.67,1968.92,2535.58,1183.5,54759,44629,6800,23627,30427,14202,2022,'CARMO DO RIO VERDE',Carmo do Rio Verde,'GO',5205000,708.0,708,59.0,59.0,1,40.0,40.0,Pequeno I
5327,5380,520505,2264,1952,175,1467,1642,310,2085.33,1791.67,133.25,1344.92,1478.17,313.5,25024,21500,1599,16139,17738,3762,2022,'CASTELANDIA',Castelândia,'GO',5205059,1242.0,1242,103.5,103.5,1,30.0,30.0,Pequeno I
5328,5381,520510,27953,23275,4581,10526,15107,8168,24069.08,19963.0,4006.33,8717.83,12724.17,7238.83,288829,239556,48076,104614,152690,86866,2022,'CATALAO',Catalão,'GO',5205109,19315.0,21986,1931.5,2198.6,1,,,Médio
5329,5382,520520,3391,2893,830,1116,1946,947,3275.33,2801.0,696.25,1180.92,1877.17,923.83,39304,33612,8355,14171,22526,11086,2022,'CATURAI',Caturaí,'GO',5205208,2691.0,2691,224.2,224.2,1,216.0,216.0,Pequeno I
5330,5383,520530,7615,6139,1124,3086,4210,1929,7332.17,5981.67,1072.25,3121.83,4194.08,1787.58,87986,71780,12867,37462,50329,21451,2022,'CAVALCANTE',Cavalcante,'GO',5205307,970.0,970,107.8,107.8,1,15.0,15.0,Pequeno I
5331,5384,520540,9244,6804,1293,1867,3160,3644,8861.83,6593.83,1283.92,1799.42,3083.33,3510.5,106342,79126,15407,21593,37000,42126,2022,'CERES',Ceres,'GO',5205406,5334.0,5334,444.5,444.5,1,197.0,197.0,Pequeno II
5332,5385,520545,4095,3465,851,1545,2396,1069,3604.5,3099.0,687.0,1504.58,2191.58,907.42,43254,37188,8244,18055,26299,10889,2022,'CEZARINA',Cezarina,'GO',5205455,3460.0,3460,288.3,288.3,1,343.0,343.0,Pequeno I
5333,5386,520547,4012,3340,694,1673,2367,973,3561.58,2990.75,626.08,1543.75,2169.83,820.92,42739,35889,7513,18525,26038,9851,2022,'CHAPADAO DO CEU',Chapadão do Céu,'GO',5205471,3749.0,3749,312.4,312.4,1,247.0,247.0,Pequeno I
5334,5387,520549,49066,43908,5985,28122,34107,9801,44643.33,40324.75,5306.5,26718.08,32024.58,8300.17,535720,483897,63678,320617,384295,99602,2022,'CIDADE OCIDENTAL',Cidade Ocidental,'GO',5205497,10469.0,10469,872.4,872.4,1,1208.0,1208.0,Médio
5335,5388,520551,14519,13043,1399,9238,10637,2406,13760.0,12470.83,1379.5,8817.25,10196.75,2274.08,165120,149650,16554,105807,122361,27289,2022,'COCALZINHO DE GOIAS',Cocalzinho de Goiás,'GO',5205513,7922.0,7922,660.2,660.2,1,261.0,261.0,Pequeno I
5336,5389,520552,2821,2429,471,1295,1766,663,2610.92,2266.67,445.25,1251.33,1696.58,570.08,31331,27200,5343,15016,20359,6841,2022,'COLINAS DO SUL',Colinas do Sul,'GO',5205521,1825.0,1825,165.9,165.9,1,,,Pequeno I
5337,5390,520570,1408,1031,149,445,594,437,1345.67,1007.92,170.92,434.33,605.25,402.67,16148,12095,2051,5212,7263,4832,2022,'CORREGO DO OURO',Córrego do Ouro,'GO',5205703,946.0,946,78.8,78.8,1,43.0,43.0,Pequeno I
5338,5391,520580,5555,4794,827,2786,3613,1181,5396.58,4661.92,688.42,2878.0,3566.42,1095.5,64759,55943,8261,34536,42797,13146,2022,'CORUMBA DE GOIAS',Corumbá de Goiás,'GO',5205802,2697.0,2697,224.8,224.8,1,138.0,138.0,Pequeno I
5339,5392,520590,3916,3043,746,1075,1821,1222,3682.83,2884.67,737.33,980.75,1718.08,1166.58,44194,34616,8848,11769,20617,13999,2022,'CORUMBAIBA',Corumbaíba,'GO',5205901,2717.0,2717,226.4,226.4,1,83.0,83.0,Pequeno I
5340,5393,520620,28365,24997,4932,13229,18161,6836,25897.42,22900.33,4795.08,12023.58,16818.67,6081.67,310769,274804,57541,144283,201824,72980,2022,'CRISTALINA',Cristalina,'GO',5206206,3592.0,3592,299.3,299.3,1,353.0,353.0,Pequeno II
5341,5394,520630,2529,2002,264,865,1129,873,2397.67,1911.92,232.58,857.25,1089.83,822.08,28772,22943,2791,10287,13078,9865,2022,'CRISTIANOPOLIS',Cristianópolis,'GO',5206305,1320.0,1320,120.0,120.0,1,40.0,40.0,Pequeno I
5342,5395,520640,6501,5199,1302,1646,2948,2251,6417.08,5235.92,1169.08,2074.33,3243.42,1992.5,77005,62831,14029,24892,38921,23910,2022,'CRIXAS',Crixás,'GO',5206404,718.0,718,59.8,59.8,1,20.0,20.0,Pequeno I
5343,5396,520650,2621,2123,409,1129,1538,585,2524.42,2052.08,371.92,1115.83,1487.75,564.33,30293,24625,4463,13390,17853,6772,2022,'CROMINIA',Cromínia,'GO',5206503,3654.0,3654,304.5,304.5,1,301.0,301.0,Pequeno I
5344,5397,520660,1542,1038,232,285,517,521,1463.92,979.42,190.75,277.33,468.08,511.33,17567,11753,2289,3328,5617,6136,2022,'CUMARI',Cumari,'GO',5206602,1469.0,1469,122.4,122.4,1,128.0,128.0,Pequeno I
5345,5398,520670,2855,2518,241,1672,1913,605,2783.33,2503.33,242.17,1681.92,1924.08,579.25,33400,30040,2906,20183,23089,6951,2022,'DAMIANOPOLIS',Damianópolis,'GO',5206701,903.0,903,75.2,75.2,1,51.0,51.0,Pequeno I
5346,5399,520680,2249,1952,251,1228,1479,473,2148.42,1863.25,262.67,1145.83,1408.5,454.75,25781,22359,3152,13750,16902,5457,2022,'DAMOLANDIA',Damolândia,'GO',5206800,3094.0,3094,257.8,257.8,1,300.0,300.0,Pequeno I
5347,5400,520690,969,745,216,189,405,340,881.5,680.92,210.08,198.25,408.33,272.58,10578,8171,2521,2379,4900,3271,2022,'DAVINOPOLIS',Davinópolis,'GO',5206909,620.0,620,51.7,51.7,1,39.0,39.0,Pequeno I
5348,5401,520710,1225,927,58,567,625,302,1160.83,892.42,50.08,563.08,613.17,279.25,13930,10709,601,6757,7358,3351,2022,'DIORAMA',Diorama,'GO',5207105,924.0,924,77.0,77.0,1,67.0,67.0,Pequeno I
5349,5402,520725,3862,2891,553,1370,1923,968,3742.83,2846.17,478.0,1476.67,1954.67,891.5,44914,34154,5736,17720,23456,10698,2022,'DOVERLANDIA',Doverlândia,'GO',5207253,6276.0,7461,523.0,621.8,1,0.0,1185.0,Pequeno I
5350,5403,520735,2492,1888,499,614,1113,775,2351.5,1817.5,439.08,660.5,1099.58,717.92,28218,21810,5269,7926,13195,8615,2022,'EDEALINA',Edealina,'GO',5207352,1674.0,1674,139.5,139.5,1,250.0,250.0,Pequeno I
5351,5404,520740,6594,5432,1166,2494,3660,1772,6205.5,5246.33,1044.75,2698.25,3743.0,1503.33,74466,62956,12537,32379,44916,18040,2022,'EDEIA',Edéia,'GO',5207402,3805.0,3805,317.1,317.1,1,245.0,245.0,Pequeno I
5352,5405,520750,1933,1559,237,845,1082,477,1834.17,1482.08,228.75,766.83,995.58,486.5,22010,17785,2745,9202,11947,5838,2022,'ESTRELA DO NORTE',Estrela do Norte,'GO',5207501,435.0,435,36.2,36.2,1,43.0,43.0,Pequeno I
5353,5406,520753,3904,3201,661,1392,2053,1148,3776.08,3107.75,646.92,1299.25,1946.17,1161.58,45313,37293,7763,15591,23354,13939,2022,'FAINA',Faina,'GO',5207535,1643.0,1643,136.9,136.9,1,191.0,191.0,Pequeno I
5354,5407,520760,3450,3110,65,2867,2932,178,3315.25,3013.0,63.67,2773.17,2836.83,176.17,39783,36156,764,33278,34042,2114,2022,'FAZENDA NOVA',Fazenda Nova,'GO',5207600,1788.0,1788,149.0,149.0,1,76.0,76.0,Pequeno I
5355,5408,520780,4172,3406,487,1641,2128,1278,3955.92,3261.17,422.33,1685.25,2107.58,1153.58,47471,39134,5068,20223,25291,13843,2022,'FIRMINOPOLIS',Firminópolis,'GO',5207808,3953.0,3953,329.4,329.4,1,590.0,590.0,Pequeno I
5356,5409,520790,8725,6726,994,3647,4641,2085,8638.25,6774.75,976.42,3767.83,4744.25,2030.5,103659,81297,11717,45214,56931,24366,2022,'FLORES DE GOIAS',Flores de Goiás,'GO',5207907,4153.0,4153,346.1,346.1,1,110.0,110.0,Pequeno I
5357,5410,520800,53416,45995,8020,26282,34302,11693,49522.33,43102.33,6523.33,26301.0,32824.33,10278.0,594268,517228,78280,315612,393892,123336,2022,'FORMOSA',Formosa,'GO',5208004,12850.0,12850,1070.8,1070.8,2,1988.0,1988.0,Grande
5358,5411,520810,2943,2490,572,1358,1930,560,2907.42,2498.67,500.08,1520.25,2020.33,478.33,34889,29984,6001,18243,24244,5740,2022,'FORMOSO',Formoso,'GO',5208103,1582.0,1582,131.8,131.8,1,78.0,78.0,Pequeno I
5359,5412,520815,2064,1621,307,468,775,846,1983.17,1603.92,326.25,481.33,807.58,796.33,23798,19247,3915,5776,9691,9556,2022,'GAMELEIRA DE GOIAS',Gameleira de Goiás,'GO',5208152,553.0,553,69.1,69.1,1,75.0,75.0,Pequeno I
5360,5413,520830,4346,3607,235,2698,2933,674,4286.42,3579.58,245.0,2743.83,2988.83,590.75,51437,42955,2940,32926,35866,7089,2022,'DIVINOPOLIS DE GOIAS',Divinópolis de Goiás,'GO',5208301,6074.0,6074,552.2,552.2,1,211.0,211.0,Pequeno I
5361,5414,520840,8907,7865,2438,2714,5152,2713,8270.08,7393.92,2462.83,2695.92,5158.75,2235.17,99241,88727,29554,32351,61905,26822,2022,'GOIANAPOLIS',Goianápolis,'GO',5208400,447.0,447,37.2,37.2,1,23.0,23.0,Pequeno I
5362,5415,520850,2253,1871,443,915,1358,513,2019.42,1709.5,430.83,797.17,1228.0,481.5,24233,20514,5170,9566,14736,5778,2022,'GOIANDIRA',Goiandira,'GO',5208509,1165.0,1165,97.1,97.1,1,72.0,72.0,Pequeno I
5363,5416,520860,28312,23018,5690,8212,13902,9116,25389.33,21051.17,4929.25,8253.58,13182.83,7868.33,304672,252614,59151,99043,158194,94420,2022,'GOIANESIA',Goianésia,'GO',5208608,1126.0,1126,93.8,93.8,1,93.0,93.0,Médio
5364,5417,520870,404842,325642,64372,141672,206044,119598,353820.75,285724.17,55682.0,123790.92,179472.92,106251.25,4245849,3428690,668184,1485491,2153675,1275015,2022,'GOIANIA',Goiânia,'GO',5208707,288419.0,295318,24034.9,24609.8,15,18737.0,18737.0,Metrópole
5365,5418,520880,31208,26792,5781,10790,16571,10221,27894.08,24088.75,5185.25,9802.33,14987.58,9101.17,334729,289065,62223,117628,179851,109214,2022,'GOIANIRA',Goianira,'GO',5208806,3160.0,3160,263.3,263.3,1,240.0,240.0,Pequeno II
5366,5419,520890,12444,9729,1759,4874,6633,3096,11623.42,9184.17,1593.92,4537.33,6131.25,3052.92,139481,110210,19127,54448,73575,36635,2022,'GOIAS',Goiás,'GO',5208905,3996.0,3996,333.0,333.0,1,168.0,168.0,Pequeno II
5367,5420,520910,13769,10234,2186,2528,4714,5520,13021.67,9859.75,2181.0,2585.67,4766.67,5093.08,156260,118317,26172,31028,57200,61117,2022,'GOIATUBA',Goiatuba,'GO',5209101,1816.0,1816,151.3,151.3,1,86.0,86.0,Pequeno II
5368,5421,520915,2432,1753,382,663,1045,708,2266.17,1637.83,364.33,562.83,927.17,710.67,27194,19654,4372,6754,11126,8528,2022,'GOUVELANDIA',Gouvelândia,'GO',5209150,3367.0,3367,280.6,280.6,1,380.0,380.0,Pequeno I
5369,5422,520920,11703,9791,1711,5530,7241,2550,11102.5,9310.42,1540.58,5297.33,6837.92,2472.5,133230,111725,18487,63568,82055,29670,2022,'GUAPO',Guapó,'GO',5209200,1679.0,1679,139.9,139.9,1,194.0,194.0,Pequeno I
5370,5423,520929,1776,1490,217,698,915,575,1748.5,1490.92,198.08,763.75,961.83,529.08,20982,17891,2377,9165,11542,6349,2022,'GUARAITA',Guaraíta,'GO',5209291,600.0,600,50.0,50.0,1,30.0,30.0,Pequeno I
5371,5424,520940,2892,2501,250,1834,2084,417,2836.67,2463.25,217.25,1819.5,2036.75,426.5,34040,29559,2607,21834,24441,5118,2022,'GUARANI DE GOIAS',Guarani de Goiás,'GO',5209408,1745.0,1745,145.4,145.4,1,30.0,30.0,Pequeno I
5372,5425,520945,1192,967,74,581,655,312,1185.33,972.67,73.42,596.83,670.25,302.42,14224,11672,881,7162,8043,3629,2022,'GUARINOS',Guarinos,'GO',5209457,1415.0,1415,117.9,117.9,1,325.0,325.0,Pequeno I
5373,5426,520960,2927,2462,819,954,1773,689,2816.75,2392.0,698.92,1057.33,1756.25,635.75,33801,28704,8387,12688,21075,7629,2022,'HEITORAI',Heitoraí,'GO',5209606,2567.0,2567,213.9,213.9,1,192.0,192.0,Pequeno I
5374,5427,520970,10593,8813,3077,1902,4979,3834,9421.92,7950.58,2607.67,1818.0,4425.67,3524.92,113063,95407,31292,21816,53108,42299,2022,'HIDROLANDIA',Hidrolândia,'GO',5209705,993.0,993,82.8,82.8,1,58.0,58.0,Pequeno I
5375,5428,520980,2041,1692,261,774,1035,657,1988.58,1672.83,270.67,759.25,1029.92,642.92,23863,20074,3248,9111,12359,7715,2022,'HIDROLINA',Hidrolina,'GO',5209804,296.0,296,59.2,59.2,1,,,Pequeno I
5376,5429,520990,8545,7669,1101,5345,6446,1223,8340.42,7509.08,989.42,5280.83,6270.25,1238.83,100085,90109,11873,63370,75243,14866,2022,'IACIARA',Iaciara,'GO',5209903,3230.0,3230,269.2,269.2,1,120.0,120.0,Pequeno I
5377,5430,520993,3493,2541,532,946,1478,1063,3284.25,2459.42,429.5,1120.67,1550.17,909.25,39411,29513,5154,13448,18602,10911,2022,'INACIOLANDIA',Inaciolândia,'GO',5209937,3460.0,3460,288.3,288.3,1,223.0,223.0,Pequeno I
5378,5431,520995,7310,6035,1417,1725,3142,2893,6901.5,5848.25,1073.25,2163.75,3237.0,2611.25,82818,70179,12879,25965,38844,31335,2022,'INDIARA',Indiara,'GO',5209952,4168.0,4168,347.3,347.3,1,495.0,495.0,Pequeno I
5379,5432,521000,28766,21215,3491,6319,9810,11405,27058.75,20366.92,3500.83,5950.83,9451.67,10915.25,324705,244403,42010,71410,113420,130983,2022,'INHUMAS',Inhumas,'GO',5210000,2217.0,2217,201.5,201.5,1,230.0,230.0,Pequeno II
5380,5433,521010,11673,9292,1563,4616,6179,3113,10799.08,8793.92,1282.33,4547.5,5829.83,2964.08,129589,105527,15388,54570,69958,35569,2022,'IPAMERI',Ipameri,'GO',5210109,4957.0,4957,413.1,413.1,1,447.0,447.0,Pequeno II
5381,5434,521015,2219,1695,131,1025,1156,539,2143.75,1668.17,136.08,1017.58,1153.67,514.5,25725,20018,1633,12211,13844,6174,2022,'IPIRANGA DE GOIAS',Ipiranga de Goiás,'GO',5210158,1782.0,1782,148.5,148.5,1,78.0,78.0,Pequeno I
5382,5435,521020,12332,8486,2011,2090,4101,4385,11319.67,7865.83,2018.83,1649.67,3668.5,4197.33,135836,94390,24226,19796,44022,50368,2022,'IPORA',Iporá,'GO',5210208,12414.0,21046,1034.5,1753.8,1,1303.0,1303.0,Pequeno II
5383,5436,521030,1670,1371,50,1156,1206,165,1549.92,1285.58,60.92,1047.0,1107.92,177.67,18599,15427,731,12564,13295,2132,2022,'ISRAELANDIA',Israelândia,'GO',5210307,837.0,837,69.8,69.8,1,76.0,76.0,Pequeno I
5384,5437,521040,24265,19791,4843,6705,11548,8243,22539.42,18720.42,4341.0,7226.25,11567.25,7153.17,270473,224645,52092,86715,138807,85838,2022,'ITABERAI',Itaberaí,'GO',5210406,4282.0,4282,356.8,356.8,1,182.0,182.0,Pequeno II
5385,5438,521056,3092,2428,698,590,1288,1140,2860.83,2342.75,646.42,719.58,1366.0,976.75,34330,28113,7757,8635,16392,11721,2022,'ITAGUARI',Itaguari,'GO',5210562,1348.0,1348,112.3,112.3,1,50.0,50.0,Pequeno I
5386,5439,521060,3027,2306,505,803,1308,998,2977.0,2326.25,496.58,839.33,1335.92,990.33,35724,27915,5959,10072,16031,11884,2022,'ITAGUARU',Itaguaru,'GO',5210604,1305.0,1305,108.8,108.8,1,100.0,100.0,Pequeno I
5387,5440,521080,2618,1712,316,664,980,732,2572.33,1690.17,282.42,711.42,993.83,696.33,30868,20282,3389,8537,11926,8356,2022,'ITAJA',Itajá,'GO',5210802,1952.0,1952,162.7,162.7,1,33.0,33.0,Pequeno I
5388,5441,521090,9839,7198,1877,742,2619,4579,9336.42,6942.92,1836.67,814.42,2651.08,4291.83,112037,83315,22040,9773,31813,51502,2022,'ITAPACI',Itapaci,'GO',5210901,4818.0,4818,401.5,401.5,1,122.0,122.0,Pequeno I
5389,5442,521100,5011,4173,595,2612,3207,966,4766.42,4001.0,528.42,2612.75,3141.17,859.83,57197,48012,6341,31353,37694,10318,2022,'ITAPIRAPUA',Itapirapuã,'GO',5211008,757.0,757,63.1,63.1,1,85.0,85.0,Pequeno I
5390,5443,521120,13883,11867,2189,5084,7273,4594,12963.0,11173.5,1624.67,5498.75,7123.42,4050.08,155556,134082,19496,65985,85481,48601,2022,'ITAPURANGA',Itapuranga,'GO',5211206,3292.0,3292,274.3,274.3,1,249.0,249.0,Pequeno II
5391,5444,521130,2696,1501,157,808,965,536,2567.33,1507.0,124.92,795.17,920.08,586.92,30808,18084,1499,9542,11041,7043,2022,'ITARUMA',Itarumã,'GO',5211305,2159.0,2159,179.9,179.9,1,142.0,142.0,Pequeno I
5392,5445,521140,4631,3635,490,1954,2444,1191,4240.83,3406.42,441.0,1809.83,2250.83,1155.58,50890,40877,5292,21718,27010,13867,2022,'ITAUCU',Itauçu,'GO',5211404,3939.0,11014,328.2,917.8,1,52.0,52.0,Pequeno I
5393,5446,521150,36526,27673,7297,10889,18186,9487,32738.42,24984.0,5843.25,10780.92,16624.17,8359.83,392861,299808,70119,129371,199490,100318,2022,'ITUMBIARA',Itumbiara,'GO',5211503,23294.0,33868,1941.2,2822.3,2,2192.0,2192.0,Médio
5394,5447,521160,1959,1380,136,856,992,388,1758.67,1312.08,130.33,806.42,936.75,375.33,21104,15745,1564,9677,11241,4504,2022,'IVOLANDIA',Ivolândia,'GO',5211602,1145.0,1145,95.4,95.4,1,41.0,41.0,Pequeno I
5395,5448,521170,2913,2331,394,988,1382,949,2780.5,2271.75,325.42,1108.33,1433.75,838.0,33366,27261,3905,13300,17205,10056,2022,'JANDAIA',Jandaia,'GO',5211701,899.0,899,74.9,74.9,1,66.0,66.0,Pequeno I
5396,5449,521180,25833,21729,4474,9838,14312,7417,24194.92,20851.0,4077.33,9991.08,14068.42,6782.58,290339,250212,48928,119893,168821,81391,2022,'JARAGUA',Jaraguá,'GO',5211800,7671.0,7671,639.2,639.2,1,76.0,76.0,Pequeno II
5397,5450,521190,33787,25188,6423,7014,13437,11751,31209.42,23355.58,6005.67,6464.92,12470.58,10885.0,374513,280267,72068,77579,149647,130620,2022,'JATAI',Jataí,'GO',5211909,10316.0,10316,859.7,859.7,3,542.0,542.0,Médio
5398,5451,521200,1988,1512,207,661,868,644,1899.83,1488.92,177.67,768.17,945.83,543.08,22798,17867,2132,9218,11350,6517,2022,'JAUPACI',Jaupaci,'GO',5212006,1857.0,1857,154.8,154.8,1,80.0,80.0,Pequeno I
5399,5452,521205,1662,1385,67,1049,1116,269,1647.5,1390.33,63.67,1050.92,1114.58,275.75,19770,16684,764,12611,13375,3309,2022,'JESUPOLIS',Jesúpolis,'GO',5212055,2487.0,2487,207.2,207.2,1,110.0,110.0,Pequeno I
5400,5453,521210,2543,1666,400,304,704,962,2283.75,1491.42,299.08,305.25,604.33,887.08,27405,17897,3589,3663,7252,10645,2022,'JOVIANIA',Joviânia,'GO',5212105,2918.0,2918,243.2,243.2,1,220.0,220.0,Pequeno I
5401,5454,521220,10531,7957,2308,2645,4953,3004,9978.25,7832.75,1861.33,3212.67,5074.0,2758.75,119739,93993,22336,38552,60888,33105,2022,'JUSSARA',Jussara,'GO',5212204,1170.0,1170,97.5,97.5,1,56.0,56.0,Pequeno I
5402,5455,521225,1038,890,77,692,769,121,961.83,823.25,92.83,605.33,698.17,125.08,11542,9879,1114,7264,8378,1501,2022,'LAGOA SANTA',Lagoa Santa,'GO',5212253,807.0,807,73.4,73.4,1,9.0,9.0,Pequeno I
5403,5456,521230,4154,3725,1663,1105,2768,957,3903.75,3573.92,1450.33,1356.42,2806.75,767.17,46845,42887,17404,16277,33681,9206,2022,'LEOPOLDO DE BULHOES',Leopoldo de Bulhões,'GO',5212303,953.0,953,79.4,79.4,1,52.0,52.0,Pequeno I
5404,5457,521250,108165,95944,23617,50410,74027,21917,100265.17,89055.42,23431.83,44800.92,68232.75,20822.67,1203182,1068665,281182,537611,818793,249872,2022,'LUZIANIA',Luziânia,'GO',5212501,21263.0,21263,1771.9,1771.9,3,1975.0,1975.0,Grande
5405,5458,521260,1380,1143,193,604,797,346,1342.0,1124.25,191.67,621.0,812.67,311.58,16104,13491,2300,7452,9752,3739,2022,'MAIRIPOTABA',Mairipotaba,'GO',5212600,642.0,642,53.5,53.5,1,46.0,46.0,Pequeno I
5406,5459,521270,5656,5107,450,3768,4218,889,5281.67,4865.33,392.92,3701.58,4094.5,770.83,63380,58384,4715,44419,49134,9250,2022,'MAMBAI',Mambaí,'GO',5212709,2630.0,2630,219.2,219.2,1,215.0,215.0,Pequeno I
5407,5460,521280,5662,4734,1017,1985,3002,1732,5377.0,4538.5,1006.58,1992.17,2998.75,1539.75,64524,54462,12079,23906,35985,18477,2022,'MARA ROSA',Mara Rosa,'GO',5212808,5429.0,5429,452.4,452.4,1,419.0,419.0,Pequeno I
5408,5461,521290,1494,1194,124,698,822,372,1395.75,1139.92,129.67,689.08,818.75,321.17,16749,13679,1556,8269,9825,3854,2022,'MARZAGAO',Marzagão,'GO',5212907,741.0,741,61.8,61.8,1,45.0,45.0,Pequeno I
5409,5462,521295,3000,2553,307,1626,1933,620,2916.58,2537.0,281.58,1790.17,2071.75,465.25,34999,30444,3379,21482,24861,5583,2022,'MATRINCHA',Matrinchã,'GO',5212956,405.0,405,33.8,33.8,1,15.0,15.0,Pequeno I
5410,5463,521300,5170,4346,796,2339,3135,1211,5033.75,4310.58,785.33,2476.58,3261.92,1048.67,60405,51727,9424,29719,39143,12584,2022,'MAURILANDIA',Maurilândia,'GO',5213004,2101.0,2101,191.0,191.0,1,,,Pequeno I
5411,5464,521305,1767,1397,157,834,991,406,1737.25,1400.92,167.08,842.67,1009.75,391.17,20847,16811,2005,10112,12117,4694,2022,'MIMOSO DE GOIAS',Mimoso de Goiás,'GO',5213053,1897.0,1897,158.1,158.1,1,160.0,160.0,Pequeno I
5412,5465,521308,14564,11181,1128,6557,7685,3496,13980.33,10920.42,1088.08,6488.58,7576.67,3343.75,167764,131045,13057,77863,90920,40125,2022,'MINACU',Minaçu,'GO',5213087,3596.0,3596,359.6,359.6,1,,,Pequeno II
5413,5466,521310,31498,24020,5214,9102,14316,9704,28382.25,22017.25,4416.25,9204.25,13620.5,8396.75,340587,264207,52995,110451,163446,100761,2022,'MINEIROS',Mineiros,'GO',5213103,19357.0,19357,1613.1,1613.1,2,2250.0,2250.0,Médio
5414,5467,521340,1062,831,70,448,518,313,1000.08,798.17,68.75,478.75,547.5,250.67,12001,9578,825,5745,6570,3008,2022,'MOIPORA',Moiporá,'GO',5213400,1476.0,1476,123.0,123.0,1,80.0,80.0,Pequeno I
5415,5468,521350,5619,4726,380,3255,3635,1091,5520.0,4696.75,424.58,3256.75,3681.33,1015.42,66240,56361,5095,39081,44176,12185,2022,'MONTE ALEGRE DE GOIAS',Monte Alegre de Goiás,'GO',5213509,1057.0,1057,96.1,96.1,1,50.0,50.0,Pequeno I
5416,5469,521370,3761,2834,949,511,1460,1374,3558.33,2682.83,903.92,477.67,1381.58,1301.25,42700,32194,10847,5732,16579,15615,2022,'MONTES CLAROS DE GOIAS',Montes Claros de Goiás,'GO',5213707,3139.0,3139,261.6,261.6,1,310.0,310.0,Pequeno I
5417,5470,521375,4665,3513,706,928,1634,1879,4134.08,3215.5,659.58,985.17,1644.75,1570.75,49609,38586,7915,11822,19737,18849,2022,'MONTIVIDIU',Montividiu,'GO',5213756,1764.0,1764,160.4,160.4,1,52.0,52.0,Pequeno I
5418,5471,521377,3321,2736,247,2118,2365,371,3314.83,2768.5,231.67,2197.67,2429.33,339.17,39778,33222,2780,26372,29152,4070,2022,'MONTIVIDIU DO NORTE',Montividiu do Norte,'GO',5213772,701.0,701,58.4,58.4,1,25.0,25.0,Pequeno I
5419,5472,521380,19581,14462,2374,2933,5307,9155,18406.08,13704.67,2154.67,3098.5,5253.17,8451.5,220873,164456,25856,37182,63038,101418,2022,'MORRINHOS',Morrinhos,'GO',5213806,3612.0,3612,301.0,301.0,1,221.0,221.0,Pequeno II
5420,5473,521385,1881,1590,213,896,1109,481,1823.58,1554.92,194.75,909.67,1104.42,450.5,21883,18659,2337,10916,13253,5406,2022,'MORRO AGUDO DE GOIAS',Morro Agudo de Goiás,'GO',5213855,1377.0,1377,114.8,114.8,1,78.0,78.0,Pequeno I
5421,5474,521390,2055,1594,452,272,724,870,1899.17,1508.58,425.67,301.08,726.75,781.83,22790,18103,5108,3613,8721,9382,2022,'MOSSAMEDES',Mossâmedes,'GO',5213905,633.0,633,57.5,57.5,1,7.0,7.0,Pequeno I
5422,5475,521400,7996,6950,989,4104,5093,1857,7531.17,6673.0,695.67,4580.58,5276.25,1396.75,90374,80076,8348,54967,63315,16761,2022,'MOZARLANDIA',Mozarlândia,'GO',5214002,3273.0,3273,272.8,272.8,1,226.0,226.0,Pequeno I
5423,5476,521405,4145,3051,383,1425,1808,1243,4014.08,3043.42,366.67,1606.17,1972.83,1070.58,48169,36521,4400,19274,23674,12847,2022,'MUNDO NOVO',Mundo Novo,'GO',5214051,1443.0,1443,120.2,120.2,1,47.0,47.0,Pequeno I
5424,5477,521410,2549,2173,477,1176,1653,520,2430.17,2091.83,434.17,1145.5,1579.67,512.17,29162,25102,5210,13746,18956,6146,2022,'MUTUNOPOLIS',Mutunópolis,'GO',5214101,580.0,580,48.3,48.3,1,35.0,35.0,Pequeno I
5425,5478,521440,4122,3485,1003,1529,2532,953,3808.5,3252.17,959.92,1406.92,2366.83,885.33,45702,39026,11519,16883,28402,10624,2022,'NAZARIO',Nazário,'GO',5214408,1902.0,1902,158.5,158.5,1,141.0,141.0,Pequeno I
5426,5479,521450,14139,11495,3039,2572,5611,5884,13212.42,10834.5,2907.42,2666.5,5573.92,5260.58,158549,130014,34889,31998,66887,63127,2022,'NEROPOLIS',Nerópolis,'GO',5214507,4313.0,4313,359.4,359.4,1,210.0,210.0,Pequeno II
5427,5480,521460,18171,14225,3852,4631,8483,5742,17063.17,13659.83,3769.08,4749.67,8518.75,5141.08,204758,163918,45229,56996,102225,61693,2022,'NIQUELANDIA',Niquelândia,'GO',5214606,5283.0,5283,440.2,440.2,2,54.0,54.0,Pequeno II
5428,5481,521470,2395,1811,283,771,1054,757,2180.33,1668.25,215.92,734.0,949.92,718.33,26164,20019,2591,8808,11399,8620,2022,'NOVA AMERICA',Nova América,'GO',5214705,679.0,679,56.6,56.6,1,197.0,197.0,Pequeno I
5429,5482,521480,1351,1016,162,467,629,387,1249.17,946.33,172.33,374.0,546.33,400.0,14990,11356,2068,4488,6556,4800,2022,'NOVA AURORA',Nova Aurora,'GO',5214804,1577.0,1577,131.4,131.4,1,220.0,220.0,Pequeno I
5430,5483,521483,6529,5291,1377,2063,3440,1851,6252.5,5087.42,1094.58,2251.83,3346.42,1741.0,75030,61049,13135,27022,40157,20892,2022,'NOVA CRIXAS',Nova Crixás,'GO',5214838,913.0,913,101.4,101.4,1,10.0,10.0,Pequeno I
5431,5484,521486,4852,4095,291,2666,2957,1138,4710.75,3997.67,275.0,2657.58,2932.58,1065.08,56529,47972,3300,31891,35191,12781,2022,'NOVA GLORIA',Nova Glória,'GO',5214861,1020.0,1020,85.0,85.0,1,75.0,75.0,Pequeno I
5432,5485,521487,1271,1056,189,655,844,212,1116.92,923.0,155.67,572.58,728.25,194.75,13403,11076,1868,6871,8739,2337,2022,'NOVA IGUACU DE GOIAS',Nova Iguaçu de Goiás,'GO',5214879,748.0,748,62.3,62.3,1,45.0,45.0,Pequeno I
5433,5486,521490,2551,2081,119,1416,1535,546,2529.5,2103.75,127.92,1419.67,1547.58,556.17,30354,25245,1535,17036,18571,6674,2022,'NOVA ROMA',Nova Roma,'GO',5214903,1273.0,1273,106.1,106.1,1,31.0,31.0,Pequeno I
5434,5487,521500,6165,5279,710,2888,3598,1681,5850.67,5035.25,635.92,3029.92,3665.83,1369.42,70208,60423,7631,36359,43990,16433,2022,'NOVA VENEZA',Nova Veneza,'GO',5215009,1859.0,1859,169.0,169.0,1,,,Pequeno I
5435,5488,521520,2162,1846,266,1084,1350,496,2029.67,1737.83,241.83,980.67,1222.5,515.33,24356,20854,2902,11768,14670,6184,2022,'NOVO BRASIL',Novo Brasil,'GO',5215207,699.0,699,58.2,58.2,1,84.0,84.0,Pequeno I
5436,5489,521523,49003,43638,13395,15147,28542,15096,44418.17,39987.25,11851.67,14319.17,26170.83,13816.42,533018,479847,142220,171830,314050,165797,2022,'NOVO GAMA',Novo Gama,'GO',5215231,9721.0,9721,883.7,883.7,2,1680.0,1680.0,Médio
5437,5490,521525,2903,2436,278,1508,1786,650,2818.0,2396.08,236.5,1572.42,1808.92,587.17,33816,28753,2838,18869,21707,7046,2022,'NOVO PLANALTO',Novo Planalto,'GO',5215256,273.0,273,24.8,24.8,1,15.0,15.0,Pequeno I
5438,5491,521530,6843,4739,923,1190,2113,2626,6562.33,4591.83,938.25,1160.33,2098.58,2493.25,78748,55102,11259,13924,25183,29919,2022,'ORIZONA',Orizona,'GO',5215306,5162.0,5162,430.2,430.2,1,33.0,33.0,Pequeno I
5439,5492,521540,2344,1899,497,703,1200,699,2316.58,1876.83,434.42,768.92,1203.33,673.5,27799,22522,5213,9227,14440,8082,2022,'OURO VERDE DE GOIAS',Ouro Verde de Goiás,'GO',5215405,5051.0,8639,420.9,719.9,1,0.0,1076.0,Pequeno I
5440,5493,521550,5005,3002,575,728,1303,1699,4643.58,2959.08,577.75,772.92,1350.67,1608.42,55723,35509,6933,9275,16208,19301,2022,'OUVIDOR',Ouvidor,'GO',5215504,2920.0,2920,243.3,243.3,1,296.0,296.0,Pequeno I
5441,5494,521560,16476,13869,3925,5873,9798,4071,15083.75,12731.17,3253.5,5954.42,9207.92,3523.25,181005,152774,39042,71453,110495,42279,2022,'PADRE BERNARDO',Padre Bernardo,'GO',5215603,3516.0,3516,293.0,293.0,1,133.0,133.0,Pequeno II
5442,5495,521565,1920,1486,262,646,908,578,1837.33,1458.83,238.08,679.92,918.0,540.83,22048,17506,2857,8159,11016,6490,2022,'PALESTINA DE GOIAS',Palestina de Goiás,'GO',5215652,1385.0,1385,115.4,115.4,1,85.0,85.0,Pequeno I
5443,5496,521570,12652,9776,2158,1160,3318,6458,11300.08,8797.25,2034.08,781.33,2815.42,5981.83,135601,105567,24409,9376,33785,71782,2022,'PALMEIRAS DE GOIAS',Palmeiras de Goiás,'GO',5215702,1284.0,1284,107.0,107.0,1,40.0,40.0,Pequeno II
5444,5497,521580,1459,1064,200,387,587,477,1345.08,986.83,163.0,375.83,538.83,448.0,16141,11842,1956,4510,6466,5376,2022,'PALMELO',Palmelo,'GO',5215801,805.0,805,67.1,67.1,1,65.0,65.0,Pequeno I
5445,5498,521590,2154,1724,222,999,1221,503,1978.42,1609.58,221.17,906.5,1127.67,481.92,23741,19315,2654,10878,13532,5783,2022,'PALMINOPOLIS',Palminópolis,'GO',5215900,1021.0,1021,85.1,85.1,1,68.0,68.0,Pequeno I
5446,5499,521600,1302,918,174,408,582,336,1266.92,918.42,144.33,427.0,571.33,347.08,15203,11021,1732,5124,6856,4165,2022,'PANAMA',Panamá,'GO',5216007,1010.0,1010,101.0,101.0,1,68.0,68.0,Pequeno I
5447,5500,521630,4282,3117,991,746,1737,1380,4085.83,3057.42,855.25,894.33,1749.58,1307.83,49030,36689,10263,10732,20995,15694,2022,'PARANAIGUARA',Paranaiguara,'GO',5216304,4464.0,4464,372.0,372.0,1,129.0,129.0,Pequeno I
5448,5501,521640,5382,4019,996,1131,2127,1892,5104.83,3899.75,913.33,1217.17,2130.5,1769.25,61258,46797,10960,14606,25566,21231,2022,'PARAUNA',Paraúna,'GO',5216403,1298.0,1298,108.2,108.2,1,81.0,81.0,Pequeno I
5449,5502,521645,1562,1068,449,36,485,583,1517.17,1070.08,387.0,127.17,514.17,555.92,18206,12841,4644,1526,6170,6671,2022,'PEROLANDIA',Perolândia,'GO',5216452,2117.0,2117,176.4,176.4,1,103.0,103.0,Pequeno I
5450,5503,521680,4410,3755,986,1412,2398,1357,4154.25,3558.0,1008.42,1156.08,2164.5,1393.5,49851,42696,12101,13873,25974,16722,2022,'PETROLINA DE GOIAS',Petrolina de Goiás,'GO',5216809,2117.0,2117,176.4,176.4,1,64.0,64.0,Pequeno I
5451,5504,521690,1519,1363,232,757,989,374,1476.67,1334.33,221.83,784.08,1005.92,328.42,17720,16012,2662,9409,12071,3941,2022,'PILAR DE GOIAS',Pilar de Goiás,'GO',5216908,1331.0,1331,110.9,110.9,1,187.0,187.0,Pequeno I
5452,5505,521710,9857,7322,1438,1732,3170,4152,9398.08,7090.0,1420.58,1844.5,3265.08,3824.92,112777,85080,17047,22134,39181,45899,2022,'PIRACANJUBA',Piracanjuba,'GO',5217104,2472.0,2472,206.0,206.0,1,66.0,66.0,Pequeno II
5453,5506,521720,6408,4766,652,2596,3248,1518,6035.08,4587.67,631.58,2605.67,3237.25,1350.42,72421,55052,7579,31268,38847,16205,2022,'PIRANHAS',Piranhas,'GO',5217203,2373.0,2373,197.8,197.8,1,76.0,76.0,Pequeno I
5454,5507,521730,12728,10447,3159,2020,5179,5268,11725.0,9933.67,3066.42,2253.42,5319.83,4613.83,140700,119204,36797,27041,63838,55366,2022,'PIRENOPOLIS',Pirenópolis,'GO',5217302,5804.0,5804,483.7,483.7,1,265.0,265.0,Pequeno II
5455,5508,521740,13523,11682,3834,3419,7253,4429,12262.33,10594.75,3472.17,2928.08,6400.25,4194.5,147148,127137,41666,35137,76803,50334,2022,'PIRES DO RIO',Pires do Rio,'GO',5217401,2683.0,4763,223.6,396.9,1,0.0,2080.0,Pequeno II
5456,5509,521760,55164,48864,10731,26406,37137,11727,48451.67,42841.75,9510.08,21718.17,31228.25,11613.5,581420,514101,114121,260618,374739,139362,2022,'PLANALTINA',Planaltina,'GO',5217609,12071.0,12071,1005.9,1005.9,1,1169.0,1169.0,Médio
5457,5510,521770,8983,6688,1451,1513,2964,3724,8514.42,6572.17,1630.58,1679.5,3310.08,3262.08,102173,78866,19567,20154,39721,39145,2022,'PONTALINA',Pontalina,'GO',5217708,1648.0,1648,137.3,137.3,1,259.0,259.0,Pequeno I
5458,5511,521800,21129,16930,5143,5276,10419,6511,19960.25,16279.58,4457.58,6213.42,10671.0,5608.58,239523,195355,53491,74561,128052,67303,2022,'PORANGATU',Porangatu,'GO',5218003,3875.0,8355,352.3,759.5,1,100.0,100.0,Pequeno II
5459,5512,521805,2650,2020,397,1079,1476,544,2398.08,1923.58,389.25,1069.83,1459.08,464.5,28777,23083,4671,12838,17509,5574,2022,'PORTEIRAO',Porteirão,'GO',5218052,6779.0,6779,564.9,564.9,1,484.0,484.0,Pequeno I
5460,5513,521810,1957,1605,300,895,1195,410,1822.5,1511.33,272.33,881.67,1154.0,357.33,21870,18136,3268,10580,13848,4288,2022,'PORTELANDIA',Portelândia,'GO',5218102,1678.0,1678,139.8,139.8,1,99.0,99.0,Pequeno I
5461,5514,521830,18363,16097,1507,11134,12641,3456,17140.33,15123.83,1253.5,10769.75,12023.25,3100.58,205684,181486,15042,129237,144279,37207,2022,'POSSE',Posse,'GO',5218300,11059.0,11059,921.6,921.6,1,863.0,863.0,Pequeno II
5462,5515,521839,2369,1936,208,1276,1484,452,2252.42,1855.17,211.75,1201.92,1413.67,441.5,27029,22262,2541,14423,16964,5298,2022,'PROFESSOR JAMIL',Professor Jamil,'GO',5218391,658.0,658,54.8,54.8,1,50.0,50.0,Pequeno I
5463,5516,521850,19333,14084,4217,1655,5872,8212,17408.42,12877.0,3590.5,1945.83,5536.33,7340.67,208901,154524,43086,23350,66436,88088,2022,'QUIRINOPOLIS',Quirinópolis,'GO',5218508,4113.0,6376,342.8,531.3,1,332.0,332.0,Pequeno II
5464,5517,521860,5168,3926,737,1113,1850,2076,4876.58,3767.08,703.33,1091.33,1794.67,1972.42,58519,45205,8440,13096,21536,23669,2022,'RIALMA',Rialma,'GO',5218607,726.0,726,60.5,60.5,1,38.0,38.0,Pequeno I
5465,5518,521870,2210,1742,360,530,890,852,2108.42,1683.08,379.58,439.42,819.0,864.08,25301,20197,4555,5273,9828,10369,2022,'RIANAPOLIS',Rianápolis,'GO',5218706,2391.0,2391,199.2,199.2,1,198.0,198.0,Pequeno I
5466,5519,521878,2516,1779,172,828,1000,779,2326.33,1736.83,208.5,869.17,1077.67,659.17,27916,20842,2502,10430,12932,7910,2022,'RIO QUENTE',Rio Quente,'GO',5218789,1595.0,1595,132.9,132.9,1,59.0,59.0,Pequeno I
5467,5520,521880,67474,54510,12415,22544,34959,19551,58686.25,47552.25,11100.58,19591.17,30691.75,16860.5,704235,570627,133207,235094,368301,202326,2022,'RIO VERDE',Rio Verde,'GO',5218805,16571.0,30265,1380.9,2522.1,2,1012.0,1012.0,Grande
5468,5521,521890,9969,7655,2004,1919,3923,3732,9574.17,7449.5,1984.92,1906.75,3891.67,3557.83,114890,89394,23819,22881,46700,42694,2022,'RUBIATABA',Rubiataba,'GO',5218904,1906.0,1906,190.6,190.6,1,,,Pequeno I
5469,5522,521900,3743,2365,508,43,551,1814,3586.17,2289.75,555.67,95.67,651.33,1638.42,43034,27477,6668,1148,7816,19661,2022,'SANCLERLANDIA',Sanclerlândia,'GO',5219001,2385.0,2385,198.8,198.8,1,136.0,136.0,Pequeno I
5470,5523,521910,3583,2924,630,1234,1864,1060,3398.33,2816.08,554.0,1341.08,1895.08,921.0,40780,33793,6648,16093,22741,11052,2022,'SANTA BARBARA DE GOIAS',Santa Bárbara de Goiás,'GO',5219100,3183.0,3183,265.2,265.2,1,122.0,122.0,Pequeno I
5471,5524,521920,1638,1377,205,791,996,381,1560.58,1315.0,191.33,738.67,930.0,385.0,18727,15780,2296,8864,11160,4620,2022,'SANTA CRUZ DE GOIAS',Santa Cruz de Goiás,'GO',5219209,811.0,811,67.6,67.6,1,50.0,50.0,Pequeno I
5472,5525,521925,2355,1940,438,769,1207,733,2213.42,1851.5,419.0,808.67,1227.67,623.83,26561,22218,5028,9704,14732,7486,2022,'SANTA FE DE GOIAS',Santa fé de Goiás,'GO',5219258,111.0,111,9.2,9.2,1,10.0,10.0,Pequeno I
5473,5526,521930,15351,11946,2963,5097,8060,3886,14627.25,11491.92,2566.5,5261.5,7828.0,3663.92,175527,137903,30798,63138,93936,43967,2022,'SANTA HELENA DE GOIAS',Santa Helena de Goiás,'GO',5219308,2326.0,2326,193.8,193.8,1,59.0,59.0,Pequeno II
5474,5527,521935,2832,2183,214,1215,1429,754,2752.83,2126.75,198.58,1177.33,1375.92,750.83,33034,25521,2383,14128,16511,9010,2022,'SANTA ISABEL',Santa Isabel,'GO',5219357,2020.0,2020,202.0,202.0,1,,,Pequeno I
5475,5528,521940,3358,2566,487,1283,1770,796,3171.42,2439.33,464.33,1198.42,1662.75,776.58,38057,29272,5572,14381,19953,9319,2022,'SANTA RITA DO ARAGUAIA',Santa Rita do Araguaia,'GO',5219407,3060.0,3060,255.0,255.0,1,167.0,167.0,Pequeno I
5476,5529,521945,1887,1445,226,756,982,463,1849.33,1468.25,227.33,792.25,1019.58,448.67,22192,17619,2728,9507,12235,5384,2022,'SANTA RITA DO NOVO DESTINO,Santa Rita do Novo Destino,'GO',5219456,621.0,621,51.8,51.8,2,20.0,20.0,Pequeno I
5477,5530,521950,2018,1573,252,738,990,583,1966.33,1554.67,270.17,729.08,999.25,555.42,23596,18656,3242,8749,11991,6665,2022,'SANTA ROSA DE GOIAS',Santa Rosa de Goiás,'GO',5219506,1494.0,1494,124.5,124.5,1,60.0,60.0,Pequeno I
5478,5531,521960,2019,1520,185,800,985,535,1980.5,1517.92,191.33,792.58,983.92,534.0,23766,18215,2296,9511,11807,6408,2022,'SANTA TEREZA DE GOIAS',Santa Tereza de Goiás,'GO',5219605,1007.0,1007,91.5,91.5,1,71.0,71.0,Pequeno I
5479,5532,521970,7246,6205,492,4755,5247,958,7099.5,6111.75,514.5,4628.33,5142.83,968.92,85194,73341,6174,55540,61714,11627,2022,'SANTA TEREZINHA DE GOIAS',Santa Terezinha de Goiás,'GO',5219704,2138.0,2138,194.4,194.4,1,,,Pequeno I
5480,5533,521971,2141,1665,404,420,824,841,2042.67,1634.25,401.42,445.75,847.17,787.08,24512,19611,4817,5349,10166,9445,2022,'SANTO ANTONIO DA BARRA',Santo Antônio da Barra,'GO',5219712,395.0,395,32.9,32.9,1,12.0,12.0,Pequeno I
5481,5534,521973,4785,3947,425,2404,2829,1118,4338.67,3816.25,274.42,2831.42,3105.83,710.42,52064,45795,3293,33977,37270,8525,2022,'SANTO ANTONIO DE GOIAS',Santo Antônio de Goiás,'GO',5219738,5627.0,5627,511.5,511.5,1,545.0,545.0,Pequeno I
5482,5535,521975,40423,35750,6656,20391,27047,8703,37425.17,33427.33,5934.0,19766.08,25700.08,7727.25,449102,401128,71208,237193,308401,92727,2022,'SANTO ANTONIO DO DESCOBERT,Santo Antônio do Descoberto,'GO',5219753,6135.0,6135,511.2,511.2,1,258.0,258.0,Médio
5483,5536,521980,6120,5191,369,3866,4235,956,6066.42,5201.08,352.83,3992.0,4344.83,856.25,72797,62413,4234,47904,52138,10275,2022,'SAO DOMINGOS',São Domingos,'GO',5219803,2227.0,2227,185.6,185.6,1,17.0,17.0,Pequeno I
5484,5537,521990,4008,3605,695,2203,2898,707,3644.17,3262.33,692.08,1824.17,2516.25,746.08,43730,39148,8305,21890,30195,8953,2022,'SAO FRANCISCO DE GOIAS',São Francisco de Goiás,'GO',5219902,1005.0,1005,83.8,83.8,1,115.0,115.0,Pequeno I
5485,5538,522000,8143,7139,2069,3303,5372,1767,7818.75,6928.0,1597.75,3767.83,5365.58,1562.42,93825,83136,19173,45214,64387,18749,2022,'SAO JOAO DALIANCA',São João D´aliança,'GO',5220009,1484.0,1484,123.7,123.7,1,81.0,81.0,Pequeno I
5486,5539,522005,1016,759,137,275,412,347,935.25,735.33,124.75,318.5,443.25,292.08,11223,8824,1497,3822,5319,3505,2022,'SAO JOAO DA PARAUNA',São João da Paraúna,'GO',5220058,875.0,875,72.9,72.9,1,87.0,87.0,Pequeno I
5487,5540,522010,13236,10371,2368,3549,5917,4454,12157.67,9814.58,2172.08,3625.5,5797.58,4017.0,145892,117775,26065,43506,69571,48204,2022,'SAO LUIS DE MONTES BELOS',São Luís de Montes Belos,'GO',5220108,6679.0,6679,556.6,556.6,1,300.0,300.0,Pequeno II
5488,5541,522015,3193,2641,735,1050,1785,856,3026.5,2535.75,696.42,1043.67,1740.08,795.67,36318,30429,8357,12524,20881,9548,2022,'SAO LUIZ DO NORTE',São Luíz do Norte,'GO',5220157,791.0,791,71.9,71.9,1,66.0,66.0,Pequeno I
5489,5542,522020,14762,11389,2420,4942,7362,4027,14206.75,10992.92,2207.92,4926.17,7134.08,3858.83,170481,131915,26495,59114,85609,46306,2022,'SAO MIGUEL DO ARAGUAIA',São Miguel do Araguaia,'GO',5220207,3311.0,3311,275.9,275.9,1,224.0,224.0,Pequeno II
5490,5543,522026,2286,1667,317,402,719,948,2253.33,1700.0,335.25,432.08,767.33,932.67,27040,20400,4023,5185,9208,11192,2022,'SAO MIGUEL DO PASSA QUATRO,São Miguel do Passa Quatro,'GO',5220264,2004.0,2004,167.0,167.0,1,500.0,500.0,Pequeno I
5491,5544,522028,1435,1103,212,492,704,399,1381.25,1079.83,258.33,429.5,687.83,392.0,16575,12958,3100,5154,8254,4704,2022,'SAO PATRICIO',São Patrício,'GO',5220280,1360.0,1360,113.3,113.3,1,90.0,90.0,Pequeno I
5492,5545,522040,9369,7435,901,4524,5425,2010,8633.25,7000.33,790.33,4608.75,5399.08,1601.25,103599,84004,9484,55305,64789,19215,2022,'SAO SIMAO',São Simão,'GO',5220405,4292.0,7120,357.7,593.3,1,161.0,161.0,Pequeno I
5493,5546,522045,65003,53912,12579,13498,26077,27835,58890.75,49526.17,11490.67,14282.83,25773.5,23752.67,706689,594314,137888,171394,309282,285032,2022,'SENADOR CANEDO',Senador Canedo,'GO',5220454,26666.0,26666,2222.2,2222.2,3,945.0,945.0,Médio
5494,5547,522050,3533,2777,573,1058,1631,1146,3365.58,2657.33,562.33,1011.17,1573.5,1083.83,40387,31888,6748,12134,18882,13006,2022,'SERRANOPOLIS',Serranópolis,'GO',5220504,975.0,975,108.3,108.3,1,30.0,30.0,Pequeno I
5495,5548,522060,9238,7550,1295,3437,4732,2818,8686.17,7147.08,1100.33,3658.17,4758.5,2388.58,104234,85765,13204,43898,57102,28663,2022,'SILVANIA',Silvânia,'GO',5220603,2722.0,2722,226.8,226.8,1,177.0,177.0,Pequeno I
5496,5549,522068,4974,4428,226,3621,3847,581,4921.58,4411.75,218.58,3650.5,3869.08,542.67,59059,52941,2623,43806,46429,6512,2022,'SIMOLANDIA',Simolândia,'GO',5220686,3624.0,5217,302.0,434.8,1,0.0,1593.0,Pequeno I
5497,5550,522070,2010,1740,39,1495,1534,206,1910.58,1672.67,41.0,1431.83,1472.83,199.83,22927,20072,492,17182,17674,2398,2022,'SITIO DABADIA',Sítio D´abadia,'GO',5220702,904.0,904,82.2,82.2,1,300.0,300.0,Pequeno I
5498,5551,522100,2571,1905,283,816,1099,806,2320.67,1792.33,243.0,853.5,1096.5,695.83,27848,21508,2916,10242,13158,8350,2022,'TAQUARAL DE GOIAS',Taquaral de Goiás,'GO',5221007,725.0,725,60.4,60.4,1,67.0,67.0,Pequeno I
5499,5552,522108,2870,2436,135,1839,1974,462,2767.83,2382.17,144.83,1851.83,1996.67,385.5,33214,28586,1738,22222,23960,4626,2022,'TERESINA DE GOIAS',Teresina de Goiás,'GO',5221080,1068.0,1068,89.0,89.0,1,84.0,84.0,Pequeno I
5500,5553,522119,5217,4590,730,2775,3505,1085,4842.67,4277.75,689.92,2538.17,3228.08,1049.67,58112,51333,8279,30458,38737,12596,2022,'TEREZOPOLIS DE GOIAS',Terezópolis de Goiás,'GO',5221197,1286.0,1286,116.9,116.9,1,,,Pequeno I
5501,5554,522130,1474,1256,93,968,1061,195,1341.25,1151.75,90.83,885.58,976.42,175.33,16095,13821,1090,10627,11717,2104,2022,'TRES RANCHOS',Três Ranchos,'GO',5221304,2440.0,2440,203.3,203.3,1,130.0,130.0,Pequeno I
5502,5555,522140,73210,56677,12928,16081,29009,27668,66737.33,52925.58,12349.25,16290.92,28640.17,24285.42,800848,635107,148191,195491,343682,291425,2022,'TRINDADE',Trindade,'GO',5221403,34114.0,34114,2842.8,2842.8,3,2835.0,2835.0,Grande
5503,5556,522145,2170,1750,396,909,1305,445,2117.83,1724.0,379.5,878.25,1257.75,466.25,25414,20688,4554,10539,15093,5595,2022,'TROMBAS',Trombas,'GO',5221452,859.0,859,85.9,85.9,1,,,Pequeno I
5504,5557,522150,3026,2285,530,659,1189,1096,2881.67,2233.17,544.0,647.0,1191.0,1042.17,34580,26798,6528,7764,14292,12506,2022,'TURVANIA',Turvânia,'GO',5221502,6149.0,6149,512.4,512.4,1,505.0,505.0,Pequeno I
5505,5558,522155,3000,2550,336,1500,1836,714,2890.75,2501.25,345.42,1544.17,1889.58,611.67,34689,30015,4145,18530,22675,7340,2022,'TURVELANDIA',Turvelândia,'GO',5221551,4712.0,4712,392.7,392.7,1,271.0,271.0,Pequeno I
5506,5559,522157,1811,1602,80,1248,1328,274,1711.5,1531.08,73.75,1233.0,1306.75,224.33,20538,18373,885,14796,15681,2692,2022,'UIRAPURU',Uirapuru,'GO',5221577,1331.0,1331,110.9,110.9,1,160.0,160.0,Pequeno I
5507,5560,522160,18194,13249,3771,1484,5255,7994,17117.5,12707.92,3677.17,1585.42,5262.58,7445.33,205410,152495,44126,19025,63151,89344,2022,'URUACU',Uruaçu,'GO',5221601,951.0,951,86.5,86.5,1,204.0,204.0,Pequeno II
5508,5561,522170,8029,6868,941,4168,5109,1759,7662.67,6604.08,809.25,4147.25,4956.5,1647.58,91952,79249,9711,49767,59478,19771,2022,'URUANA',Uruana,'GO',5221700,2445.0,2445,203.8,203.8,1,279.0,279.0,Pequeno I
5509,5562,522180,1985,1411,276,432,708,703,1711.25,1238.58,236.08,372.92,609.0,629.58,20535,14863,2833,4475,7308,7555,2022,'URUTAI',Urutaí,'GO',5221809,3602.0,3602,300.2,300.2,1,208.0,208.0,Pequeno I
5510,5563,522185,68990,58184,25112,11622,36734,21450,61984.25,52501.42,21109.08,12802.0,33911.08,18590.33,743811,630017,253309,153624,406933,223084,2022,'VALPARAISO DE GOIAS',Valparaíso de Goiás,'GO',5221858,20356.0,20356,1696.3,1696.3,4,1839.0,1839.0,Grande
5511,5564,522190,2089,1600,348,628,976,624,2008.67,1561.92,332.08,649.83,981.92,580.0,24104,18743,3985,7798,11783,6960,2022,'VARJAO',Varjão,'GO',5221908,1178.0,1178,117.8,117.8,1,64.0,64.0,Pequeno I
5512,5565,522200,6440,5257,1363,1759,3122,2135,5868.0,4800.67,1243.08,1400.83,2643.92,2156.75,70416,57608,14917,16810,31727,25881,2022,'VIANOPOLIS',Vianópolis,'GO',5222005,129.0,129,10.8,10.8,1,4.0,4.0,Pequeno I
5513,5566,522205,4557,3693,1198,981,2179,1514,4427.5,3692.0,904.33,1516.25,2420.58,1271.42,53130,44304,10852,18195,29047,15257,2022,'VICENTINOPOLIS',Vicentinópolis,'GO',5222054,2444.0,2444,222.2,222.2,1,174.0,174.0,Pequeno I
5514,5567,522220,3187,2657,327,1627,1954,703,3221.0,2709.83,297.25,1777.42,2074.67,635.17,38652,32518,3567,21329,24896,7622,2022,'VILA BOA',Vila Boa,'GO',5222203,6078.0,6078,506.5,506.5,1,500.0,500.0,Pequeno I
5515,5568,522230,3679,3134,521,1826,2347,787,3522.5,3055.42,562.08,1741.0,2303.08,752.33,42270,36665,6745,20892,27637,9028,2022,'VILA PROPICIO',Vila Propício,'GO',5222302,705.0,705,58.8,58.8,2,46.0,46.0,Pequeno I
5516,5569,530010,763223,684838,103918,396820,500738,184100,629504.58,569580.0,81139.67,347353.92,428493.58,141086.42,7554055,6834960,973676,4168247,5141923,1693037,2022,'BRASILIA',Brasília,'DF',5300108,300262.0,300262,27296.5,27296.5,29,27645.0,27645.0,Metrópole
